"country","simulation","group","points","goals_scored","goals_taken","diff_goals","rank"
"Brazil",1,2,9,13,3,10,1
"Italy",1,2,4,5,7,-2,2
"England",1,6,7,6,2,4,1
"Denmark",1,6,6,6,5,1,2
"Spain",1,8,9,9,1,8,1
"Algeria",1,8,6,2,3,-1,2
"Brazil",2,2,7,3,1,2,1
"Morocco",2,2,4,4,4,0,2
"Senegal",2,3,9,9,3,6,1
"Uruguay",2,3,4,4,7,-3,2
"Portugal",2,4,7,6,1,5,1
"Japan",2,4,6,4,3,1,2
"Switzerland",2,6,6,6,1,5,1
"Argentina",2,6,5,2,1,1,2
"France",2,8,9,6,2,4,1
"Denmark",2,8,4,5,4,1,2
"Switzerland",3,5,9,6,0,6,1
"Italy",3,5,6,2,1,1,2
"Nigeria",3,6,7,4,0,4,1
"Spain",3,6,6,5,3,2,2
"Netherlands",3,7,9,5,1,4,1
"Portugal",3,7,6,6,4,2,2
"Belgium",3,8,9,6,1,5,1
"Mexico",3,8,6,6,3,3,2
"Germany",4,1,9,10,4,6,1
"Morocco",4,1,4,7,8,-1,2
"France",4,2,5,5,3,2,1
"Iran",4,2,4,2,2,0,2
"Italy",4,4,7,6,0,6,1
"United States",4,4,4,2,4,-2,2
"Poland",4,5,6,4,6,-2,1
"Spain",4,5,5,8,4,4,2
"Tunisia",4,8,6,6,2,4,1
"Portugal",4,8,5,4,3,1,2
"Algeria",5,1,7,7,4,3,1
"Netherlands",5,1,6,9,5,4,2
"France",5,3,7,6,1,5,1
"Korea Republic",5,3,4,3,4,-1,2
"Switzerland",5,4,7,7,4,3,1
"Brazil",5,4,4,2,2,0,2
"Belgium",6,2,9,8,0,8,1
"Chile",6,2,6,6,5,1,2
"Netherlands",6,3,9,8,2,6,1
"Argentina",6,3,6,5,4,1,2
"France",6,4,9,4,1,3,1
"Korea Republic",6,4,6,3,2,1,2
"Portugal",6,5,7,2,0,2,1
"Australia",6,5,5,4,1,3,2
"Mexico",6,6,9,7,3,4,1
"Brazil",6,6,4,6,3,3,2
"Spain",6,7,9,6,1,5,1
"Denmark",6,7,4,3,3,0,2
"Italy",7,1,6,6,3,3,1
"Senegal",7,1,5,6,4,2,2
"Belgium",7,3,9,7,1,6,1
"Uruguay",7,3,6,4,4,0,2
"Argentina",7,7,7,5,2,3,1
"Nigeria",7,7,6,6,3,3,2
"France",7,8,7,8,2,6,1
"Chile",7,8,5,4,3,1,2
"Brazil",8,2,7,7,1,6,1
"Poland",8,2,5,4,2,2,2
"France",8,4,9,13,1,12,1
"Croatia",8,4,6,3,4,-1,2
"Spain",8,8,9,7,0,7,1
"Morocco",8,8,4,3,5,-2,2
"Germany",9,3,9,6,0,6,1
"Brazil",9,3,4,2,4,-2,2
"Argentina",9,5,9,4,1,3,1
"Poland",9,5,6,5,3,2,2
"Senegal",10,1,7,3,1,2,1
"Denmark",10,1,6,3,2,1,2
"Croatia",10,3,9,6,2,4,1
"Nigeria",10,3,6,3,2,1,2
"Italy",10,5,9,6,1,5,1
"Brazil",10,5,6,5,2,3,2
"Portugal",10,6,7,5,2,3,1
"Germany",10,6,5,6,4,2,2
"Belgium",10,7,7,2,0,2,1
"Netherlands",10,7,6,4,1,3,2
"Wales",10,8,7,7,2,5,1
"Mexico",10,8,4,1,4,-3,2
"Qatar",11,1,9,4,1,3,1
"Mexico",11,1,6,5,1,4,2
"Denmark",11,2,7,3,0,3,1
"England",11,2,6,6,2,4,2
"Portugal",11,4,9,6,1,5,1
"Wales",11,4,4,3,2,1,2
"Italy",11,5,9,9,1,8,1
"Japan",11,5,6,5,5,0,2
"Brazil",11,7,7,8,3,5,1
"Netherlands",11,7,4,4,3,1,2
"Germany",11,8,9,7,3,4,1
"France",11,8,4,4,4,0,2
"Morocco",12,1,7,4,2,2,1
"Colombia",12,1,5,2,1,1,2
"United States",12,2,5,5,4,1,1
"Spain",12,2,4,3,2,1,2
"Mexico",12,3,7,4,2,2,1
"Brazil",12,3,6,2,1,1,2
"Uruguay",12,5,9,7,0,7,1
"England",12,5,6,4,1,3,2
"Colombia",13,1,9,6,3,3,1
"Switzerland",13,1,6,7,2,5,2
"Italy",13,3,7,4,2,2,1
"Belgium",13,3,5,2,1,1,2
"France",13,6,9,4,1,3,1
"Croatia",13,6,6,4,2,2,2
"Brazil",13,7,7,8,2,6,1
"Germany",13,7,5,5,2,3,2
"Spain",13,8,7,4,1,3,1
"Costa Rica",13,8,4,2,3,-1,2
"France",14,2,7,6,1,5,1
"Colombia",14,2,5,2,1,1,2
"Poland",14,4,9,8,2,6,1
"Croatia",14,4,6,3,2,1,2
"Spain",14,7,7,3,0,3,1
"Netherlands",14,7,4,4,4,0,2
"Argentina",14,8,9,8,2,6,1
"Japan",14,8,6,3,3,0,2
"Brazil",15,3,9,8,0,8,1
"Netherlands",15,3,6,5,3,2,2
"Argentina",15,5,9,11,2,9,1
"Nigeria",15,5,4,2,3,-1,2
"Denmark",15,8,6,4,3,1,1
"Portugal",15,8,5,6,5,1,2
"Chile",16,1,5,3,1,2,1
"Qatar",16,1,4,4,2,2,2
"Colombia",16,2,9,5,1,4,1
"Spain",16,2,6,7,2,5,2
"Belgium",16,4,9,5,2,3,1
"Australia",16,4,4,3,3,0,2
"England",16,5,7,6,1,5,1
"Netherlands",16,5,5,1,0,1,2
"Poland",16,6,7,4,2,2,1
"Argentina",16,6,5,4,2,2,2
"Brazil",17,3,9,9,2,7,1
"United States",17,3,6,3,5,-2,2
"Argentina",17,5,7,4,1,3,1
"Algeria",17,5,4,5,4,1,2
"Wales",17,7,7,4,1,3,1
"Mexico",17,7,4,4,2,2,2
"Denmark",18,1,7,5,3,2,1
"Tunisia",18,1,4,3,3,0,2
"Algeria",18,4,5,1,0,1,1
"Portugal",18,4,4,3,3,0,2
"Belgium",18,5,7,6,0,6,1
"Korea Republic",18,5,4,5,5,0,2
"Mexico",18,6,7,6,1,5,1
"Brazil",18,6,5,2,1,1,2
"France",18,7,9,6,0,6,1
"Iran",18,7,6,5,2,3,2
"Germany",18,8,9,6,0,6,1
"England",18,8,6,2,3,-1,2
"Netherlands",19,1,7,3,0,3,1
"Morocco",19,1,4,4,5,-1,2
"Brazil",19,3,7,5,1,4,1
"United States",19,3,5,3,2,1,2
"Iran",19,4,9,8,3,5,1
"Spain",19,4,6,9,8,1,2
"Belgium",19,5,9,10,2,8,1
"Germany",19,5,6,7,4,3,2
"France",19,6,9,5,0,5,1
"Italy",19,6,6,3,2,1,2
"Wales",19,8,7,2,0,2,1
"Argentina",19,8,6,3,1,2,2
"Italy",20,2,9,8,1,7,1
"Argentina",20,2,4,3,2,1,2
"Belgium",20,5,7,6,1,5,1
"Switzerland",20,5,4,2,2,0,2
"Portugal",20,6,7,10,3,7,1
"Colombia",20,6,5,3,2,1,2
"Spain",20,7,9,3,0,3,1
"Morocco",20,7,6,2,1,1,2
"Croatia",20,8,9,8,4,4,1
"Chile",20,8,6,6,6,0,2
"Qatar",21,1,7,3,1,2,1
"Croatia",21,1,4,2,2,0,2
"France",21,2,9,11,2,9,1
"Netherlands",21,2,4,5,4,1,2
"Portugal",21,6,5,3,1,2,1
"Switzerland",21,6,4,2,2,0,2
"Argentina",21,7,9,6,1,5,1
"Italy",21,7,6,4,2,2,2
"Germany",22,1,7,5,2,3,1
"Qatar",22,1,5,3,2,1,2
"Belgium",22,3,7,5,1,4,1
"Algeria",22,3,4,3,5,-2,2
"Brazil",22,4,7,7,2,5,1
"Italy",22,4,5,6,2,4,2
"Denmark",22,5,7,5,2,3,1
"Chile",22,5,4,6,3,3,2
"Croatia",22,6,9,6,3,3,1
"France",22,6,4,3,1,2,2
"England",22,7,7,6,1,5,1
"United States",22,7,4,4,7,-3,2
"Netherlands",22,8,7,4,2,2,1
"Argentina",22,8,5,6,2,4,2
"Italy",23,1,9,9,2,7,1
"Qatar",23,1,6,5,3,2,2
"Uruguay",23,4,7,4,0,4,1
"France",23,4,5,3,1,2,2
"Brazil",23,5,7,5,0,5,1
"Tunisia",23,5,6,5,5,0,2
"Poland",23,6,9,7,1,6,1
"Portugal",23,6,6,7,6,1,2
"Belgium",23,8,7,4,1,3,1
"Mexico",23,8,5,5,2,3,2
"Netherlands",24,2,7,5,3,2,1
"England",24,2,6,5,3,2,2
"Italy",24,4,9,7,0,7,1
"Brazil",24,4,6,5,2,3,2
"Portugal",24,5,9,8,1,7,1
"Korea Republic",24,5,4,3,2,1,2
"Chile",24,7,7,4,1,3,1
"Belgium",24,7,6,7,4,3,2
"Argentina",24,8,7,6,2,4,1
"Wales",24,8,6,4,3,1,2
"Germany",25,2,7,4,0,4,1
"Belgium",25,2,4,3,3,0,2
"Denmark",25,3,7,3,0,3,1
"France",25,3,5,4,3,1,2
"Uruguay",25,4,9,5,1,4,1
"Switzerland",25,4,6,5,3,2,2
"Iran",25,5,7,3,0,3,1
"Argentina",25,5,6,9,1,8,2
"Spain",25,6,9,10,2,8,1
"Japan",25,6,4,5,6,-1,2
"Portugal",25,7,7,4,1,3,1
"Croatia",25,7,4,5,5,0,2
"Croatia",26,1,7,6,1,5,1
"Qatar",26,1,6,2,2,0,2
"France",26,2,7,8,2,6,1
"Italy",26,2,5,5,2,3,2
"Argentina",26,5,9,7,0,7,1
"Switzerland",26,5,6,3,4,-1,2
"Spain",26,6,7,6,0,6,1
"Korea Republic",26,6,6,4,4,0,2
"Portugal",26,7,7,6,3,3,1
"Mexico",26,7,4,3,3,0,2
"England",26,8,7,5,3,2,1
"Denmark",26,8,6,6,4,2,2
"Germany",27,1,7,5,0,5,1
"Wales",27,1,5,4,3,1,2
"Belgium",27,2,9,7,0,7,1
"Poland",27,2,6,5,5,0,2
"Netherlands",27,6,7,7,1,6,1
"Argentina",27,6,6,5,5,0,2
"Spain",27,7,7,7,2,5,1
"Uruguay",27,7,4,2,2,0,2
"Portugal",27,8,9,8,3,5,1
"Italy",27,8,6,6,4,2,2
"Spain",28,2,7,4,1,3,1
"Korea Republic",28,2,5,4,3,1,2
"Belgium",28,4,9,10,3,7,1
"Japan",28,4,6,6,3,3,2
"Argentina",28,5,9,11,0,11,1
"United States",28,5,6,2,1,1,2
"Brazil",28,8,9,9,1,8,1
"Italy",28,8,4,2,6,-4,2
"Senegal",29,1,7,4,1,3,1
"Qatar",29,1,4,1,2,-1,2
"England",29,2,7,6,3,3,1
"Italy",29,2,6,7,4,3,2
"Belgium",29,3,9,5,0,5,1
"Croatia",29,3,4,3,4,-1,2
"Denmark",29,4,7,4,2,2,1
"Spain",29,4,6,5,2,3,2
"Korea Republic",29,5,7,4,1,3,1
"Germany",29,5,6,3,3,0,2
"Netherlands",29,7,9,6,0,6,1
"Argentina",29,7,4,2,2,0,2
"France",29,8,7,8,0,8,1
"Uruguay",29,8,5,3,2,1,2
"Qatar",30,1,7,5,3,2,1
"Mexico",30,1,6,7,5,2,2
"Spain",30,2,9,7,0,7,1
"Iran",30,2,4,3,2,1,2
"France",30,5,9,5,0,5,1
"Germany",30,5,6,6,1,5,2
"Belgium",30,6,7,5,1,4,1
"Uruguay",30,6,5,2,1,1,2
"Portugal",31,2,9,7,2,5,1
"Colombia",31,2,4,4,3,1,2
"France",31,3,7,5,3,2,1
"Uruguay",31,3,6,2,1,1,2
"Poland",31,4,7,3,1,2,1
"England",31,4,4,4,4,0,2
"Iran",31,6,9,6,1,5,1
"Mexico",31,6,4,5,2,3,2
"Netherlands",31,7,7,13,2,11,1
"Brazil",31,7,4,5,4,1,2
"Croatia",31,8,6,6,5,1,1
"Spain",31,8,5,4,2,2,2
"Portugal",32,2,7,6,1,5,1
"Chile",32,2,4,2,4,-2,2
"Australia",32,3,7,2,0,2,1
"Brazil",32,3,6,5,4,1,2
"France",32,4,9,5,2,3,1
"Colombia",32,4,4,2,2,0,2
"Italy",32,5,7,4,1,3,1
"Switzerland",32,5,4,5,4,1,2
"Argentina",32,6,9,10,2,8,1
"Netherlands",32,6,4,7,5,2,2
"Korea Republic",32,7,7,4,2,2,1
"Poland",32,7,4,3,2,1,2
"England",32,8,7,4,1,3,1
"Croatia",32,8,4,2,2,0,2
"Germany",33,1,6,5,2,3,1
"Algeria",33,1,5,2,1,1,2
"Mexico",33,3,9,5,0,5,1
"Iran",33,3,4,5,6,-1,2
"Portugal",33,7,9,5,0,5,1
"Uruguay",33,7,6,4,2,2,2
"Spain",33,8,7,5,3,2,1
"Croatia",33,8,5,8,5,3,2
"Wales",34,4,7,5,2,3,1
"Denmark",34,4,6,4,3,1,2
"Spain",34,6,7,5,2,3,1
"Poland",34,6,5,3,2,1,2
"Algeria",34,7,6,3,3,0,1
"Belgium",34,7,5,5,2,3,2
"Italy",34,8,7,10,2,8,1
"Portugal",34,8,4,3,3,0,2
"Netherlands",35,3,7,5,2,3,1
"England",35,3,5,3,0,3,2
"Argentina",35,5,7,5,2,3,1
"Mexico",35,5,5,3,2,1,2
"France",35,6,7,7,3,4,1
"Colombia",35,6,3,2,2,0,2
"Portugal",35,7,7,7,3,4,1
"Korea Republic",35,7,4,4,3,1,2
"Italy",35,8,7,6,3,3,1
"Spain",35,8,5,3,2,1,2
"Netherlands",36,1,7,9,3,6,1
"Qatar",36,1,6,8,4,4,2
"Portugal",36,4,7,5,2,3,1
"Tunisia",36,4,5,4,3,1,2
"Brazil",36,5,9,7,3,4,1
"Mexico",36,5,6,7,3,4,2
"Belgium",36,6,7,6,2,4,1
"United States",36,6,5,3,1,2,2
"Spain",36,7,9,9,1,8,1
"Germany",36,7,6,4,4,0,2
"France",36,8,7,6,1,5,1
"Croatia",36,8,5,2,1,1,2
"Japan",37,3,6,3,3,0,1
"Belgium",37,3,5,3,1,2,2
"England",37,5,9,5,0,5,1
"United States",37,5,4,4,3,1,2
"France",37,6,7,4,2,2,1
"Morocco",37,6,4,3,2,1,2
"Brazil",37,8,9,7,2,5,1
"Iran",37,8,4,4,3,1,2
"France",38,4,7,6,4,2,1
"Costa Rica",38,4,6,4,2,2,2
"Senegal",38,5,7,4,1,3,1
"Germany",38,5,6,2,2,0,2
"Brazil",38,7,9,9,3,6,1
"Mexico",38,7,6,2,2,0,2
"Portugal",38,8,7,4,0,4,1
"Switzerland",38,8,6,4,3,1,2
"United States",39,1,7,6,2,4,1
"Qatar",39,1,4,1,2,-1,2
"Brazil",39,2,7,5,0,5,1
"Costa Rica",39,2,6,5,4,1,2
"Senegal",39,3,7,3,0,3,1
"England",39,3,4,3,1,2,2
"Wales",39,4,7,5,3,2,1
"Colombia",39,4,4,2,2,0,2
"Italy",39,5,9,4,0,4,1
"Switzerland",39,5,4,3,3,0,2
"Belgium",39,6,7,3,1,2,1
"Netherlands",39,6,4,4,4,0,2
"Poland",39,7,9,4,0,4,1
"Spain",39,7,6,3,1,2,2
"Mexico",39,8,9,5,1,4,1
"Argentina",39,8,6,5,3,2,2
"Spain",40,3,7,6,2,4,1
"Denmark",40,3,6,6,6,0,2
"Korea Republic",40,8,7,5,2,3,1
"England",40,8,4,2,2,0,2
"Morocco",41,2,7,4,2,2,1
"Italy",41,2,5,4,3,1,2
"Mexico",41,3,7,7,4,3,1
"Algeria",41,3,6,5,5,0,2
"Netherlands",41,5,7,4,2,2,1
"Chile",41,5,4,4,4,0,2
"France",41,6,9,7,1,6,1
"Germany",41,6,4,3,2,1,2
"Brazil",41,7,7,4,2,2,1
"Denmark",41,7,5,2,1,1,2
"Belgium",41,8,9,6,0,6,1
"Australia",41,8,6,5,2,3,2
"Germany",42,2,7,2,0,2,1
"Brazil",42,2,6,6,2,4,2
"France",42,5,7,6,0,6,1
"Switzerland",42,5,6,8,4,4,2
"Argentina",42,6,7,4,1,3,1
"Senegal",42,6,6,4,2,2,2
"Mexico",43,1,9,4,0,4,1
"Chile",43,1,6,6,2,4,2
"France",43,2,7,11,3,8,1
"Tunisia",43,2,5,5,2,3,2
"United States",43,4,6,3,2,1,1
"Belgium",43,4,5,4,2,2,2
"Netherlands",43,5,7,6,3,3,1
"Argentina",43,5,6,6,4,2,2
"Germany",43,8,7,10,4,6,1
"Brazil",43,8,6,5,3,2,2
"Qatar",44,1,9,7,4,3,1
"Italy",44,1,4,3,3,0,2
"Spain",44,4,7,6,4,2,1
"Uruguay",44,4,5,6,3,3,2
"Belgium",44,8,9,5,0,5,1
"Mexico",44,8,6,4,2,2,2
"Croatia",45,1,7,5,2,3,1
"Qatar",45,1,5,4,2,2,2
"Brazil",45,2,7,3,1,2,1
"Netherlands",45,2,6,7,3,4,2
"Germany",45,4,7,5,1,4,1
"Argentina",45,4,5,5,1,4,2
"France",45,6,9,8,1,7,1
"Uruguay",45,6,6,6,4,2,2
"Belgium",45,7,9,9,2,7,1
"Japan",45,7,6,4,4,0,2
"Nigeria",46,1,9,7,1,6,1
"Wales",46,1,4,3,5,-2,2
"England",46,2,9,8,2,6,1
"Poland",46,2,6,2,2,0,2
"France",46,3,5,2,1,1,1
"United States",46,3,4,4,4,0,2
"Brazil",46,4,7,5,1,4,1
"Japan",46,4,6,4,5,-1,2
"Colombia",46,5,7,5,3,2,1
"Portugal",46,5,4,6,3,3,2
"Argentina",46,8,9,7,0,7,1
"Croatia",46,8,6,4,2,2,2
"Brazil",47,2,9,6,1,5,1
"Senegal",47,2,6,5,2,3,2
"France",47,4,9,5,0,5,1
"Colombia",47,4,6,4,2,2,2
"Mexico",48,3,9,5,1,4,1
"Chile",48,3,6,4,3,1,2
"France",48,7,9,5,1,4,1
"Italy",48,7,6,4,2,2,2
"Senegal",49,1,7,4,1,3,1
"Colombia",49,1,6,2,2,0,2
"Brazil",49,3,7,6,1,5,1
"Iran",49,3,4,4,5,-1,2
"Korea Republic",49,4,6,5,2,3,1
"Belgium",49,4,5,2,1,1,2
"France",49,5,7,6,0,6,1
"Australia",49,5,5,3,2,1,2
"Germany",49,6,7,7,1,6,1
"Portugal",49,6,6,7,3,4,2
"Switzerland",49,7,9,5,0,5,1
"Argentina",49,7,6,4,2,2,2
"Spain",49,8,9,12,1,11,1
"Uruguay",49,8,6,4,5,-1,2
"France",50,3,9,7,0,7,1
"Germany",50,3,4,4,4,0,2
"Brazil",50,4,9,9,1,8,1
"Costa Rica",50,4,4,1,2,-1,2
"Japan",50,5,9,4,1,3,1
"Italy",50,5,4,6,2,4,2
"Spain",50,6,9,8,0,8,1
"Uruguay",50,6,6,4,5,-1,2
"England",50,7,7,4,2,2,1
"Australia",50,7,5,2,1,1,2
"Nigeria",50,8,7,3,1,2,1
"Portugal",50,8,5,5,4,1,2
"Croatia",51,4,9,5,1,4,1
"Belgium",51,4,6,3,1,2,2
"Brazil",51,6,7,4,1,3,1
"Senegal",51,6,4,3,4,-1,2
"Portugal",51,8,9,7,2,5,1
"Mexico",51,8,6,7,6,1,2
"Colombia",52,1,7,8,2,6,1
"Wales",52,1,6,4,2,2,2
"Uruguay",52,5,9,6,0,6,1
"Portugal",52,5,6,4,1,3,2
"Korea Republic",52,6,7,4,1,3,1
"Denmark",52,6,5,4,2,2,2
"Spain",52,7,9,9,0,9,1
"Croatia",52,7,6,5,4,1,2
"Italy",54,1,7,4,1,3,1
"Qatar",54,1,5,3,2,1,2
"Portugal",54,4,9,9,5,4,1
"Mexico",54,4,6,7,5,2,2
"Germany",54,5,7,7,3,4,1
"Jamaica",54,5,4,4,4,0,2
"Brazil",54,7,9,11,1,10,1
"Netherlands",54,7,6,4,2,2,2
"Uruguay",54,8,9,5,0,5,1
"Spain",54,8,6,7,1,6,2
"Brazil",55,2,9,9,1,8,1
"Japan",55,2,4,4,5,-1,2
"Belgium",55,3,7,7,5,2,1
"Uruguay",55,3,6,8,5,3,2
"Germany",55,7,7,7,1,6,1
"Spain",55,7,4,3,2,1,2
"Mexico",56,1,7,4,2,2,1
"Algeria",56,1,4,2,2,0,2
"Brazil",56,2,7,6,1,5,1
"Germany",56,2,5,6,2,4,2
"Portugal",56,5,9,10,1,9,1
"Colombia",56,5,4,2,2,0,2
"Uruguay",56,6,7,5,2,3,1
"Belgium",56,6,5,3,1,2,2
"England",56,7,9,7,0,7,1
"Wales",56,7,6,8,3,5,2
"Spain",56,8,9,6,1,5,1
"Netherlands",56,8,6,7,4,3,2
"Denmark",57,1,9,4,0,4,1
"Jamaica",57,1,6,2,2,0,2
"Italy",57,2,7,6,2,4,1
"Portugal",57,2,5,7,5,2,2
"Belgium",57,5,7,7,2,5,1
"Senegal",57,5,5,5,3,2,2
"England",57,7,7,4,2,2,1
"Morocco",57,7,6,5,3,2,2
"Germany",58,2,9,9,2,7,1
"Argentina",58,2,4,4,5,-1,2
"France",58,4,9,3,0,3,1
"Netherlands",58,4,6,6,1,5,2
"Belgium",58,5,7,6,0,6,1
"Uruguay",58,5,4,2,3,-1,2
"England",58,7,9,3,0,3,1
"Chile",58,7,6,2,1,1,2
"Colombia",59,1,7,8,3,5,1
"Qatar",59,1,4,4,5,-1,2
"England",59,3,9,7,1,6,1
"Uruguay",59,3,6,8,5,3,2
"Australia",59,4,7,7,1,6,1
"Brazil",59,4,5,3,1,2,2
"Denmark",59,5,9,9,1,8,1
"Argentina",59,5,6,5,4,1,2
"France",59,6,9,8,1,7,1
"Chile",59,6,6,5,3,2,2
"Mexico",59,7,6,5,3,2,1
"Portugal",59,7,5,4,2,2,2
"Colombia",60,1,7,4,0,4,1
"Qatar",60,1,4,1,1,0,2
"France",60,2,7,8,3,5,1
"Australia",60,2,4,3,4,-1,2
"Mexico",60,4,9,4,0,4,1
"Portugal",60,4,6,3,2,1,2
"Brazil",60,5,9,9,0,9,1
"United States",60,5,6,5,4,1,2
"Belgium",60,7,9,5,1,4,1
"Netherlands",60,7,6,7,2,5,2
"Belgium",61,3,9,5,1,4,1
"Korea Republic",61,3,6,3,1,2,2
"Netherlands",61,4,9,5,0,5,1
"Spain",61,4,4,3,4,-1,2
"Brazil",61,7,7,5,2,3,1
"Australia",61,7,4,6,3,3,2
"Uruguay",61,8,7,8,2,6,1
"Portugal",61,8,5,4,3,1,2
"Brazil",62,4,9,7,2,5,1
"Germany",62,4,6,4,3,1,2
"Argentina",62,5,7,4,0,4,1
"Tunisia",62,5,6,2,2,0,2
"Australia",62,6,7,5,1,4,1
"Colombia",62,6,4,4,4,0,2
"Netherlands",63,4,9,8,1,7,1
"Australia",63,4,6,4,3,1,2
"Brazil",63,7,7,7,1,6,1
"Italy",63,7,5,1,0,1,2
"Uruguay",64,3,7,5,1,4,1
"England",64,3,6,4,2,2,2
"Italy",64,5,7,2,0,2,1
"United States",64,5,4,5,5,0,2
"Japan",64,6,9,5,0,5,1
"Argentina",64,6,4,3,1,2,2
"Colombia",64,7,7,5,2,3,1
"Belgium",64,7,5,5,3,2,2
"Costa Rica",64,8,7,4,2,2,1
"Spain",64,8,5,6,4,2,2
"Brazil",65,2,7,3,1,2,1
"Korea Republic",65,2,4,3,3,0,2
"England",65,7,9,5,2,3,1
"Costa Rica",65,7,6,3,2,1,2
"Belgium",65,8,9,6,2,4,1
"Italy",65,8,6,6,5,1,2
"Brazil",66,2,7,8,3,5,1
"Switzerland",66,2,4,3,6,-3,2
"Portugal",66,3,9,6,0,6,1
"Germany",66,3,4,3,2,1,2
"Italy",66,4,7,4,1,3,1
"Belgium",66,4,5,5,1,4,2
"England",66,6,9,10,0,10,1
"Korea Republic",66,6,6,4,5,-1,2
"Colombia",66,8,7,5,3,2,1
"France",66,8,6,8,3,5,2
"Croatia",67,1,9,7,1,6,1
"Poland",67,1,6,5,3,2,2
"England",67,3,7,4,2,2,1
"Senegal",67,3,6,3,2,1,2
"Portugal",67,4,7,5,2,3,1
"Wales",67,4,6,7,3,4,2
"Spain",67,5,7,7,1,6,1
"Netherlands",67,5,5,5,2,3,2
"Switzerland",67,6,6,6,5,1,1
"Italy",67,6,5,5,1,4,2
"Argentina",67,7,7,4,1,3,1
"Denmark",67,7,6,5,3,2,2
"Mexico",68,3,9,8,2,6,1
"Belgium",68,3,6,4,2,2,2
"Italy",68,4,5,4,2,2,1
"Senegal",68,4,4,4,5,-1,2
"Germany",68,6,9,6,1,5,1
"Spain",68,6,6,6,4,2,2
"United States",68,7,7,5,3,2,1
"Brazil",68,7,6,4,3,1,2
"Uruguay",68,8,9,7,3,4,1
"France",68,8,6,4,3,1,2
"Spain",69,2,7,6,1,5,1
"Colombia",69,2,4,3,3,0,2
"England",69,3,9,4,0,4,1
"Germany",69,3,4,2,2,0,2
"Belgium",69,8,7,3,0,3,1
"Mexico",69,8,6,2,2,0,2
"Denmark",70,1,9,10,3,7,1
"Nigeria",70,1,4,4,7,-3,2
"Brazil",70,3,9,5,1,4,1
"Japan",70,3,6,6,3,3,2
"France",70,4,7,6,3,3,1
"Mexico",70,4,4,2,2,0,2
"Argentina",70,5,7,8,1,7,1
"Croatia",70,5,6,8,5,3,2
"Algeria",70,6,7,5,0,5,1
"Colombia",70,6,4,2,2,0,2
"Qatar",71,1,7,5,1,4,1
"Algeria",71,1,5,4,3,1,2
"Brazil",71,2,9,8,1,7,1
"Denmark",71,2,4,4,3,1,2
"Argentina",71,4,9,9,2,7,1
"Netherlands",71,4,4,4,6,-2,2
"Iran",71,5,9,7,2,5,1
"Germany",71,5,6,4,4,0,2
"Spain",71,6,9,8,1,7,1
"Wales",71,6,4,5,4,1,2
"Mexico",71,8,7,6,4,2,1
"Australia",71,8,4,5,5,0,2
"Switzerland",72,2,7,5,2,3,1
"Denmark",72,2,6,5,4,1,2
"Brazil",72,5,9,7,2,5,1
"Netherlands",72,5,6,6,3,3,2
"Belgium",72,7,9,8,2,6,1
"Poland",72,7,4,2,4,-2,2
"Spain",72,8,7,6,0,6,1
"Uruguay",72,8,5,4,2,2,2
"Brazil",73,4,9,11,1,10,1
"Croatia",73,4,6,5,4,1,2
"Jamaica",74,1,9,9,3,6,1
"Tunisia",74,1,4,4,4,0,2
"Spain",74,3,9,8,4,4,1
"Mexico",74,3,6,6,4,2,2
"Belgium",74,4,7,6,3,3,1
"Korea Republic",74,4,6,5,5,0,2
"Uruguay",74,5,9,6,2,4,1
"England",74,5,6,6,3,3,2
"Argentina",74,6,7,9,4,5,1
"Morocco",74,6,4,8,8,0,2
"Denmark",74,7,7,6,4,2,1
"Portugal",74,7,4,2,2,0,2
"Brazil",74,8,9,3,0,3,1
"Wales",74,8,4,2,2,0,2
"Germany",75,1,7,6,3,3,1
"Qatar",75,1,5,5,4,1,2
"France",75,2,9,5,1,4,1
"Netherlands",75,2,6,3,2,1,2
"Belgium",75,3,7,4,2,2,1
"Denmark",75,3,4,5,5,0,2
"England",75,6,7,5,2,3,1
"Wales",75,6,4,3,1,2,2
"Nigeria",75,7,9,5,2,3,1
"Spain",75,7,4,5,4,1,2
"Portugal",75,8,7,4,2,2,1
"Italy",75,8,6,4,3,1,2
"Colombia",76,1,6,4,3,1,1
"Algeria",76,1,5,2,1,1,2
"Belgium",76,2,9,7,0,7,1
"Denmark",76,2,6,4,1,3,2
"Iran",76,3,9,9,1,8,1
"England",76,3,4,4,4,0,2
"Germany",76,5,7,9,4,5,1
"Argentina",76,5,5,6,3,3,2
"France",76,6,9,8,1,7,1
"Uruguay",76,6,6,7,2,5,2
"Portugal",76,7,7,5,2,3,1
"Netherlands",76,7,4,4,4,0,2
"Croatia",76,8,6,11,4,7,1
"Tunisia",76,8,5,4,3,1,2
"Qatar",77,1,7,6,3,3,1
"Mexico",77,1,6,7,5,2,2
"Portugal",77,4,7,6,1,5,1
"Uruguay",77,4,5,5,4,1,2
"Australia",77,6,7,4,1,3,1
"Croatia",77,6,6,2,2,0,2
"Wales",77,8,7,5,1,4,1
"Denmark",77,8,5,4,2,2,2
"Germany",78,1,9,6,0,6,1
"Poland",78,1,6,5,5,0,2
"Italy",78,2,9,4,0,4,1
"Argentina",78,2,6,5,2,3,2
"Spain",78,6,9,5,2,3,1
"Australia",78,6,6,7,3,4,2
"England",78,7,9,4,0,4,1
"Mexico",78,7,6,7,3,4,2
"Algeria",78,8,9,8,3,5,1
"Portugal",78,8,4,8,7,1,2
"Italy",79,2,6,7,3,4,1
"Argentina",79,2,5,6,5,1,2
"Portugal",79,5,9,12,1,11,1
"Germany",79,5,6,7,4,3,2
"Belgium",79,6,9,7,2,5,1
"Switzerland",79,6,4,5,4,1,2
"Qatar",80,1,9,6,1,5,1
"Poland",80,1,6,5,3,2,2
"England",80,2,7,6,1,5,1
"Denmark",80,2,4,1,4,-3,2
"Spain",80,3,7,3,1,2,1
"Japan",80,3,6,4,3,1,2
"Korea Republic",80,7,9,4,1,3,1
"Belgium",80,7,4,6,4,2,2
"Brazil",80,8,7,5,1,4,1
"United States",80,8,6,3,2,1,2
"Italy",81,1,9,6,0,6,1
"Tunisia",81,1,4,3,3,0,2
"Croatia",81,2,7,4,1,3,1
"France",81,2,6,2,1,1,2
"Mexico",81,3,7,7,5,2,1
"Argentina",81,3,6,7,3,4,2
"Brazil",81,4,9,9,0,9,1
"Germany",81,4,6,10,4,6,2
"Belgium",81,5,9,4,0,4,1
"Switzerland",81,5,6,3,1,2,2
"Brazil",82,2,9,8,3,5,1
"Switzerland",82,2,6,5,2,3,2
"Uruguay",82,3,7,5,3,2,1
"Spain",82,3,6,3,1,2,2
"Mexico",82,7,9,6,1,5,1
"France",82,7,4,3,1,2,2
"Belgium",82,8,9,8,2,6,1
"Colombia",82,8,6,5,5,0,2
"Uruguay",83,1,7,8,2,6,1
"Senegal",83,1,5,4,2,2,2
"Mexico",83,2,7,5,1,4,1
"Argentina",83,2,5,3,1,2,2
"Spain",83,3,9,6,2,4,1
"Colombia",83,3,6,6,4,2,2
"England",83,6,7,9,3,6,1
"Germany",83,6,6,7,7,0,2
"Japan",83,7,7,7,2,5,1
"Brazil",83,7,6,11,4,7,2
"Belgium",83,8,7,5,2,3,1
"Switzerland",83,8,5,3,1,2,2
"Poland",84,3,6,5,3,2,1
"Colombia",84,3,5,4,2,2,2
"Netherlands",84,4,9,4,0,4,1
"Japan",84,4,4,2,2,0,2
"Iran",84,5,7,4,1,3,1
"Argentina",84,5,5,3,2,1,2
"France",84,6,6,5,1,4,1
"Mexico",84,6,5,3,2,1,2
"Croatia",85,1,7,3,1,2,1
"Qatar",85,1,6,4,2,2,2
"Mexico",85,3,7,5,2,3,1
"Switzerland",85,3,4,3,3,0,2
"Argentina",85,4,9,8,0,8,1
"Germany",85,4,6,4,3,1,2
"England",85,6,9,8,2,6,1
"Uruguay",85,6,6,5,4,1,2
"France",85,7,9,7,1,6,1
"Colombia",85,7,4,1,1,0,2
"Costa Rica",85,8,6,2,2,0,1
"Spain",85,8,5,3,1,2,2
"Qatar",86,1,7,4,2,2,1
"Italy",86,1,5,3,2,1,2
"Uruguay",86,2,7,6,3,3,1
"France",86,2,4,6,4,2,2
"Croatia",86,4,6,3,1,2,1
"Switzerland",86,4,5,4,3,1,2
"Belgium",86,5,7,4,2,2,1
"Iran",86,5,5,3,2,1,2
"Portugal",86,7,9,8,1,7,1
"Colombia",86,7,6,5,3,2,2
"England",86,8,7,6,2,4,1
"Wales",86,8,4,7,8,-1,2
"Denmark",87,1,7,8,1,7,1
"Tunisia",87,1,4,4,7,-3,2
"France",87,3,9,4,1,3,1
"Australia",87,3,4,4,3,1,2
"Colombia",87,4,7,6,2,4,1
"Belgium",87,4,5,6,4,2,2
"Argentina",87,7,7,6,1,5,1
"Netherlands",87,7,5,2,1,1,2
"Uruguay",88,1,7,5,1,4,1
"Qatar",88,1,4,2,3,-1,2
"Switzerland",88,2,5,4,3,1,1
"Korea Republic",88,2,4,2,2,0,2
"Argentina",88,3,7,5,2,3,1
"Mexico",88,3,4,2,2,0,2
"Brazil",88,4,9,8,2,6,1
"Netherlands",88,4,4,5,3,2,2
"Spain",88,5,7,6,1,5,1
"Morocco",88,5,6,3,4,-1,2
"Croatia",88,6,7,5,2,3,1
"Iran",88,6,5,6,5,1,2
"England",88,7,7,6,4,2,1
"Denmark",88,7,4,4,4,0,2
"Australia",89,2,7,3,1,2,1
"Chile",89,2,3,4,4,0,2
"Spain",89,3,9,6,2,4,1
"Korea Republic",89,3,6,10,4,6,2
"Netherlands",89,4,7,5,2,3,1
"Belgium",89,4,6,7,5,2,2
"Mexico",89,5,9,8,3,5,1
"Argentina",89,5,4,4,4,0,2
"Portugal",89,6,7,7,1,6,1
"Croatia",89,6,6,5,5,0,2
"France",89,8,9,5,0,5,1
"Colombia",89,8,4,3,3,0,2
"Denmark",90,1,9,7,4,3,1
"Poland",90,1,6,5,4,1,2
"Wales",90,2,7,4,2,2,1
"Italy",90,2,5,6,5,1,2
"Belgium",90,3,7,6,1,5,1
"Germany",90,3,6,6,4,2,2
"Australia",90,4,7,7,1,6,1
"Mexico",90,4,5,3,2,1,2
"England",90,5,7,4,0,4,1
"Colombia",90,5,6,4,1,3,2
"Netherlands",90,6,6,6,4,2,1
"Portugal",90,6,5,3,2,1,2
"France",90,7,7,2,0,2,1
"Croatia",90,7,6,5,1,4,2
"Iran",90,8,7,4,2,2,1
"Spain",90,8,4,5,3,2,2
"Qatar",91,1,9,4,1,3,1
"Poland",91,1,6,6,4,2,2
"Spain",91,3,7,5,2,3,1
"Germany",91,3,5,8,6,2,2
"France",91,4,7,4,0,4,1
"Tunisia",91,4,4,2,3,-1,2
"Belgium",91,5,7,7,2,5,1
"Mexico",91,5,3,2,2,0,2
"Portugal",91,7,9,8,1,7,1
"Uruguay",91,7,6,4,1,3,2
"England",91,8,6,3,3,0,1
"Jamaica",91,8,5,4,1,3,2
"Belgium",92,3,7,5,2,3,1
"Uruguay",92,3,6,4,2,2,2
"Argentina",92,4,9,7,1,6,1
"Italy",92,4,6,9,5,4,2
"Spain",92,7,9,8,1,7,1
"Iran",92,7,6,3,3,0,2
"Brazil",92,8,7,3,1,2,1
"Croatia",92,8,4,2,2,0,2
"Argentina",93,2,7,6,2,4,1
"United States",93,2,4,3,4,-1,2
"Uruguay",93,3,9,6,2,4,1
"Switzerland",93,3,6,5,4,1,2
"Spain",93,4,9,13,1,12,1
"Colombia",93,4,4,2,5,-3,2
"England",93,6,7,5,1,4,1
"Chile",93,6,6,4,4,0,2
"Netherlands",93,7,7,5,3,2,1
"Belgium",93,7,5,5,2,3,2
"Brazil",93,8,9,5,1,4,1
"Croatia",93,8,4,2,2,0,2
"Uruguay",94,1,7,4,1,3,1
"United States",94,1,6,6,4,2,2
"France",94,2,9,7,2,5,1
"Croatia",94,2,4,1,1,0,2
"Brazil",94,3,7,6,0,6,1
"Germany",94,3,6,5,4,1,2
"Italy",94,6,7,5,3,2,1
"England",94,6,5,4,3,1,2
"Argentina",94,8,7,6,2,4,1
"Mexico",94,8,6,3,1,2,2
"Denmark",95,1,7,5,2,3,1
"Qatar",95,1,6,7,1,6,2
"Mexico",95,4,7,4,2,2,1
"England",95,4,5,3,2,1,2
"Portugal",95,5,7,7,4,3,1
"Germany",95,5,6,5,2,3,2
"Spain",95,6,7,8,3,5,1
"Colombia",95,6,5,6,5,1,2
"Argentina",95,7,7,5,2,3,1
"Tunisia",95,7,4,5,5,0,2
"Italy",95,8,9,7,2,5,1
"Belgium",95,8,6,3,1,2,2
"Qatar",96,1,7,5,1,4,1
"Senegal",96,1,5,4,1,3,2
"Japan",96,2,7,3,1,2,1
"Uruguay",96,2,6,5,3,2,2
"Spain",96,3,9,11,0,11,1
"Germany",96,3,4,2,4,-2,2
"Brazil",96,4,7,8,3,5,1
"Wales",96,4,5,2,1,1,2
"Belgium",96,7,9,7,0,7,1
"Jamaica",96,7,4,5,5,0,2
"United States",96,8,7,3,1,2,1
"England",96,8,6,5,3,2,2
"Italy",97,1,9,4,1,3,1
"Algeria",97,1,6,4,2,2,2
"Iran",97,3,6,8,5,3,1
"Uruguay",97,3,5,5,3,2,2
"France",97,5,7,7,2,5,1
"Germany",97,5,6,7,5,2,2
"Morocco",97,6,7,4,0,4,1
"Portugal",97,6,5,5,2,3,2
"Mexico",97,7,7,5,3,2,1
"Brazil",97,7,6,5,2,3,2
"Colombia",98,1,7,5,2,3,1
"Qatar",98,1,5,5,3,2,2
"Italy",98,3,9,9,1,8,1
"Brazil",98,3,6,9,3,6,2
"Portugal",98,5,7,5,2,3,1
"Denmark",98,5,6,3,1,2,2
"Argentina",98,6,9,4,0,4,1
"Australia",98,6,6,3,2,1,2
"Tunisia",99,1,9,6,1,5,1
"Germany",99,1,6,4,1,3,2
"Wales",99,3,7,3,1,2,1
"Croatia",99,3,6,4,3,1,2
"Korea Republic",99,4,7,5,3,2,1
"Spain",99,4,5,5,4,1,2
"Poland",99,5,7,3,0,3,1
"Iran",99,5,6,3,3,0,2
"France",99,7,9,6,0,6,1
"Chile",99,7,4,4,4,0,2
"Denmark",99,8,7,4,2,2,1
"England",99,8,4,4,2,2,2
"Portugal",100,2,7,6,1,5,1
"Colombia",100,2,5,6,3,3,2
"Netherlands",100,3,7,5,2,3,1
"Brazil",100,3,5,8,1,7,2
"Mexico",100,6,6,5,5,0,1
"Iran",100,6,5,6,4,2,2
"Italy",100,7,7,4,0,4,1
"France",100,7,4,2,2,0,2
"Croatia",100,8,6,4,2,2,1
"Poland",100,8,5,3,2,1,2
"Colombia",101,1,9,8,2,6,1
"Qatar",101,1,6,3,3,0,2
"Brazil",101,2,7,8,4,4,1
"Denmark",101,2,6,9,3,6,2
"Germany",101,4,9,8,3,5,1
"Korea Republic",101,4,4,2,2,0,2
"Netherlands",101,7,9,4,0,4,1
"Poland",101,7,4,9,2,7,2
"Italy",102,1,7,5,0,5,1
"Chile",102,1,6,4,4,0,2
"Wales",102,2,9,7,2,5,1
"Korea Republic",102,2,6,3,3,0,2
"Brazil",102,3,7,5,1,4,1
"Poland",102,3,5,4,3,1,2
"France",102,5,9,7,2,5,1
"Germany",102,5,4,5,4,1,2
"Spain",102,6,7,3,0,3,1
"Senegal",102,6,6,2,1,1,2
"Portugal",103,3,7,11,2,9,1
"Mexico",103,3,4,3,8,-5,2
"Denmark",103,4,7,6,2,4,1
"England",103,4,6,6,4,2,2
"Australia",103,5,9,7,1,6,1
"Argentina",103,5,6,5,2,3,2
"Uruguay",103,6,9,7,1,6,1
"Belgium",103,6,6,5,2,3,2
"Poland",104,1,7,5,2,3,1
"Germany",104,1,6,7,2,5,2
"England",104,2,6,6,6,0,1
"Mexico",104,2,5,6,3,3,2
"Brazil",104,4,7,8,3,5,1
"Switzerland",104,4,4,5,5,0,2
"Italy",104,6,9,5,1,4,1
"Australia",104,6,4,3,3,0,2
"Belgium",104,8,7,5,2,3,1
"Croatia",104,8,5,4,3,1,2
"Qatar",105,1,7,5,2,3,1
"Switzerland",105,1,3,2,2,0,2
"Colombia",105,5,5,3,1,2,1
"Portugal",105,5,4,2,3,-1,2
"Spain",105,7,7,7,1,6,1
"Germany",105,7,6,3,2,1,2
"Netherlands",105,8,7,4,2,2,1
"United States",105,8,4,2,4,-2,2
"Netherlands",106,1,9,8,1,7,1
"Wales",106,1,4,3,6,-3,2
"Morocco",106,3,7,6,3,3,1
"Argentina",106,3,4,4,3,1,2
"Spain",106,4,7,3,1,2,1
"Switzerland",106,4,6,3,2,1,2
"Denmark",106,5,7,5,1,4,1
"Belgium",106,5,6,5,3,2,2
"Brazil",107,2,7,7,1,6,1
"Italy",107,2,5,3,2,1,2
"Iran",107,3,7,4,1,3,1
"France",107,3,6,4,2,2,2
"Wales",107,4,9,4,0,4,1
"Argentina",107,4,6,3,3,0,2
"Switzerland",107,5,6,9,3,6,1
"Portugal",107,5,5,4,2,2,2
"Netherlands",108,1,9,11,4,7,1
"Morocco",108,1,6,5,4,1,2
"Belgium",108,2,9,7,1,6,1
"Australia",108,2,6,5,3,2,2
"Mexico",108,3,9,5,0,5,1
"Korea Republic",108,3,6,2,1,1,2
"Spain",108,4,7,6,3,3,1
"Tunisia",108,4,4,3,4,-1,2
"Colombia",108,5,6,7,3,4,1
"Japan",108,5,5,4,3,1,2
"France",108,6,9,14,3,11,1
"Iran",108,6,6,6,8,-2,2
"Brazil",108,7,9,7,1,6,1
"Denmark",108,7,6,6,2,4,2
"Belgium",109,2,9,9,3,6,1
"Chile",109,2,6,3,3,0,2
"France",109,3,9,8,1,7,1
"Italy",109,3,4,3,5,-2,2
"Argentina",109,4,7,6,1,5,1
"Costa Rica",109,4,4,3,6,-3,2
"Colombia",109,5,9,4,0,4,1
"England",109,5,4,5,3,2,2
"Spain",109,6,9,5,1,4,1
"Netherlands",109,6,4,3,3,0,2
"Portugal",109,7,7,7,0,7,1
"Germany",109,7,6,4,3,1,2
"Netherlands",110,1,7,5,2,3,1
"Switzerland",110,1,6,5,2,3,2
"Croatia",110,4,7,8,1,7,1
"Brazil",110,4,5,5,2,3,2
"Japan",110,5,7,4,1,3,1
"Uruguay",110,5,6,4,4,0,2
"France",110,6,9,4,0,4,1
"Colombia",110,6,4,2,2,0,2
"Germany",110,8,6,6,2,4,1
"Australia",110,8,5,4,3,1,2
"Netherlands",111,1,7,3,1,2,1
"Qatar",111,1,5,3,2,1,2
"England",111,2,7,5,3,2,1
"Mexico",111,2,6,6,3,3,2
"Brazil",111,4,7,7,2,5,1
"United States",111,4,6,4,3,1,2
"Argentina",111,8,9,8,1,7,1
"Croatia",111,8,6,3,2,1,2
"Chile",112,1,6,4,3,1,1
"Croatia",112,1,5,6,3,3,2
"Argentina",112,6,9,10,1,9,1
"Netherlands",112,6,4,5,3,2,2
"England",112,7,9,5,1,4,1
"Costa Rica",112,7,6,6,3,3,2
"Uruguay",112,8,7,3,1,2,1
"Belgium",112,8,4,3,2,1,2
"England",113,2,9,9,1,8,1
"Italy",113,2,6,4,3,1,2
"Portugal",113,4,7,6,3,3,1
"Mexico",113,4,5,4,1,3,2
"Argentina",113,5,7,6,2,4,1
"Denmark",113,5,4,5,5,0,2
"Germany",113,7,7,12,2,10,1
"Brazil",113,7,5,3,2,1,2
"Belgium",113,8,9,6,0,6,1
"Morocco",113,8,6,4,4,0,2
"Germany",114,1,7,8,1,7,1
"Qatar",114,1,4,4,4,0,2
"Australia",114,4,7,5,2,3,1
"Argentina",114,4,5,4,2,2,2
"Brazil",114,5,7,6,3,3,1
"Croatia",114,5,4,4,4,0,2
"Spain",114,6,7,6,2,4,1
"Colombia",114,6,5,8,3,5,2
"France",114,7,7,7,1,6,1
"Denmark",114,7,5,5,4,1,2
"Poland",114,8,7,6,4,2,1
"England",114,8,6,4,3,1,2
"Mexico",115,1,9,5,1,4,1
"Poland",115,1,6,4,3,1,2
"Italy",115,4,5,6,3,3,1
"Switzerland",115,4,4,3,5,-2,2
"Germany",115,6,7,5,2,3,1
"Argentina",115,6,6,5,2,3,2
"Belgium",115,8,9,11,2,9,1
"Iran",115,8,6,4,3,1,2
"Uruguay",116,1,9,7,1,6,1
"Poland",116,1,6,6,4,2,2
"Portugal",116,2,7,7,2,5,1
"Iran",116,2,6,5,6,-1,2
"England",116,3,7,7,1,6,1
"Algeria",116,3,6,4,4,0,2
"Belgium",116,7,7,4,0,4,1
"Colombia",116,7,6,3,3,0,2
"Netherlands",117,3,7,2,0,2,1
"England",117,3,6,4,2,2,2
"Korea Republic",117,4,9,5,2,3,1
"Portugal",117,4,6,4,3,1,2
"Spain",117,6,7,3,1,2,1
"Denmark",117,6,5,5,3,2,2
"Germany",117,7,7,5,1,4,1
"Brazil",117,7,5,4,1,3,2
"France",117,8,7,4,0,4,1
"Uruguay",117,8,5,1,0,1,2
"Qatar",118,1,7,4,1,3,1
"Denmark",118,1,5,4,2,2,2
"Spain",118,2,9,8,3,5,1
"Japan",118,2,4,5,5,0,2
"Mexico",118,6,6,8,6,2,1
"Korea Republic",118,6,5,6,3,3,2
"Germany",119,2,7,7,2,5,1
"Korea Republic",119,2,5,3,1,2,2
"Spain",119,3,9,7,1,6,1
"Italy",119,3,6,5,2,3,2
"England",119,5,9,9,2,7,1
"Australia",119,5,6,5,5,0,2
"Portugal",119,6,7,4,2,2,1
"United States",119,6,6,3,1,2,2
"Argentina",119,8,9,5,2,3,1
"Croatia",119,8,6,7,4,3,2
"Germany",120,1,7,5,1,4,1
"Qatar",120,1,4,4,4,0,2
"Brazil",120,2,7,8,3,5,1
"Iran",120,2,6,4,4,0,2
"Portugal",120,3,7,5,1,4,1
"Nigeria",120,3,5,3,1,2,2
"Mexico",120,4,9,6,1,5,1
"England",120,4,6,4,3,1,2
"Spain",120,5,9,6,1,5,1
"Colombia",120,5,4,3,2,1,2
"Korea Republic",120,6,9,6,0,6,1
"Belgium",120,6,6,3,3,0,2
"Uruguay",121,1,7,4,0,4,1
"Qatar",121,1,6,3,2,1,2
"France",121,4,7,5,3,2,1
"Poland",121,4,5,3,1,2,2
"Argentina",121,6,9,8,2,6,1
"Japan",121,6,6,5,5,0,2
"Morocco",122,2,7,3,1,2,1
"Denmark",122,2,5,4,3,1,2
"Brazil",122,4,9,16,1,15,1
"Italy",122,4,6,4,4,0,2
"Argentina",122,5,6,4,2,2,1
"Mexico",122,5,5,3,2,1,2
"Netherlands",122,6,7,7,2,5,1
"Chile",122,6,6,4,2,2,2
"Germany",122,7,7,6,3,3,1
"Poland",122,7,4,5,5,0,2
"France",122,8,7,5,2,3,1
"Algeria",122,8,4,5,4,1,2
"Croatia",123,1,9,7,0,7,1
"Qatar",123,1,4,6,5,1,2
"Japan",123,2,9,5,0,5,1
"Uruguay",123,2,6,3,3,0,2
"Argentina",123,3,9,5,1,4,1
"Tunisia",123,3,4,2,3,-1,2
"Portugal",123,4,9,4,0,4,1
"Colombia",123,4,6,3,2,1,2
"Belgium",123,5,7,8,2,6,1
"Germany",123,5,6,5,5,0,2
"Brazil",123,6,9,11,0,11,1
"Poland",123,6,6,2,4,-2,2
"Switzerland",123,7,7,4,2,2,1
"Spain",123,7,6,6,2,4,2
"Wales",124,1,7,4,1,3,1
"Uruguay",124,1,6,7,2,5,2
"Colombia",124,3,7,6,2,4,1
"Australia",124,3,4,5,3,2,2
"France",124,4,7,5,1,4,1
"Croatia",124,4,5,4,2,2,2
"Netherlands",124,5,9,8,0,8,1
"Belgium",124,5,4,4,3,1,2
"Algeria",125,2,7,8,4,4,1
"Portugal",125,2,6,6,3,3,2
"Italy",125,3,7,4,1,3,1
"France",125,3,5,5,3,2,2
"Spain",125,4,9,5,1,4,1
"Uruguay",125,4,6,6,2,4,2
"Brazil",125,7,7,7,3,4,1
"Germany",125,7,5,4,3,1,2
"Belgium",125,8,6,3,3,0,1
"Iran",125,8,5,4,2,2,2
"Brazil",126,2,7,5,1,4,1
"Germany",126,2,6,5,2,3,2
"France",126,3,9,6,0,6,1
"Netherlands",126,3,6,4,2,2,2
"Belgium",126,4,9,5,2,3,1
"Denmark",126,4,6,5,2,3,2
"England",126,5,7,14,4,10,1
"Croatia",126,5,5,3,2,1,2
"Italy",126,6,7,6,3,3,1
"Wales",126,6,6,6,4,2,2
"Mexico",126,8,9,6,2,4,1
"Nigeria",126,8,4,2,3,-1,2
"Italy",127,1,9,10,3,7,1
"Costa Rica",127,1,4,4,4,0,2
"Argentina",127,2,7,7,4,3,1
"Iran",127,2,4,3,3,0,2
"France",127,7,7,9,5,4,1
"Korea Republic",127,7,6,4,2,2,2
"Brazil",127,8,9,9,1,8,1
"United States",127,8,6,4,5,-1,2
"Wales",128,1,9,7,1,6,1
"Denmark",128,1,6,7,3,4,2
"Mexico",128,4,7,2,0,2,1
"Morocco",128,4,4,1,1,0,2
"Brazil",128,5,9,8,1,7,1
"Japan",128,5,6,3,2,1,2
"Germany",128,7,7,4,1,3,1
"Iran",128,7,4,3,4,-1,2
"Belgium",129,3,9,6,0,6,1
"United States",129,3,6,2,1,1,2
"Switzerland",129,4,7,4,2,2,1
"Spain",129,4,5,2,1,1,2
"Argentina",129,7,7,6,2,4,1
"Netherlands",129,7,6,6,2,4,2
"Netherlands",130,1,9,12,1,11,1
"Tunisia",130,1,4,2,5,-3,2
"Belgium",130,2,7,7,3,4,1
"Mexico",130,2,5,6,4,2,2
"England",130,3,7,8,2,6,1
"Denmark",130,3,6,3,4,-1,2
"Brazil",130,4,9,7,3,4,1
"Germany",130,4,6,10,2,8,2
"United States",130,5,6,6,5,1,1
"Italy",130,5,5,4,2,2,2
"Portugal",130,6,9,4,0,4,1
"Japan",130,6,6,4,2,2,2
"Spain",130,7,9,8,2,6,1
"Uruguay",130,7,6,3,1,2,2
"France",130,8,7,5,1,4,1
"Algeria",130,8,4,6,3,3,2
"Germany",131,1,9,13,2,11,1
"United States",131,1,4,4,5,-1,2
"Italy",131,3,9,9,2,7,1
"Spain",131,3,6,8,5,3,2
"Japan",131,4,7,4,1,3,1
"Croatia",131,4,4,5,4,1,2
"Switzerland",131,5,6,5,4,1,1
"Denmark",131,5,5,3,2,1,2
"France",131,7,7,4,0,4,1
"Mexico",131,7,4,6,3,3,2
"Algeria",132,1,7,4,2,2,1
"Qatar",132,1,6,4,3,1,2
"France",132,3,9,6,1,5,1
"Colombia",132,3,6,8,4,4,2
"Belgium",132,5,9,6,2,4,1
"Iran",132,5,4,4,4,0,2
"Croatia",132,7,9,7,0,7,1
"Portugal",132,7,6,5,1,4,2
"Spain",132,8,9,11,5,6,1
"Denmark",132,8,4,3,3,0,2
"Portugal",133,2,7,4,1,3,1
"Chile",133,2,6,7,4,3,2
"Brazil",133,3,7,6,3,3,1
"Mexico",133,3,6,8,4,4,2
"Belgium",133,7,9,3,0,3,1
"Croatia",133,7,6,2,1,1,2
"Chile",134,1,9,7,1,6,1
"Jamaica",134,1,4,5,7,-2,2
"Brazil",134,2,9,6,1,5,1
"Croatia",134,2,6,5,2,3,2
"Italy",134,3,7,4,1,3,1
"Spain",134,3,5,3,2,1,2
"Morocco",134,5,6,7,4,3,1
"Argentina",134,5,5,5,3,2,2
"England",134,6,7,3,1,2,1
"United States",134,6,6,4,1,3,2
"Switzerland",134,7,7,4,1,3,1
"Portugal",134,7,4,1,1,0,2
"Korea Republic",134,8,6,3,3,0,1
"France",134,8,5,3,1,2,2
"United States",135,1,7,4,2,2,1
"Denmark",135,1,5,3,2,1,2
"Croatia",135,4,7,6,2,4,1
"England",135,4,5,2,0,2,2
"Brazil",135,5,9,11,1,10,1
"Switzerland",135,5,6,5,4,1,2
"Spain",135,8,7,3,1,2,1
"Colombia",135,8,6,4,3,1,2
"Spain",136,2,9,8,0,8,1
"Croatia",136,2,4,4,5,-1,2
"Belgium",136,6,7,6,1,5,1
"Morocco",136,6,4,7,7,0,2
"Chile",136,7,9,5,1,4,1
"Costa Rica",136,7,4,4,3,1,2
"Chile",137,3,7,3,1,2,1
"Korea Republic",137,3,4,3,2,1,2
"Portugal",137,7,9,6,1,5,1
"Iran",137,7,4,5,4,1,2
"Japan",137,8,9,3,0,3,1
"England",137,8,6,2,1,1,2
"Morocco",138,1,6,4,5,-1,1
"Netherlands",138,1,5,6,3,3,2
"Uruguay",138,3,9,8,2,6,1
"England",138,3,6,2,2,0,2
"Denmark",138,4,7,5,2,3,1
"Brazil",138,4,5,5,4,1,2
"Belgium",138,6,7,8,1,7,1
"Japan",138,6,5,6,2,4,2
"Germany",138,7,6,5,3,2,1
"Chile",138,7,5,3,2,1,2
"Portugal",138,8,9,6,2,4,1
"Australia",138,8,6,7,4,3,2
"Belgium",139,2,9,9,1,8,1
"Iran",139,2,6,5,4,1,2
"Brazil",139,3,9,13,0,13,1
"Croatia",139,3,4,1,6,-5,2
"Mexico",139,6,9,5,1,4,1
"England",139,6,4,3,3,0,2
"France",139,8,7,6,4,2,1
"Wales",139,8,4,5,4,1,2
"Qatar",140,1,5,5,4,1,1
"Nigeria",140,1,4,5,5,0,2
"Argentina",140,2,7,4,1,3,1
"Netherlands",140,2,5,3,1,2,2
"Germany",140,3,7,4,1,3,1
"Brazil",140,3,6,3,2,1,2
"Portugal",140,5,9,4,1,3,1
"Colombia",140,5,6,7,1,6,2
"Mexico",140,6,7,7,4,3,1
"Belgium",140,6,4,4,4,0,2
"Brazil",141,3,9,8,4,4,1
"Iran",141,3,6,6,5,1,2
"Italy",142,2,9,10,3,7,1
"Spain",142,2,4,5,4,1,2
"Belgium",142,3,9,5,0,5,1
"Croatia",142,3,4,3,4,-1,2
"Denmark",142,4,7,4,2,2,1
"England",142,4,6,5,3,2,2
"Argentina",142,5,9,8,2,6,1
"Switzerland",142,5,4,3,3,0,2
"France",142,6,9,6,2,4,1
"Wales",142,6,6,6,2,4,2
"Germany",143,2,7,2,0,2,1
"Poland",143,2,5,2,1,1,2
"Argentina",143,4,7,3,1,2,1
"Australia",143,4,4,5,2,3,2
"Belgium",143,5,7,6,2,4,1
"Chile",143,5,4,1,3,-2,2
"Portugal",143,6,7,5,1,4,1
"Japan",143,6,5,4,0,4,2
"Brazil",143,8,9,8,1,7,1
"Denmark",143,8,4,5,2,3,2
"Croatia",144,2,9,9,2,7,1
"Japan",144,2,4,3,3,0,2
"Belgium",144,3,7,4,1,3,1
"Australia",144,3,6,2,1,1,2
"Italy",144,4,7,5,3,2,1
"England",144,4,6,5,1,4,2
"Korea Republic",144,7,7,3,0,3,1
"Uruguay",144,7,4,4,4,0,2
"France",144,8,7,6,3,3,1
"Netherlands",144,8,4,3,2,1,2
"Belgium",145,2,7,6,2,4,1
"Uruguay",145,2,4,3,4,-1,2
"Brazil",145,3,9,8,4,4,1
"Denmark",145,3,6,10,7,3,2
"Germany",145,5,7,3,0,3,1
"Iran",145,5,4,4,4,0,2
"Portugal",145,6,7,5,1,4,1
"Colombia",145,6,6,4,3,1,2
"Mexico",145,7,9,5,1,4,1
"Spain",145,7,4,4,3,1,2
"Senegal",145,8,7,7,4,3,1
"Korea Republic",145,8,4,3,3,0,2
"Uruguay",146,1,9,11,4,7,1
"Wales",146,1,6,6,6,0,2
"Belgium",146,3,9,6,2,4,1
"Netherlands",146,3,6,6,2,4,2
"Brazil",146,4,7,7,4,3,1
"Denmark",146,4,6,7,4,3,2
"Argentina",146,5,9,5,0,5,1
"Italy",146,5,6,4,3,1,2
"France",146,7,7,6,2,4,1
"Iran",146,7,4,4,5,-1,2
"Chile",146,8,7,6,3,3,1
"Spain",146,8,6,5,3,2,2
"Mexico",147,1,7,6,2,4,1
"Algeria",147,1,6,5,3,2,2
"Belgium",147,2,9,11,1,10,1
"Italy",147,2,6,2,3,-1,2
"Spain",147,3,9,9,1,8,1
"Jamaica",147,3,4,3,5,-2,2
"Iran",147,5,9,5,1,4,1
"Argentina",147,5,6,6,3,3,2
"England",147,6,9,5,1,4,1
"Japan",147,6,4,3,3,0,2
"Croatia",147,8,9,6,1,5,1
"France",147,8,6,4,2,2,2
"Costa Rica",148,1,6,3,1,2,1
"Denmark",148,1,5,2,1,1,2
"Belgium",148,2,7,7,2,5,1
"Italy",148,2,6,6,2,4,2
"Nigeria",148,3,7,4,1,3,1
"Uruguay",148,3,5,7,4,3,2
"Spain",148,5,9,8,3,5,1
"Australia",148,5,4,4,6,-2,2
"Switzerland",148,7,6,2,3,-1,1
"Netherlands",148,7,5,3,0,3,2
"Uruguay",149,1,7,6,1,5,1
"Switzerland",149,1,6,5,4,1,2
"Spain",149,2,9,6,2,4,1
"Denmark",149,2,4,3,4,-1,2
"Italy",149,3,7,6,1,5,1
"Brazil",149,3,4,3,2,1,2
"Portugal",149,4,7,4,1,3,1
"Croatia",149,4,5,3,0,3,2
"Netherlands",149,6,7,4,2,2,1
"Korea Republic",149,6,6,9,3,6,2
"Belgium",150,2,9,5,1,4,1
"Japan",150,2,4,2,1,1,2
"England",150,3,9,12,5,7,1
"Iran",150,3,4,4,4,0,2
"Brazil",150,4,9,6,0,6,1
"Croatia",150,4,6,5,4,1,2
"Portugal",150,5,7,7,0,7,1
"Switzerland",150,5,5,3,2,1,2
"Algeria",150,6,7,5,2,3,1
"Germany",150,6,6,7,6,1,2
"France",150,7,7,4,0,4,1
"Colombia",150,7,6,3,3,0,2
"Italy",150,8,9,6,3,3,1
"Korea Republic",150,8,6,6,4,2,2
"Netherlands",151,1,7,7,1,6,1
"Qatar",151,1,3,4,4,0,2
"Portugal",151,2,9,7,4,3,1
"Italy",151,2,6,5,4,1,2
"Croatia",151,3,7,3,1,2,1
"Japan",151,3,6,3,2,1,2
"Brazil",151,4,9,6,2,4,1
"Denmark",151,4,4,4,4,0,2
"England",152,2,9,5,0,5,1
"Senegal",152,2,4,4,6,-2,2
"Belgium",152,3,7,6,1,5,1
"Iran",152,3,6,4,3,1,2
"Mexico",152,4,7,4,1,3,1
"Argentina",152,4,3,5,5,0,2
"Brazil",152,7,7,6,1,5,1
"Jamaica",152,7,6,5,4,1,2
"Portugal",153,2,9,6,2,4,1
"Mexico",153,2,6,6,2,4,2
"Argentina",153,3,9,7,0,7,1
"Denmark",153,3,6,5,3,2,2
"Spain",153,5,7,3,1,2,1
"Italy",153,5,6,3,2,1,2
"Germany",153,7,7,4,1,3,1
"England",153,7,6,4,2,2,2
"Uruguay",154,2,7,5,2,3,1
"England",154,2,6,4,2,2,2
"Belgium",154,4,7,4,2,2,1
"Croatia",154,4,6,4,1,3,2
"Brazil",154,6,9,8,2,6,1
"Japan",154,6,4,4,4,0,2
"Spain",154,8,9,11,0,11,1
"Netherlands",154,8,4,1,2,-1,2
"Brazil",155,2,9,7,1,6,1
"Tunisia",155,2,6,5,4,1,2
"Switzerland",155,3,7,4,1,3,1
"Korea Republic",155,3,4,3,2,1,2
"Belgium",155,4,7,6,1,5,1
"Netherlands",155,4,6,5,2,3,2
"Spain",155,5,9,7,3,4,1
"Chile",155,5,6,5,4,1,2
"Germany",155,6,9,5,1,4,1
"Costa Rica",155,6,4,3,3,0,2
"France",155,7,7,9,2,7,1
"Nigeria",155,7,6,6,6,0,2
"Poland",156,3,5,4,3,1,1
"Mexico",156,3,4,4,2,2,2
"Algeria",156,5,7,3,1,2,1
"England",156,5,4,3,3,0,2
"Colombia",156,6,7,6,0,6,1
"Korea Republic",156,6,5,2,1,1,2
"Argentina",156,8,7,4,0,4,1
"Australia",156,8,4,2,1,1,2
"Portugal",157,2,9,7,2,5,1
"Morocco",157,2,4,2,2,0,2
"Iran",157,3,7,4,2,2,1
"Belgium",157,3,6,5,4,1,2
"France",157,4,7,5,0,5,1
"Italy",157,4,6,3,4,-1,2
"Australia",157,7,7,5,2,3,1
"Argentina",157,7,4,3,3,0,2
"England",157,8,7,7,4,3,1
"Switzerland",157,8,6,3,3,0,2
"Netherlands",158,3,7,8,5,3,1
"England",158,3,5,7,5,2,2
"Brazil",158,4,9,5,0,5,1
"Italy",158,4,4,3,4,-1,2
"Belgium",158,8,9,8,1,7,1
"Denmark",158,8,6,5,4,1,2
"Netherlands",159,1,7,6,2,4,1
"Nigeria",159,1,5,3,2,1,2
"England",159,2,7,6,3,3,1
"Denmark",159,2,6,6,5,1,2
"Portugal",159,4,6,7,5,2,1
"Australia",159,4,5,6,2,4,2
"Uruguay",159,6,7,10,2,8,1
"France",159,6,5,4,2,2,2
"Croatia",160,1,9,8,2,6,1
"Poland",160,1,6,5,3,2,2
"Denmark",160,2,7,5,3,2,1
"England",160,2,5,3,2,1,2
"Brazil",160,4,9,5,0,5,1
"Mexico",160,4,6,4,2,2,2
"Argentina",160,6,6,5,4,1,1
"Jamaica",160,6,5,4,3,1,2
"Portugal",160,7,9,5,1,4,1
"Colombia",160,7,4,2,2,0,2
"Italy",160,8,7,8,4,4,1
"France",160,8,3,3,3,0,2
"Switzerland",161,1,9,6,1,5,1
"Netherlands",161,1,6,8,6,2,2
"Spain",161,2,7,5,0,5,1
"Mexico",161,2,5,2,1,1,2
"Germany",161,3,7,5,1,4,1
"Poland",161,3,6,5,6,-1,2
"Belgium",161,5,7,5,2,3,1
"Australia",161,5,6,3,3,0,2
"Switzerland",162,1,7,4,2,2,1
"Denmark",162,1,6,6,4,2,2
"Tunisia",162,3,5,4,3,1,1
"England",162,3,4,3,3,0,2
"Belgium",162,5,7,5,1,4,1
"Chile",162,5,5,7,2,5,2
"Brazil",162,7,7,7,2,5,1
"Italy",162,7,6,4,3,1,2
"Japan",163,3,9,4,0,4,1
"Brazil",163,3,6,3,1,2,2
"Germany",163,4,7,2,0,2,1
"Korea Republic",163,4,6,4,2,2,2
"Netherlands",163,6,7,4,1,3,1
"Spain",163,6,5,7,4,3,2
"Belgium",163,8,7,9,3,6,1
"Switzerland",163,8,4,3,3,0,2
"Qatar",164,1,9,7,4,3,1
"Italy",164,1,6,6,4,2,2
"England",164,6,7,4,1,3,1
"Switzerland",164,6,6,3,2,1,2
"Belgium",164,7,7,7,4,3,1
"Uruguay",164,7,6,8,3,5,2
"Argentina",164,8,7,6,3,3,1
"Jamaica",164,8,6,6,4,2,2
"Poland",165,5,9,8,2,6,1
"England",165,5,4,5,4,1,2
"Belgium",165,6,9,8,3,5,1
"Iran",165,6,4,6,5,1,2
"Denmark",166,1,9,6,1,5,1
"Tunisia",166,1,4,2,1,1,2
"Wales",166,3,7,7,2,5,1
"France",166,3,6,7,5,2,2
"Croatia",166,4,7,5,2,3,1
"Iran",166,4,4,5,5,0,2
"Netherlands",166,6,9,7,1,6,1
"Portugal",166,6,6,4,3,1,2
"Brazil",166,8,9,12,2,10,1
"Italy",166,8,6,9,6,3,2
"Colombia",167,1,9,6,1,5,1
"Tunisia",167,1,6,5,3,2,2
"Spain",167,4,9,6,1,5,1
"Uruguay",167,4,6,7,4,3,2
"Italy",167,5,7,6,3,3,1
"Portugal",167,5,6,11,4,7,2
"Brazil",167,7,7,7,3,4,1
"Poland",167,7,4,3,3,0,2
"Colombia",168,1,9,8,1,7,1
"Qatar",168,1,6,4,2,2,2
"Korea Republic",168,4,7,6,3,3,1
"Brazil",168,4,6,5,3,2,2
"Uruguay",168,7,7,5,1,4,1
"Spain",168,7,5,3,2,1,2
"Wales",169,1,9,11,3,8,1
"Colombia",169,1,6,6,3,3,2
"Belgium",169,2,5,6,2,4,1
"Chile",169,2,4,5,7,-2,2
"Australia",169,3,7,8,4,4,1
"Argentina",169,3,5,6,5,1,2
"Senegal",169,4,6,5,4,1,1
"France",169,4,5,2,1,1,2
"Portugal",169,5,9,9,0,9,1
"Japan",169,5,6,3,3,0,2
"Denmark",169,8,7,3,1,2,1
"Brazil",169,8,6,6,2,4,2
"Belgium",170,6,7,7,2,5,1
"Uruguay",170,6,4,4,3,1,2
"Portugal",170,7,9,8,4,4,1
"Colombia",170,7,6,6,5,1,2
"England",171,3,6,2,2,0,1
"Morocco",171,3,5,3,1,2,2
"France",171,4,7,7,2,5,1
"Colombia",171,4,5,5,1,4,2
"Brazil",171,5,6,5,3,2,1
"Denmark",171,5,5,6,5,1,2
"Spain",171,6,9,6,2,4,1
"Chile",171,6,6,5,3,2,2
"Portugal",171,8,9,5,0,5,1
"Korea Republic",171,8,6,3,2,1,2
"Senegal",172,1,7,3,1,2,1
"Colombia",172,1,5,4,3,1,2
"Iran",172,2,6,5,3,2,1
"Belgium",172,2,5,4,1,3,2
"France",172,3,7,5,2,3,1
"Netherlands",172,3,5,5,2,3,2
"Australia",172,4,7,4,2,2,1
"Germany",172,4,4,3,3,0,2
"Spain",172,6,7,4,1,3,1
"Italy",172,6,6,4,2,2,2
"Croatia",172,7,7,7,4,3,1
"Nigeria",172,7,4,3,4,-1,2
"Brazil",172,8,9,8,0,8,1
"Mexico",172,8,4,3,5,-2,2
"England",173,2,9,8,2,6,1
"Mexico",173,2,6,6,5,1,2
"Croatia",173,3,7,5,2,3,1
"Senegal",173,3,6,3,2,1,2
"Brazil",173,5,7,6,1,5,1
"Netherlands",173,5,4,1,1,0,2
"England",174,6,9,6,1,5,1
"Uruguay",174,6,6,4,1,3,2
"Croatia",174,7,7,4,2,2,1
"Portugal",174,7,4,2,3,-1,2
"Portugal",175,2,6,7,3,4,1
"Uruguay",175,2,5,3,1,2,2
"Switzerland",175,5,5,4,2,2,1
"England",175,5,4,4,4,0,2
"France",175,6,7,7,2,5,1
"Wales",175,6,4,5,5,0,2
"Qatar",176,1,6,3,4,-1,1
"Costa Rica",176,1,5,4,1,3,2
"Italy",176,2,7,7,2,5,1
"England",176,2,6,4,4,0,2
"Brazil",176,3,9,8,2,6,1
"Switzerland",176,3,6,6,4,2,2
"Belgium",176,4,7,5,1,4,1
"Korea Republic",176,4,4,2,3,-1,2
"France",176,6,9,6,0,6,1
"Algeria",176,6,6,4,4,0,2
"Argentina",176,7,7,6,1,5,1
"Iran",176,7,6,4,1,3,2
"Spain",176,8,7,5,3,2,1
"Poland",176,8,4,4,3,1,2
"Qatar",177,1,9,5,2,3,1
"Germany",177,1,6,4,2,2,2
"Brazil",177,2,9,7,1,6,1
"Korea Republic",177,2,4,5,4,1,2
"Argentina",177,4,9,8,1,7,1
"Croatia",177,4,6,3,5,-2,2
"Portugal",177,5,7,6,3,3,1
"Uruguay",177,5,4,2,2,0,2
"France",177,6,9,9,0,9,1
"Costa Rica",177,6,4,2,6,-4,2
"Spain",177,7,9,7,2,5,1
"Mexico",177,7,4,3,4,-1,2
"Italy",177,8,7,5,1,4,1
"Belgium",177,8,5,5,2,3,2
"Uruguay",178,1,7,6,2,4,1
"Poland",178,1,5,7,3,4,2
"Italy",178,2,7,6,2,4,1
"Algeria",178,2,4,2,3,-1,2
"Portugal",178,3,7,2,0,2,1
"Tunisia",178,3,4,3,3,0,2
"France",178,5,9,4,1,3,1
"Chile",178,5,6,5,2,3,2
"Spain",178,7,7,9,1,8,1
"Morocco",178,7,4,3,6,-3,2
"Mexico",179,1,9,9,3,6,1
"Nigeria",179,1,4,2,3,-1,2
"Croatia",179,2,7,6,2,4,1
"Argentina",179,2,6,3,4,-1,2
"Brazil",179,3,7,8,1,7,1
"Netherlands",179,3,5,5,4,1,2
"France",179,5,7,7,4,3,1
"Australia",179,5,4,3,3,0,2
"Spain",179,6,9,8,2,6,1
"Italy",179,6,4,2,2,0,2
"Germany",179,7,9,9,0,9,1
"England",179,7,4,8,2,6,2
"Portugal",179,8,9,8,1,7,1
"Algeria",179,8,6,4,4,0,2
"Mexico",180,1,7,8,3,5,1
"Chile",180,1,4,2,4,-2,2
"Colombia",180,4,7,8,2,6,1
"Senegal",180,4,6,2,4,-2,2
"Croatia",180,7,7,4,2,2,1
"Belgium",180,7,6,6,4,2,2
"Algeria",180,8,7,5,3,2,1
"Argentina",180,8,4,7,4,3,2
"Poland",181,3,7,6,1,5,1
"England",181,3,4,3,3,0,2
"Italy",181,4,7,6,3,3,1
"Brazil",181,4,6,8,7,1,2
"Germany",181,5,7,5,2,3,1
"Portugal",181,5,5,4,2,2,2
"Denmark",181,8,7,3,1,2,1
"Belgium",181,8,4,3,3,0,2
"Algeria",182,1,7,4,2,2,1
"Italy",182,1,4,1,1,0,2
"Portugal",182,2,9,5,1,4,1
"Germany",182,2,6,3,2,1,2
"Mexico",182,3,7,5,2,3,1
"France",182,3,5,3,2,1,2
"Korea Republic",182,5,7,6,1,5,1
"Brazil",182,5,6,7,3,4,2
"England",182,7,9,8,4,4,1
"Netherlands",182,7,6,8,4,4,2
"Argentina",182,8,7,5,2,3,1
"Nigeria",182,8,5,2,1,1,2
"Uruguay",183,1,7,2,0,2,1
"Qatar",183,1,5,1,0,1,2
"Mexico",183,2,9,7,2,5,1
"France",183,2,6,5,3,2,2
"Colombia",183,3,7,6,1,5,1
"Korea Republic",183,3,5,3,2,1,2
"Netherlands",183,4,9,6,1,5,1
"Wales",183,4,6,4,2,2,2
"Spain",183,5,7,4,1,3,1
"Germany",183,5,6,3,1,2,2
"Denmark",183,6,7,5,2,3,1
"Belgium",183,6,5,4,3,1,2
"Iran",183,7,9,7,2,5,1
"Argentina",183,7,6,4,3,1,2
"Germany",184,2,7,5,1,4,1
"Switzerland",184,2,4,4,5,-1,2
"Belgium",184,3,9,6,2,4,1
"Korea Republic",184,3,6,7,3,4,2
"Brazil",184,4,9,4,1,3,1
"Japan",184,4,6,4,1,3,2
"Argentina",184,6,9,10,4,6,1
"Netherlands",184,6,6,4,3,1,2
"Uruguay",184,8,7,8,5,3,1
"England",184,8,6,8,4,4,2
"Netherlands",185,1,9,7,2,5,1
"Switzerland",185,1,4,3,3,0,2
"Brazil",185,2,9,9,1,8,1
"Denmark",185,2,4,1,2,-1,2
"Mexico",185,4,7,4,1,3,1
"Nigeria",185,4,4,5,5,0,2
"Portugal",185,6,7,5,2,3,1
"Germany",185,6,6,3,2,1,2
"Spain",185,8,7,8,3,5,1
"Iran",185,8,5,3,2,1,2
"Uruguay",186,1,9,6,2,4,1
"Poland",186,1,6,3,2,1,2
"Belgium",186,2,7,4,1,3,1
"Denmark",186,2,4,5,6,-1,2
"Brazil",186,3,9,8,0,8,1
"Nigeria",186,3,4,5,6,-1,2
"Argentina",186,4,9,5,1,4,1
"Mexico",186,4,4,5,2,3,2
"Iran",186,7,5,4,2,2,1
"Croatia",186,7,4,2,3,-1,2
"England",186,8,7,7,3,4,1
"Italy",186,8,6,7,2,5,2
"Uruguay",187,1,9,5,2,3,1
"Wales",187,1,6,6,3,3,2
"Belgium",187,2,9,12,4,8,1
"Japan",187,2,4,4,6,-2,2
"England",187,3,7,6,3,3,1
"Senegal",187,3,4,3,3,0,2
"Chile",187,4,7,5,3,2,1
"Portugal",187,4,4,3,2,1,2
"Argentina",187,5,7,5,2,3,1
"Germany",187,5,6,3,1,2,2
"Netherlands",187,7,7,4,2,2,1
"Brazil",187,7,6,4,2,2,2
"Uruguay",188,1,7,3,0,3,1
"Algeria",188,1,4,4,3,1,2
"Mexico",188,3,9,5,0,5,1
"Poland",188,3,6,4,2,2,2
"France",188,4,9,6,1,5,1
"Chile",188,4,6,7,8,-1,2
"Croatia",188,6,9,6,1,5,1
"England",188,6,6,7,2,5,2
"Portugal",188,7,9,9,0,9,1
"Colombia",188,7,6,6,4,2,2
"Italy",189,1,9,7,1,6,1
"Switzerland",189,1,4,6,3,3,2
"England",189,3,7,5,3,2,1
"Mexico",189,3,6,5,2,3,2
"Germany",189,7,9,5,1,4,1
"Brazil",189,7,6,6,4,2,2
"Belgium",190,4,7,4,2,2,1
"Netherlands",190,4,5,6,4,2,2
"Uruguay",190,5,7,4,2,2,1
"Spain",190,5,6,10,1,9,2
"Mexico",190,6,9,9,1,8,1
"Korea Republic",190,6,4,4,6,-2,2
"Portugal",190,7,7,8,4,4,1
"Germany",190,7,5,5,3,2,2
"Brazil",191,5,9,5,1,4,1
"Croatia",191,5,6,4,3,1,2
"Uruguay",191,6,9,5,1,4,1
"Spain",191,6,4,3,3,0,2
"Portugal",191,8,6,5,3,2,1
"Chile",191,8,5,3,2,1,2
"Portugal",192,2,7,6,2,4,1
"Colombia",192,2,6,3,3,0,2
"Netherlands",192,4,7,3,1,2,1
"Australia",192,4,4,1,1,0,2
"Italy",192,7,9,6,0,6,1
"France",192,7,4,5,6,-1,2
"Belgium",192,8,7,7,3,4,1
"Germany",192,8,6,5,2,3,2
"Spain",193,3,7,5,2,3,1
"Italy",193,3,6,6,4,2,2
"Belgium",193,5,9,8,3,5,1
"Senegal",193,5,6,4,4,0,2
"Argentina",193,6,7,6,3,3,1
"Croatia",193,6,4,4,4,0,2
"Netherlands",193,7,7,3,0,3,1
"Brazil",193,7,6,4,2,2,2
"Uruguay",193,8,9,7,2,5,1
"Poland",193,8,6,3,2,1,2
"Brazil",194,2,9,9,0,9,1
"Croatia",194,2,4,3,5,-2,2
"Spain",194,3,9,6,1,5,1
"Germany",194,3,6,8,3,5,2
"Belgium",194,6,7,6,3,3,1
"Uruguay",194,6,4,1,2,-1,2
"Colombia",194,7,7,6,2,4,1
"Portugal",194,7,4,1,1,0,2
"France",195,3,7,3,0,3,1
"Morocco",195,3,4,2,3,-1,2
"Belgium",195,4,9,8,2,6,1
"Chile",195,4,6,5,3,2,2
"Brazil",195,5,9,6,1,5,1
"Mexico",195,5,4,3,3,0,2
"Netherlands",195,7,7,3,0,3,1
"Argentina",195,7,6,4,3,1,2
"Morocco",196,1,9,6,2,4,1
"Colombia",196,1,6,6,4,2,2
"Korea Republic",196,3,5,5,3,2,1
"Mexico",196,3,4,4,5,-1,2
"Netherlands",196,4,9,8,1,7,1
"Argentina",196,4,6,6,2,4,2
"Germany",196,5,6,6,3,3,1
"Brazil",196,5,5,4,2,2,2
"France",196,7,9,6,2,4,1
"Italy",196,7,6,7,3,4,2
"England",196,8,7,6,0,6,1
"Poland",196,8,6,6,6,0,2
"Argentina",197,2,9,5,1,4,1
"Germany",197,2,4,3,2,1,2
"England",197,4,7,5,2,3,1
"Italy",197,4,4,3,2,1,2
"Brazil",197,5,9,11,2,9,1
"Denmark",197,5,6,6,3,3,2
"Belgium",197,7,7,6,1,5,1
"Switzerland",197,7,6,4,6,-2,2
"Portugal",197,8,7,7,1,6,1
"Colombia",197,8,5,3,2,1,2
"Senegal",198,1,7,6,4,2,1
"Colombia",198,1,6,6,4,2,2
"France",198,2,9,6,1,5,1
"Iran",198,2,4,4,4,0,2
"Belgium",198,3,7,5,0,5,1
"Italy",198,3,6,6,3,3,2
"Croatia",198,5,7,4,2,2,1
"Nigeria",198,5,6,6,5,1,2
"Uruguay",198,7,7,4,2,2,1
"Tunisia",198,7,4,2,2,0,2
"Portugal",198,8,7,3,1,2,1
"Netherlands",198,8,6,3,2,1,2
"Netherlands",199,5,9,6,1,5,1
"Portugal",199,5,6,5,2,3,2
"Spain",199,7,7,5,3,2,1
"Mexico",199,7,6,5,2,3,2
"Colombia",199,8,9,5,0,5,1
"Switzerland",199,8,4,2,2,0,2
"Netherlands",200,3,7,3,1,2,1
"Korea Republic",200,3,5,5,4,1,2
"Switzerland",200,7,6,5,4,1,1
"Uruguay",200,7,5,2,0,2,2
"Argentina",200,8,9,5,0,5,1
"Croatia",200,8,6,8,2,6,2
"Croatia",201,1,7,5,1,4,1
"Jamaica",201,1,4,1,2,-1,2
"Germany",201,2,7,3,1,2,1
"Portugal",201,2,5,5,2,3,2
"France",201,3,9,10,2,8,1
"Netherlands",201,3,6,6,3,3,2
"Denmark",201,6,9,7,1,6,1
"Chile",201,6,4,4,4,0,2
"Italy",201,7,7,8,6,2,1
"Brazil",201,7,5,4,2,2,2
"Colombia",202,1,7,3,1,2,1
"United States",202,1,5,3,1,2,2
"Belgium",202,4,9,11,2,9,1
"Croatia",202,4,4,2,3,-1,2
"Wales",202,5,7,7,4,3,1
"Italy",202,5,5,5,3,2,2
"France",202,6,7,8,1,7,1
"Japan",202,6,6,4,6,-2,2
"Brazil",202,7,9,9,2,7,1
"Korea Republic",202,7,4,3,4,-1,2
"Algeria",203,1,7,3,1,2,1
"Poland",203,1,4,5,5,0,2
"Uruguay",203,2,9,7,2,5,1
"Spain",203,2,4,2,4,-2,2
"England",203,3,9,6,2,4,1
"Netherlands",203,3,4,2,2,0,2
"Denmark",203,4,7,4,2,2,1
"Argentina",203,4,6,5,3,2,2
"Germany",203,5,7,3,1,2,1
"Belgium",203,5,6,7,2,5,2
"France",203,6,9,11,2,9,1
"Colombia",203,6,6,6,3,3,2
"Brazil",203,7,7,6,1,5,1
"Wales",203,7,4,1,1,0,2
"Chile",203,8,7,5,2,3,1
"Iran",203,8,5,3,2,1,2
"Colombia",204,1,9,7,1,6,1
"United States",204,1,6,5,5,0,2
"Brazil",204,3,9,8,1,7,1
"Nigeria",204,3,6,3,4,-1,2
"Spain",204,4,7,4,2,2,1
"Uruguay",204,4,6,5,3,2,2
"France",204,5,9,6,0,6,1
"Denmark",204,5,6,5,5,0,2
"Germany",204,6,7,5,1,4,1
"Argentina",204,6,4,1,1,0,2
"Belgium",204,7,7,3,1,2,1
"Italy",204,7,4,5,3,2,2
"Netherlands",204,8,7,7,3,4,1
"Algeria",204,8,4,3,3,0,2
"Chile",205,3,7,5,3,2,1
"Denmark",205,3,6,3,1,2,2
"Belgium",205,7,9,8,2,6,1
"Switzerland",205,7,6,4,4,0,2
"Brazil",205,8,9,5,0,5,1
"Italy",205,8,6,4,3,1,2
"Italy",206,1,9,5,1,4,1
"Qatar",206,1,4,2,2,0,2
"Spain",206,5,7,4,1,3,1
"Nigeria",206,5,4,1,1,0,2
"Colombia",206,6,7,6,2,4,1
"Portugal",206,6,6,8,4,4,2
"Poland",206,7,7,4,1,3,1
"Croatia",206,7,5,5,4,1,2
"France",206,8,7,9,1,8,1
"Netherlands",206,8,4,2,2,0,2
"Qatar",207,1,7,5,3,2,1
"Denmark",207,1,6,5,2,3,2
"Brazil",207,2,7,3,0,3,1
"Italy",207,2,5,3,2,1,2
"Colombia",207,4,7,5,3,2,1
"England",207,4,5,2,0,2,2
"Portugal",207,5,9,8,1,7,1
"Germany",207,5,6,4,3,1,2
"Belgium",207,6,7,5,1,4,1
"Croatia",207,6,5,1,0,1,2
"Wales",208,1,7,2,0,2,1
"Nigeria",208,1,5,2,1,1,2
"Brazil",208,2,7,5,1,4,1
"Poland",208,2,5,5,3,2,2
"Argentina",208,3,9,7,2,5,1
"Iran",208,3,4,5,6,-1,2
"Korea Republic",208,4,7,4,2,2,1
"England",208,4,4,5,3,2,2
"France",208,8,9,5,0,5,1
"Netherlands",208,8,6,3,1,2,2
"Qatar",209,1,7,4,1,3,1
"Costa Rica",209,1,4,5,5,0,2
"Germany",209,2,7,7,1,6,1
"Portugal",209,2,6,4,3,1,2
"Brazil",209,3,9,8,2,6,1
"Mexico",209,3,6,6,4,2,2
"Croatia",209,4,9,4,0,4,1
"Nigeria",209,4,4,4,5,-1,2
"Australia",209,5,7,4,1,3,1
"Belgium",209,5,4,4,3,1,2
"Argentina",209,6,7,7,1,6,1
"Italy",209,6,3,1,1,0,2
"England",209,7,7,6,1,5,1
"Denmark",209,7,6,4,3,1,2
"Germany",210,1,7,8,4,4,1
"Wales",210,1,6,6,5,1,2
"Mexico",210,4,7,5,1,4,1
"Chile",210,4,4,3,3,0,2
"Brazil",210,5,7,5,1,4,1
"Croatia",210,5,6,3,3,0,2
"France",210,7,7,6,3,3,1
"Senegal",210,7,4,7,8,-1,2
"Japan",211,2,7,7,2,5,1
"Spain",211,2,6,4,3,1,2
"France",211,3,9,7,1,6,1
"Mexico",211,3,6,4,1,3,2
"Brazil",211,4,7,10,3,7,1
"Germany",211,4,4,3,3,0,2
"Denmark",211,5,9,7,1,6,1
"Argentina",211,5,6,8,3,5,2
"Portugal",211,6,9,7,1,6,1
"Uruguay",211,6,6,6,3,3,2
"England",211,7,7,6,3,3,1
"Iran",211,7,6,6,2,4,2
"Wales",212,1,9,9,3,6,1
"Qatar",212,1,6,6,4,2,2
"Germany",212,2,7,8,1,7,1
"Argentina",212,2,5,3,2,1,2
"Spain",212,3,7,2,0,2,1
"Morocco",212,3,6,3,1,2,2
"Poland",212,6,9,8,2,6,1
"Croatia",212,6,4,5,4,1,2
"Belgium",212,7,7,3,1,2,1
"Uruguay",212,7,6,4,3,1,2
"Netherlands",212,8,6,5,2,3,1
"Korea Republic",212,8,5,6,5,1,2
"Netherlands",213,1,7,2,0,2,1
"United States",213,1,6,7,1,6,2
"Switzerland",213,3,7,3,1,2,1
"Colombia",213,3,4,2,2,0,2
"Belgium",213,4,7,6,2,4,1
"Denmark",213,4,5,3,2,1,2
"France",213,5,7,6,2,4,1
"Japan",213,5,6,7,3,4,2
"Senegal",213,7,7,7,3,4,1
"Spain",213,7,6,10,5,5,2
"Argentina",213,8,7,5,1,4,1
"Australia",213,8,4,1,3,-2,2
"Argentina",214,2,9,10,2,8,1
"Japan",214,2,4,3,4,-1,2
"Wales",214,3,7,5,2,3,1
"Australia",214,3,4,3,4,-1,2
"Switzerland",214,4,7,4,0,4,1
"Brazil",214,4,5,2,0,2,2
"Spain",214,6,9,15,3,12,1
"Iran",214,6,6,7,4,3,2
"Netherlands",214,7,9,6,0,6,1
"Belgium",214,7,6,5,2,3,2
"Germany",215,1,9,4,1,3,1
"Qatar",215,1,4,4,2,2,2
"Italy",215,2,9,9,1,8,1
"France",215,2,6,4,2,2,2
"Portugal",215,4,9,8,0,8,1
"Croatia",215,4,6,3,4,-1,2
"Belgium",215,5,9,4,0,4,1
"Uruguay",215,5,6,5,2,3,2
"Netherlands",215,8,7,4,2,2,1
"Chile",215,8,4,3,1,2,2
"Mexico",216,1,7,6,0,6,1
"Qatar",216,1,5,3,1,2,2
"Senegal",216,2,7,6,3,3,1
"Croatia",216,2,4,4,2,2,2
"Netherlands",216,3,6,3,4,-1,1
"Argentina",216,3,5,5,2,3,2
"Belgium",216,8,7,9,2,7,1
"Germany",216,8,5,9,4,5,2
"Netherlands",217,1,7,4,0,4,1
"Wales",217,1,6,6,5,1,2
"England",217,3,9,8,1,7,1
"Mexico",217,3,6,5,4,1,2
"Belgium",217,4,7,8,3,5,1
"United States",217,4,5,6,4,2,2
"Portugal",217,5,9,11,2,9,1
"Germany",217,5,6,2,4,-2,2
"Italy",217,6,7,4,1,3,1
"Brazil",217,6,5,4,2,2,2
"Colombia",217,7,7,3,1,2,1
"Spain",217,7,6,3,1,2,2
"Poland",218,1,9,9,1,8,1
"Qatar",218,1,6,2,3,-1,2
"Croatia",218,3,7,4,1,3,1
"Brazil",218,3,6,6,2,4,2
"Denmark",218,4,5,6,3,3,1
"Senegal",218,4,4,2,4,-2,2
"Mexico",218,5,7,7,4,3,1
"France",218,5,5,4,1,3,2
"Italy",218,8,9,8,1,7,1
"Portugal",218,8,6,4,3,1,2
"Brazil",219,2,9,9,0,9,1
"Senegal",219,2,4,2,4,-2,2
"Uruguay",219,3,9,9,2,7,1
"Spain",219,3,6,10,3,7,2
"Belgium",219,5,7,11,4,7,1
"Iran",219,5,5,5,4,1,2
"Argentina",219,8,7,6,2,4,1
"Korea Republic",219,8,6,4,3,1,2
"Mexico",220,6,7,4,1,3,1
"Belgium",220,6,6,6,1,5,2
"Japan",220,7,6,4,4,0,1
"Costa Rica",220,7,5,3,1,2,2
"Poland",221,1,7,3,0,3,1
"Denmark",221,1,6,3,3,0,2
"Mexico",221,2,7,7,2,5,1
"France",221,2,4,4,4,0,2
"Belgium",221,3,7,6,2,4,1
"Croatia",221,3,4,3,5,-2,2
"Spain",221,4,9,8,2,6,1
"Chile",221,4,6,7,5,2,2
"Argentina",221,5,7,4,1,3,1
"Germany",221,5,6,4,3,1,2
"England",221,6,9,5,1,4,1
"Korea Republic",221,6,4,5,5,0,2
"Netherlands",221,7,7,6,3,3,1
"Brazil",221,7,5,3,2,1,2
"Uruguay",221,8,7,5,2,3,1
"Portugal",221,8,4,3,2,1,2
"Mexico",222,1,9,4,1,3,1
"Morocco",222,1,4,2,2,0,2
"Argentina",222,3,9,8,3,5,1
"Croatia",222,3,4,6,6,0,2
"Belgium",222,5,7,5,2,3,1
"Italy",222,5,5,6,4,2,2
"Spain",222,6,7,5,1,4,1
"Netherlands",222,6,4,4,3,1,2
"France",222,8,7,10,4,6,1
"Uruguay",222,8,4,2,4,-2,2
"Algeria",223,1,7,4,1,3,1
"Switzerland",223,1,4,3,3,0,2
"Brazil",223,2,9,9,0,9,1
"Denmark",223,2,6,5,6,-1,2
"Spain",223,4,7,4,0,4,1
"Australia",223,4,5,3,2,1,2
"Germany",223,5,7,8,2,6,1
"Chile",223,5,3,2,2,0,2
"France",223,6,9,9,2,7,1
"Italy",223,6,6,4,2,2,2
"Iran",223,8,7,5,3,2,1
"Wales",223,8,4,1,1,0,2
"Senegal",224,1,7,3,0,3,1
"Costa Rica",224,1,4,2,2,0,2
"Spain",224,3,7,5,2,3,1
"Colombia",224,3,5,6,3,3,2
"Germany",224,4,7,8,4,4,1
"Japan",224,4,5,9,4,5,2
"Chile",224,6,9,7,1,6,1
"Portugal",224,6,4,4,3,1,2
"Denmark",225,1,9,6,0,6,1
"Senegal",225,1,6,6,3,3,2
"Brazil",225,2,9,10,2,8,1
"Iran",225,2,6,5,2,3,2
"Argentina",225,6,6,5,3,2,1
"Netherlands",225,6,5,3,2,1,2
"Korea Republic",225,7,6,4,5,-1,1
"Italy",225,7,5,8,5,3,2
"Colombia",225,8,7,5,2,3,1
"Morocco",225,8,4,2,2,0,2
"Brazil",226,3,6,9,2,7,1
"Netherlands",226,3,5,2,1,1,2
"Belgium",226,5,7,7,4,3,1
"Denmark",226,5,5,5,4,1,2
"Wales",226,6,7,3,0,3,1
"Portugal",226,6,5,1,0,1,2
"Costa Rica",226,8,7,6,3,3,1
"Uruguay",226,8,5,8,3,5,2
"France",227,3,7,8,1,7,1
"Senegal",227,3,6,5,6,-1,2
"Argentina",227,4,7,5,2,3,1
"United States",227,4,5,2,1,1,2
"Germany",227,6,7,6,1,5,1
"Spain",227,6,5,3,1,2,2
"Brazil",227,7,7,6,2,4,1
"Denmark",227,7,5,4,3,1,2
"England",227,8,9,7,1,6,1
"Italy",227,8,6,4,5,-1,2
"Japan",228,3,7,7,4,3,1
"Netherlands",228,3,4,4,3,1,2
"Spain",228,4,9,5,0,5,1
"Poland",228,4,6,3,3,0,2
"Argentina",228,5,9,5,2,3,1
"Switzerland",228,5,6,5,3,2,2
"France",228,8,7,5,0,5,1
"Korea Republic",228,8,6,5,1,4,2
"Belgium",229,3,7,4,1,3,1
"Japan",229,3,6,7,3,4,2
"Argentina",229,5,7,5,1,4,1
"Germany",229,5,6,5,4,1,2
"Spain",229,6,9,5,1,4,1
"Switzerland",229,6,6,5,3,2,2
"Netherlands",229,7,9,10,1,9,1
"England",229,7,6,4,3,1,2
"Denmark",230,1,5,4,3,1,1
"Qatar",230,1,4,3,3,0,2
"Italy",230,2,7,5,2,3,1
"Wales",230,2,6,3,2,1,2
"Germany",230,4,9,7,2,5,1
"England",230,4,6,6,4,2,2
"Switzerland",230,5,9,7,4,3,1
"Mexico",230,5,6,5,4,1,2
"Brazil",230,6,9,9,2,7,1
"Croatia",230,6,6,5,4,1,2
"Colombia",230,7,9,6,2,4,1
"Australia",230,7,4,2,3,-1,2
"Japan",230,8,7,6,4,2,1
"Nigeria",230,8,3,2,2,0,2
"Portugal",231,3,9,11,5,6,1
"Uruguay",231,3,4,9,7,2,2
"Belgium",231,4,7,10,2,8,1
"Wales",231,4,4,4,7,-3,2
"Brazil",231,5,9,7,0,7,1
"United States",231,5,6,4,3,1,2
"Italy",231,6,7,8,2,6,1
"Switzerland",231,6,6,3,3,0,2
"Germany",232,1,7,5,3,2,1
"Nigeria",232,1,4,2,3,-1,2
"Argentina",232,2,9,6,0,6,1
"Croatia",232,2,4,2,2,0,2
"Chile",232,5,7,7,4,3,1
"Denmark",232,5,5,6,3,3,2
"Switzerland",232,7,9,6,2,4,1
"Mexico",232,7,4,5,3,2,2
"France",232,8,9,5,2,3,1
"United States",232,8,4,3,3,0,2
"Brazil",233,2,7,8,1,7,1
"Germany",233,2,4,5,6,-1,2
"England",233,5,7,6,3,3,1
"Tunisia",233,5,4,2,3,-1,2
"Portugal",233,7,7,7,3,4,1
"Netherlands",233,7,6,5,3,2,2
"Belgium",233,8,7,8,2,6,1
"Uruguay",233,8,6,7,5,2,2
"Switzerland",234,3,6,3,2,1,1
"Italy",234,3,5,3,2,1,2
"Netherlands",234,4,7,6,1,5,1
"Poland",234,4,4,3,3,0,2
"England",234,5,9,9,1,8,1
"Chile",234,5,6,4,4,0,2
"France",234,6,9,7,0,7,1
"Japan",234,6,6,3,2,1,2
"Argentina",234,7,9,8,3,5,1
"Tunisia",234,7,6,6,5,1,2
"Spain",234,8,9,6,2,4,1
"Iran",234,8,6,4,3,1,2
"Germany",235,3,7,6,4,2,1
"Wales",235,3,6,8,5,3,2
"Belgium",235,6,9,5,1,4,1
"Denmark",235,6,4,4,4,0,2
"Argentina",235,7,9,7,2,5,1
"Japan",235,7,6,8,3,5,2
"France",236,2,9,10,1,9,1
"Japan",236,2,4,2,4,-2,2
"Switzerland",236,3,7,3,1,2,1
"Belgium",236,3,4,5,2,3,2
"Netherlands",236,5,7,5,2,3,1
"United States",236,5,4,4,5,-1,2
"Brazil",236,6,9,7,0,7,1
"Denmark",236,6,4,1,1,0,2
"Switzerland",237,1,7,7,4,3,1
"Italy",237,1,5,5,2,3,2
"Germany",237,2,9,6,2,4,1
"Argentina",237,2,4,6,3,3,2
"Portugal",237,3,9,4,0,4,1
"Nigeria",237,3,6,2,1,1,2
"Netherlands",237,5,9,7,1,6,1
"France",237,5,6,5,3,2,2
"Spain",237,6,9,5,1,4,1
"Iran",237,6,6,3,2,1,2
"Chile",238,1,7,4,1,3,1
"Mexico",238,1,6,4,4,0,2
"Portugal",238,3,7,4,2,2,1
"Australia",238,3,3,3,3,0,2
"Brazil",238,4,9,12,0,12,1
"Netherlands",238,4,6,6,5,1,2
"England",238,5,9,8,2,6,1
"Uruguay",238,5,6,6,4,2,2
"Spain",238,6,9,6,2,4,1
"Nigeria",238,6,4,5,4,1,2
"Iran",238,7,7,4,2,2,1
"Argentina",238,7,5,5,4,1,2
"Korea Republic",239,3,9,5,0,5,1
"Portugal",239,3,6,5,2,3,2
"Belgium",239,4,7,3,1,2,1
"Netherlands",239,4,6,6,2,4,2
"France",239,5,7,4,1,3,1
"Switzerland",239,5,4,2,2,0,2
"Denmark",239,6,7,4,0,4,1
"Argentina",239,6,4,3,4,-1,2
"Colombia",239,8,7,3,1,2,1
"England",239,8,5,4,2,2,2
"Qatar",240,1,7,3,1,2,1
"Switzerland",240,1,6,6,3,3,2
"Iran",240,3,9,5,0,5,1
"Chile",240,3,6,4,1,3,2
"Argentina",240,5,9,8,0,8,1
"Denmark",240,5,6,5,3,2,2
"Belgium",240,6,9,8,1,7,1
"Netherlands",240,6,6,4,5,-1,2
"England",241,2,9,6,0,6,1
"Colombia",241,2,4,1,2,-1,2
"Brazil",241,4,9,8,1,7,1
"Mexico",241,4,6,3,3,0,2
"Argentina",241,6,7,4,1,3,1
"Switzerland",241,6,6,7,5,2,2
"Belgium",241,8,9,12,3,9,1
"Wales",241,8,6,5,5,0,2
"Croatia",242,1,7,7,1,6,1
"Tunisia",242,1,5,5,4,1,2
"Netherlands",242,2,7,7,3,4,1
"Spain",242,2,5,6,4,2,2
"Germany",242,3,7,10,3,7,1
"Korea Republic",242,3,4,3,5,-2,2
"Belgium",242,4,7,4,1,3,1
"Poland",242,4,6,6,4,2,2
"Argentina",242,5,7,6,2,4,1
"Denmark",242,5,6,5,5,0,2
"France",242,7,7,9,3,6,1
"Mexico",242,7,5,6,4,2,2
"Uruguay",242,8,6,6,3,3,1
"Portugal",242,8,5,5,4,1,2
"France",243,4,9,8,1,7,1
"Italy",243,4,4,7,3,4,2
"Argentina",243,5,7,7,4,3,1
"Switzerland",243,5,5,3,2,1,2
"Spain",243,6,7,6,2,4,1
"Poland",243,6,5,4,3,1,2
"Mexico",243,8,7,3,0,3,1
"Wales",243,8,4,2,2,0,2
"Portugal",244,5,9,4,1,3,1
"Chile",244,5,4,4,3,1,2
"Uruguay",244,6,9,9,1,8,1
"Tunisia",244,6,4,1,3,-2,2
"France",244,7,7,6,1,5,1
"United States",244,7,5,5,4,1,2
"Argentina",244,8,7,5,2,3,1
"Italy",244,8,5,4,2,2,2
"Portugal",245,2,7,8,1,7,1
"Algeria",245,2,4,6,5,1,2
"Brazil",245,3,7,7,4,3,1
"Wales",245,3,5,5,4,1,2
"Croatia",245,5,9,7,2,5,1
"Argentina",245,5,6,7,3,4,2
"England",245,6,9,5,1,4,1
"Tunisia",245,6,4,2,3,-1,2
"Spain",245,8,7,4,0,4,1
"Morocco",245,8,4,2,3,-1,2
"Denmark",246,1,9,4,0,4,1
"Qatar",246,1,4,3,4,-1,2
"France",246,3,9,9,1,8,1
"Japan",246,3,6,4,6,-2,2
"Belgium",246,4,9,5,0,5,1
"Croatia",246,4,6,5,2,3,2
"Argentina",246,5,7,8,1,7,1
"Mexico",246,5,4,4,6,-2,2
"Tunisia",246,7,7,5,3,2,1
"England",246,7,4,2,2,0,2
"Korea Republic",247,2,6,5,3,2,1
"Wales",247,2,5,3,1,2,2
"France",247,3,9,5,1,4,1
"United States",247,3,4,4,4,0,2
"Uruguay",247,4,9,7,1,6,1
"Portugal",247,4,6,3,2,1,2
"Brazil",247,5,7,4,2,2,1
"Mexico",247,5,4,4,4,0,2
"Argentina",247,6,7,4,2,2,1
"Germany",247,6,4,2,2,0,2
"Poland",247,8,6,2,1,1,1
"England",247,8,5,2,1,1,2
"Korea Republic",248,2,7,6,2,4,1
"Belgium",248,2,6,5,6,-1,2
"Argentina",248,3,9,10,2,8,1
"Mexico",248,3,4,1,3,-2,2
"Germany",248,4,7,6,1,5,1
"Brazil",248,4,6,5,4,1,2
"Spain",248,7,9,6,1,5,1
"Uruguay",248,7,6,5,3,2,2
"Colombia",249,1,9,5,0,5,1
"Jamaica",249,1,6,5,3,2,2
"France",249,3,9,5,1,4,1
"Croatia",249,3,4,6,6,0,2
"Brazil",249,5,9,5,0,5,1
"Wales",249,5,6,3,1,2,2
"Portugal",249,6,7,6,1,5,1
"Uruguay",249,6,5,3,1,2,2
"Uruguay",250,1,7,5,2,3,1
"Qatar",250,1,4,4,3,1,2
"Iran",250,2,6,4,3,1,1
"Brazil",250,2,5,3,1,2,2
"Japan",250,3,7,6,2,4,1
"England",250,3,6,5,3,2,2
"France",250,4,7,4,1,3,1
"Australia",250,4,6,5,4,1,2
"Argentina",250,7,6,5,3,2,1
"Netherlands",250,7,5,4,2,2,2
"Poland",251,1,7,6,1,5,1
"Italy",251,1,4,4,2,2,2
"Belgium",251,2,6,2,1,1,1
"Netherlands",251,2,5,3,2,1,2
"Spain",251,4,9,14,2,12,1
"Colombia",251,4,4,4,4,0,2
"Brazil",251,6,7,8,1,7,1
"Croatia",251,6,5,5,3,2,2
"Uruguay",251,7,7,7,2,5,1
"France",251,7,6,5,4,1,2
"Argentina",251,8,9,10,3,7,1
"Switzerland",251,8,4,6,5,1,2
"Switzerland",252,1,6,7,4,3,1
"Mexico",252,1,5,6,5,1,2
"Spain",252,2,7,4,1,3,1
"Senegal",252,2,5,4,2,2,2
"France",252,3,9,11,0,11,1
"Italy",252,3,6,7,6,1,2
"Netherlands",252,4,9,6,0,6,1
"Argentina",252,4,6,5,2,3,2
"Japan",252,5,7,4,2,2,1
"Brazil",252,5,6,4,3,1,2
"Wales",252,6,7,3,1,2,1
"Colombia",252,6,5,2,1,1,2
"Uruguay",252,7,9,9,2,7,1
"Poland",252,7,6,2,3,-1,2
"Belgium",252,8,7,4,2,2,1
"Chile",252,8,4,4,3,1,2
"Netherlands",253,1,9,5,0,5,1
"Qatar",253,1,6,7,2,5,2
"Germany",253,2,7,8,2,6,1
"Argentina",253,2,6,9,4,5,2
"France",253,3,6,6,5,1,1
"Uruguay",253,3,5,6,4,2,2
"Brazil",253,6,9,9,2,7,1
"Croatia",253,6,4,4,4,0,2
"Spain",253,8,9,7,4,3,1
"Iran",253,8,4,6,6,0,2
"France",254,2,9,7,3,4,1
"Korea Republic",254,2,4,5,4,1,2
"Uruguay",254,3,7,7,2,5,1
"Belgium",254,3,4,5,4,1,2
"England",254,5,7,3,1,2,1
"Colombia",254,5,6,3,2,1,2
"Argentina",254,6,7,6,1,5,1
"Australia",254,6,4,3,5,-2,2
"Portugal",255,2,7,7,1,6,1
"Mexico",255,2,6,5,2,3,2
"Wales",255,3,6,3,2,1,1
"Brazil",255,3,5,3,2,1,2
"England",255,4,7,4,2,2,1
"Colombia",255,4,4,6,4,2,2
"Italy",255,5,7,5,2,3,1
"Argentina",255,5,4,5,5,0,2
"Chile",255,6,7,5,1,4,1
"Netherlands",255,6,6,5,6,-1,2
"Belgium",255,7,7,4,0,4,1
"Morocco",255,7,6,4,1,3,2
"Spain",255,8,9,12,2,10,1
"Croatia",255,8,6,7,3,4,2
"Croatia",256,1,7,4,1,3,1
"Qatar",256,1,5,2,1,1,2
"France",256,3,7,7,1,6,1
"Uruguay",256,3,5,3,2,1,2
"Japan",256,4,9,6,1,5,1
"Belgium",256,4,6,5,4,1,2
"Germany",256,5,7,4,2,2,1
"England",256,5,6,5,3,2,2
"Portugal",256,7,7,4,0,4,1
"Switzerland",256,7,6,4,5,-1,2
"Colombia",256,8,7,6,0,6,1
"Spain",256,8,5,3,1,2,2
"Denmark",257,4,7,7,2,5,1
"Tunisia",257,4,6,6,6,0,2
"Croatia",257,5,7,3,1,2,1
"Argentina",257,5,6,5,2,3,2
"Portugal",257,8,9,9,1,8,1
"Uruguay",257,8,6,8,4,4,2
"Denmark",258,1,6,4,4,0,1
"Qatar",258,1,5,2,0,2,2
"Colombia",258,2,9,7,1,6,1
"Belgium",258,2,6,5,3,2,2
"Mexico",258,3,7,10,5,5,1
"Algeria",258,3,4,6,6,0,2
"Uruguay",258,5,9,4,0,4,1
"England",258,5,6,3,1,2,2
"France",258,7,7,5,0,5,1
"Germany",258,7,6,4,5,-1,2
"Spain",259,2,7,8,4,4,1
"Korea Republic",259,2,6,4,3,1,2
"Portugal",259,3,7,3,1,2,1
"Colombia",259,3,4,2,2,0,2
"Germany",260,1,9,10,3,7,1
"Qatar",260,1,4,4,3,1,2
"Italy",260,3,7,5,0,5,1
"Brazil",260,3,6,5,3,2,2
"Netherlands",260,4,7,4,0,4,1
"France",260,4,6,4,1,3,2
"Spain",260,5,7,8,2,6,1
"Colombia",260,5,4,5,3,2,2
"Belgium",260,6,9,6,1,5,1
"Nigeria",260,6,4,2,2,0,2
"Argentina",260,8,6,6,4,2,1
"Denmark",260,8,5,5,4,1,2
"Denmark",261,2,7,3,1,2,1
"Korea Republic",261,2,5,4,2,2,2
"Mexico",261,5,9,8,2,6,1
"Argentina",261,5,4,3,2,1,2
"Portugal",261,6,7,5,1,4,1
"Uruguay",261,6,5,7,2,5,2
"France",261,7,9,10,2,8,1
"Colombia",261,7,6,7,4,3,2
"Brazil",261,8,7,8,4,4,1
"Netherlands",261,8,6,4,3,1,2
"Denmark",262,1,9,6,0,6,1
"Qatar",262,1,6,4,2,2,2
"France",262,2,9,6,1,5,1
"Iran",262,2,4,2,2,0,2
"Argentina",262,3,7,6,0,6,1
"Korea Republic",262,3,6,4,6,-2,2
"Australia",262,4,7,5,2,3,1
"Brazil",262,4,6,6,2,4,2
"England",262,5,9,5,1,4,1
"Uruguay",262,5,6,5,2,3,2
"Poland",262,6,5,3,2,1,1
"Portugal",262,6,4,3,3,0,2
"Belgium",262,7,7,4,1,3,1
"Italy",262,7,5,5,3,2,2
"Belgium",263,2,9,4,0,4,1
"Netherlands",263,2,6,4,1,3,2
"Brazil",263,3,6,7,4,3,1
"Poland",263,3,5,1,0,1,2
"Switzerland",263,4,9,5,0,5,1
"Spain",263,4,6,5,1,4,2
"Portugal",263,5,7,9,0,9,1
"Australia",263,5,5,4,3,1,2
"Germany",264,1,7,5,2,3,1
"Switzerland",264,1,5,2,1,1,2
"Japan",264,4,7,4,1,3,1
"Mexico",264,4,6,5,2,3,2
"Croatia",264,5,9,5,0,5,1
"Argentina",264,5,6,5,2,3,2
"France",264,6,7,7,2,5,1
"Chile",264,6,4,2,5,-3,2
"Brazil",264,7,7,9,4,5,1
"Netherlands",264,7,6,9,5,4,2
"Portugal",264,8,7,4,0,4,1
"Poland",264,8,4,5,6,-1,2
"Colombia",265,1,7,5,2,3,1
"Jamaica",265,1,6,5,2,3,2
"Spain",265,4,7,8,5,3,1
"Croatia",265,4,4,4,5,-1,2
"Belgium",265,5,9,9,0,9,1
"Poland",265,5,4,3,3,0,2
"United States",265,6,7,5,2,3,1
"Uruguay",265,6,4,3,4,-1,2
"Denmark",265,7,9,6,2,4,1
"France",265,7,4,3,4,-1,2
"Brazil",265,8,9,4,0,4,1
"Mexico",265,8,6,5,2,3,2
"Switzerland",266,1,7,8,4,4,1
"Germany",266,1,6,6,4,2,2
"Italy",266,2,9,3,0,3,1
"Argentina",266,2,6,7,4,3,2
"Mexico",266,3,7,4,2,2,1
"Algeria",266,3,5,4,3,1,2
"Uruguay",266,4,9,7,0,7,1
"Morocco",266,4,4,4,6,-2,2
"England",266,5,9,8,3,5,1
"Croatia",266,5,4,2,2,0,2
"Denmark",266,7,6,4,2,2,1
"Portugal",266,7,5,3,2,1,2
"Croatia",267,1,9,7,3,4,1
"Qatar",267,1,4,4,4,0,2
"England",267,2,9,5,2,3,1
"Iran",267,2,6,5,2,3,2
"Netherlands",267,4,9,11,4,7,1
"Belgium",267,4,6,8,4,4,2
"Brazil",267,5,9,4,1,3,1
"Mexico",267,5,6,5,2,3,2
"Denmark",267,7,9,8,1,7,1
"Spain",267,7,6,3,3,0,2
"Germany",268,4,9,11,2,9,1
"Nigeria",268,4,4,3,4,-1,2
"France",268,7,7,3,1,2,1
"Croatia",268,7,5,4,1,3,2
"Poland",268,8,7,7,3,4,1
"Netherlands",268,8,6,6,2,4,2
"England",269,2,7,3,1,2,1
"Denmark",269,2,4,4,3,1,2
"Portugal",269,4,9,4,1,3,1
"Colombia",269,4,6,3,2,1,2
"Belgium",269,7,9,8,1,7,1
"Australia",269,7,6,4,4,0,2
"Denmark",270,1,7,3,1,2,1
"Qatar",270,1,3,1,1,0,2
"France",270,2,7,6,3,3,1
"Iran",270,2,6,3,2,1,2
"Brazil",270,3,7,7,4,3,1
"Croatia",270,3,4,4,3,1,2
"Netherlands",270,5,7,6,1,5,1
"Japan",270,5,6,3,2,1,2
"Colombia",271,2,9,8,3,5,1
"Spain",271,2,6,6,3,3,2
"Korea Republic",271,3,9,8,2,6,1
"Portugal",271,3,4,6,5,1,2
"Belgium",271,6,9,9,1,8,1
"Netherlands",271,6,6,6,3,3,2
"Germany",271,7,7,3,1,2,1
"Argentina",271,7,5,4,2,2,2
"France",272,2,9,4,1,3,1
"Netherlands",272,2,6,6,4,2,2
"Brazil",272,3,6,4,4,0,1
"Iran",272,3,5,3,0,3,2
"England",272,5,7,6,2,4,1
"Chile",272,5,6,4,3,1,2
"Australia",272,6,7,3,1,2,1
"Portugal",272,6,4,5,5,0,2
"Uruguay",272,8,7,4,1,3,1
"Korea Republic",272,8,4,3,4,-1,2
"Colombia",273,1,7,6,2,4,1
"Tunisia",273,1,4,1,5,-4,2
"Brazil",273,2,7,9,3,6,1
"Netherlands",273,2,6,5,2,3,2
"Uruguay",273,5,7,9,3,6,1
"England",273,5,6,3,1,2,2
"Argentina",273,7,7,7,4,3,1
"Croatia",273,7,4,3,3,0,2
"Germany",273,8,9,5,2,3,1
"Portugal",273,8,6,5,3,2,2
"Colombia",274,1,7,8,2,6,1
"Poland",274,1,5,3,1,2,2
"Brazil",274,2,7,4,1,3,1
"Iran",274,2,4,2,4,-2,2
"France",274,3,9,8,1,7,1
"Korea Republic",274,3,4,5,8,-3,2
"England",274,4,9,6,1,5,1
"Australia",274,4,6,7,2,5,2
"Uruguay",274,5,9,8,3,5,1
"Belgium",274,5,6,5,4,1,2
"Netherlands",274,6,7,4,1,3,1
"Japan",274,6,6,4,3,1,2
"Portugal",274,8,7,11,6,5,1
"Wales",274,8,6,10,8,2,2
"Switzerland",275,1,9,7,1,6,1
"Costa Rica",275,1,4,2,2,0,2
"Spain",275,2,9,6,0,6,1
"Netherlands",275,2,6,4,3,1,2
"Germany",275,3,7,5,2,3,1
"Senegal",275,3,6,5,3,2,2
"Belgium",275,4,7,6,2,4,1
"Wales",275,4,6,5,3,2,2
"Poland",275,5,9,5,2,3,1
"Brazil",275,5,6,6,3,3,2
"England",275,6,7,4,2,2,1
"Uruguay",275,6,6,6,4,2,2
"Korea Republic",275,7,7,5,2,3,1
"Chile",275,7,4,3,3,0,2
"Italy",276,1,9,10,2,8,1
"Wales",276,1,6,4,5,-1,2
"Germany",276,3,7,6,2,4,1
"Poland",276,3,5,5,2,3,2
"Korea Republic",276,4,7,5,2,3,1
"France",276,4,4,3,4,-1,2
"Netherlands",276,5,9,11,3,8,1
"Spain",276,5,4,6,4,2,2
"Morocco",276,6,7,7,4,3,1
"England",276,6,4,5,5,0,2
"Portugal",276,7,9,7,0,7,1
"Uruguay",276,7,4,2,5,-3,2
"Colombia",277,1,9,6,2,4,1
"Senegal",277,1,6,3,2,1,2
"Germany",277,5,9,6,1,5,1
"England",277,5,6,4,2,2,2
"Mexico",277,7,6,4,2,2,1
"France",277,7,5,2,1,1,2
"Belgium",277,8,7,9,4,5,1
"United States",277,8,4,3,4,-1,2
"Tunisia",278,1,6,5,2,3,1
"Qatar",278,1,5,2,1,1,2
"Spain",278,4,7,6,1,5,1
"Nigeria",278,4,4,2,4,-2,2
"Algeria",278,5,6,6,6,0,1
"Belgium",278,5,5,6,3,3,2
"Germany",278,6,7,2,0,2,1
"Argentina",278,6,6,8,3,5,2
"Spain",279,2,7,8,4,4,1
"Denmark",279,2,5,6,5,1,2
"Brazil",279,4,7,7,2,5,1
"Mexico",279,4,5,4,2,2,2
"Germany",279,5,9,10,0,10,1
"Korea Republic",279,5,4,2,6,-4,2
"Colombia",279,6,7,7,4,3,1
"Portugal",279,6,6,5,3,2,2
"Belgium",279,7,9,8,1,7,1
"Iran",279,7,4,5,4,1,2
"France",279,8,7,8,3,5,1
"Croatia",279,8,5,4,1,3,2
"Wales",280,1,9,9,3,6,1
"Denmark",280,1,6,6,3,3,2
"Portugal",280,2,7,5,0,5,1
"Italy",280,2,5,9,0,9,2
"Uruguay",280,4,6,3,2,1,1
"Jamaica",280,4,5,2,0,2,2
"Spain",280,5,9,6,1,5,1
"United States",280,5,6,2,1,1,2
"Brazil",280,8,9,6,0,6,1
"Croatia",280,8,6,5,3,2,2
"Senegal",281,3,7,4,0,4,1
"Netherlands",281,3,5,2,1,1,2
"England",281,4,9,8,2,6,1
"Uruguay",281,4,6,5,2,3,2
"Brazil",281,5,9,8,3,5,1
"Germany",281,5,4,7,5,2,2
"Belgium",281,6,9,11,2,9,1
"Wales",281,6,4,3,5,-2,2
"Italy",281,7,9,8,3,5,1
"France",281,7,4,4,4,0,2
"Argentina",281,8,9,9,2,7,1
"Japan",281,8,6,4,4,0,2
"Italy",282,1,9,7,1,6,1
"Switzerland",282,1,6,4,2,2,2
"Belgium",282,3,9,6,0,6,1
"Costa Rica",282,3,4,2,4,-2,2
"Japan",282,4,7,3,1,2,1
"Croatia",282,4,4,5,5,0,2
"Spain",282,5,9,7,1,6,1
"Uruguay",282,5,4,3,3,0,2
"Mexico",282,6,6,3,3,0,1
"Portugal",282,6,5,4,2,2,2
"Korea Republic",282,7,7,5,2,3,1
"Netherlands",282,7,6,4,3,1,2
"England",282,8,7,8,3,5,1
"Australia",282,8,5,4,2,2,2
"Germany",283,2,7,8,1,7,1
"Portugal",283,2,6,4,5,-1,2
"Uruguay",283,3,9,7,3,4,1
"Belgium",283,3,6,6,5,1,2
"Denmark",283,6,9,4,1,3,1
"Argentina",283,6,6,4,3,1,2
"Iran",283,8,6,4,3,1,1
"Senegal",283,8,5,3,1,2,2
"Iran",284,2,7,7,2,5,1
"Colombia",284,2,4,4,4,0,2
"Uruguay",284,3,9,7,1,6,1
"France",284,3,6,6,3,3,2
"Croatia",284,5,9,6,1,5,1
"Morocco",284,5,6,3,3,0,2
"Netherlands",284,6,7,4,2,2,1
"Spain",284,6,5,3,2,1,2
"Germany",284,7,9,7,2,5,1
"Portugal",284,7,6,7,2,5,2
"Colombia",285,1,7,6,0,6,1
"Tunisia",285,1,6,4,4,0,2
"Belgium",285,2,9,9,1,8,1
"Poland",285,2,6,5,2,3,2
"Mexico",285,3,7,4,2,2,1
"Wales",285,3,4,4,4,0,2
"Uruguay",285,4,7,5,1,4,1
"France",285,4,6,5,3,2,2
"England",285,5,6,10,6,4,1
"Denmark",285,5,5,5,3,2,2
"Argentina",285,7,7,5,1,4,1
"Iran",285,7,4,1,3,-2,2
"Italy",286,1,7,2,0,2,1
"Algeria",286,1,5,2,1,1,2
"Belgium",286,2,9,11,2,9,1
"Korea Republic",286,2,6,6,8,-2,2
"Argentina",286,4,7,6,3,3,1
"Morocco",286,4,4,3,3,0,2
"Spain",286,5,9,7,1,6,1
"Colombia",286,5,4,4,2,2,2
"Uruguay",286,7,9,6,1,5,1
"Portugal",286,7,6,8,3,5,2
"Croatia",286,8,9,7,2,5,1
"England",286,8,4,3,3,0,2
"Italy",287,1,9,9,3,6,1
"Qatar",287,1,4,4,4,0,2
"Argentina",287,2,7,7,2,5,1
"Mexico",287,2,4,5,5,0,2
"Portugal",287,3,7,4,2,2,1
"Netherlands",287,3,4,3,1,2,2
"Belgium",287,5,9,6,1,5,1
"Colombia",287,5,6,5,3,2,2
"Brazil",287,6,7,7,3,4,1
"Wales",287,6,6,6,4,2,2
"Qatar",288,1,7,5,1,4,1
"Colombia",288,1,5,4,1,3,2
"Germany",288,4,9,6,2,4,1
"United States",288,4,4,1,2,-1,2
"Belgium",288,7,5,4,2,2,1
"Croatia",288,7,4,2,3,-1,2
"Qatar",289,1,7,7,3,4,1
"Chile",289,1,5,3,2,1,2
"Argentina",289,2,7,4,2,2,1
"Germany",289,2,5,5,4,1,2
"France",289,3,7,9,2,7,1
"United States",289,3,4,3,3,0,2
"Uruguay",289,4,9,5,1,4,1
"Wales",289,4,6,6,3,3,2
"Switzerland",289,5,9,5,1,4,1
"Algeria",289,5,4,3,3,0,2
"Spain",289,6,6,7,2,5,1
"Nigeria",289,6,5,4,3,1,2
"Iran",289,7,7,6,2,4,1
"Mexico",289,7,4,5,4,1,2
"Brazil",289,8,9,10,1,9,1
"Senegal",289,8,6,2,6,-4,2
"Spain",290,3,9,7,2,5,1
"Chile",290,3,4,5,4,1,2
"France",290,6,9,8,0,8,1
"Uruguay",290,6,6,4,5,-1,2
"England",290,7,9,6,1,5,1
"Italy",290,7,6,6,2,4,2
"Argentina",290,8,6,3,2,1,1
"Netherlands",290,8,5,2,1,1,2
"Mexico",291,1,7,7,3,4,1
"Qatar",291,1,4,1,2,-1,2
"Portugal",291,3,9,6,1,5,1
"Germany",291,3,4,3,5,-2,2
"Brazil",291,5,9,7,0,7,1
"Tunisia",291,5,6,4,4,0,2
"Croatia",291,6,9,5,2,3,1
"Belgium",291,6,6,10,2,8,2
"Spain",291,8,7,5,3,2,1
"Colombia",291,8,4,4,3,1,2
"Uruguay",292,1,9,9,2,7,1
"Qatar",292,1,4,4,4,0,2
"Spain",292,4,9,11,0,11,1
"Italy",292,4,6,4,6,-2,2
"France",292,5,7,5,1,4,1
"Denmark",292,5,6,7,2,5,2
"Morocco",292,6,9,4,0,4,1
"Netherlands",292,6,6,3,1,2,2
"Uruguay",293,1,7,6,1,5,1
"United States",293,1,4,3,2,1,2
"Croatia",293,3,7,2,0,2,1
"Belgium",293,3,6,5,1,4,2
"Poland",293,5,7,6,4,2,1
"Spain",293,5,4,3,3,0,2
"France",293,8,9,9,1,8,1
"Denmark",293,8,6,7,5,2,2
"Germany",294,5,7,7,1,6,1
"France",294,5,5,3,2,1,2
"Brazil",294,6,7,4,2,2,1
"United States",294,6,4,3,3,0,2
"Argentina",294,7,7,7,0,7,1
"Denmark",294,7,6,5,4,1,2
"Belgium",294,8,9,4,0,4,1
"Senegal",294,8,4,1,2,-1,2
"Spain",295,2,9,5,0,5,1
"Tunisia",295,2,4,1,1,0,2
"Brazil",295,3,9,9,0,9,1
"Korea Republic",295,3,6,2,2,0,2
"France",295,4,9,9,1,8,1
"Senegal",295,4,6,4,1,3,2
"Colombia",295,5,7,4,2,2,1
"Japan",295,5,6,5,1,4,2
"Wales",295,7,6,5,4,1,1
"Argentina",295,7,5,4,2,2,2
"Italy",295,8,6,4,2,2,1
"Belgium",295,8,5,2,1,1,2
"Australia",296,2,7,5,1,4,1
"Wales",296,2,6,6,4,2,2
"Spain",296,4,9,8,0,8,1
"Denmark",296,4,6,8,2,6,2
"England",296,5,7,6,1,5,1
"Mexico",296,5,4,1,3,-2,2
"Portugal",296,7,5,7,2,5,1
"Tunisia",296,7,4,3,6,-3,2
"France",296,8,9,7,2,5,1
"Italy",296,8,6,6,2,4,2
"Switzerland",297,1,7,4,2,2,1
"Qatar",297,1,6,3,2,1,2
"Spain",297,2,6,7,3,4,1
"Denmark",297,2,5,4,2,2,2
"Portugal",297,5,7,6,3,3,1
"Colombia",297,5,5,4,2,2,2
"Wales",297,6,7,5,3,2,1
"Uruguay",297,6,5,5,3,2,2
"Brazil",298,2,9,7,0,7,1
"Netherlands",298,2,4,3,3,0,2
"Denmark",298,3,6,7,4,3,1
"Argentina",298,3,5,4,2,2,2
"England",298,5,7,4,2,2,1
"Colombia",298,5,6,2,1,1,2
"Germany",298,6,7,7,1,6,1
"Iran",298,6,5,3,2,1,2
"Belgium",298,8,7,9,4,5,1
"Chile",298,8,6,2,2,0,2
"Germany",299,1,7,8,3,5,1
"Costa Rica",299,1,5,7,2,5,2
"Netherlands",299,2,9,5,2,3,1
"Australia",299,2,4,4,4,0,2
"Uruguay",299,3,6,5,2,3,1
"Spain",299,3,5,2,1,1,2
"Chile",299,7,9,7,2,5,1
"Iran",299,7,6,5,3,2,2
"Senegal",300,1,7,4,2,2,1
"Uruguay",300,1,5,3,2,1,2
"Belgium",300,4,9,8,1,7,1
"United States",300,4,4,3,4,-1,2
"Portugal",300,6,9,6,1,5,1
"Croatia",300,6,4,3,3,0,2
"Argentina",300,7,9,5,1,4,1
"Germany",300,7,6,9,4,5,2
"Morocco",301,1,7,4,1,3,1
"Colombia",301,1,6,6,5,1,2
"Spain",301,2,9,7,1,6,1
"Croatia",301,2,4,3,4,-1,2
"Uruguay",301,3,9,5,1,4,1
"Senegal",301,3,4,3,4,-1,2
"Wales",301,4,9,5,1,4,1
"Brazil",301,4,6,9,2,7,2
"England",301,5,9,7,1,6,1
"Italy",301,5,4,5,3,2,2
"United States",302,1,7,5,1,4,1
"Uruguay",302,1,4,3,4,-1,2
"Iran",302,2,7,2,0,2,1
"Netherlands",302,2,6,5,3,2,2
"France",302,3,9,12,2,10,1
"Chile",302,3,4,1,1,0,2
"Algeria",302,4,9,3,0,3,1
"Argentina",302,4,4,6,3,3,2
"Spain",302,7,9,4,0,4,1
"Italy",302,7,4,3,2,1,2
"Portugal",303,7,7,4,2,2,1
"Korea Republic",303,7,6,6,4,2,2
"Mexico",304,1,6,3,2,1,1
"Qatar",304,1,5,3,1,2,2
"Brazil",304,2,7,10,2,8,1
"Croatia",304,2,3,1,1,0,2
"Germany",304,4,7,6,3,3,1
"Argentina",304,4,4,4,2,2,2
"Iran",304,7,7,3,1,2,1
"Uruguay",304,7,4,1,1,0,2
"Poland",305,1,7,4,0,4,1
"Qatar",305,1,6,4,1,3,2
"Belgium",305,4,9,6,0,6,1
"Australia",305,4,4,2,3,-1,2
"Brazil",305,7,7,2,0,2,1
"Denmark",305,7,5,4,2,2,2
"Uruguay",305,8,7,4,2,2,1
"England",305,8,6,5,3,2,2
"Colombia",306,1,7,10,4,6,1
"Poland",306,1,5,4,2,2,2
"England",306,3,7,3,1,2,1
"Chile",306,3,5,2,1,1,2
"Germany",306,4,7,5,0,5,1
"Portugal",306,4,4,5,3,2,2
"Denmark",306,7,7,6,2,4,1
"Spain",306,7,6,8,4,4,2
"Croatia",306,8,7,6,2,4,1
"Brazil",306,8,5,7,3,4,2
"France",307,3,9,10,3,7,1
"Korea Republic",307,3,6,4,3,1,2
"Senegal",307,5,6,2,2,0,1
"Netherlands",307,5,5,5,3,2,2
"Uruguay",307,6,9,6,1,5,1
"Japan",307,6,6,7,6,1,2
"Switzerland",307,7,7,3,1,2,1
"Croatia",307,7,4,2,2,0,2
"Belgium",307,8,9,5,1,4,1
"Australia",307,8,6,2,1,1,2
"Brazil",308,2,9,6,0,6,1
"Poland",308,2,4,3,2,1,2
"Mexico",308,4,7,8,2,6,1
"Portugal",308,4,4,5,4,1,2
"Argentina",308,5,7,8,4,4,1
"Croatia",308,5,5,4,3,1,2
"France",308,8,9,10,3,7,1
"Uruguay",308,8,6,7,5,2,2
"Colombia",309,1,7,3,1,2,1
"Tunisia",309,1,6,4,3,1,2
"Spain",309,2,7,5,1,4,1
"Japan",309,2,6,5,4,1,2
"France",309,3,7,5,1,4,1
"Italy",309,3,5,5,3,2,2
"Australia",309,5,7,4,2,2,1
"Mexico",309,5,6,2,1,1,2
"Argentina",309,7,9,7,1,6,1
"Netherlands",309,7,6,7,3,4,2
"Denmark",309,8,7,8,1,7,1
"Portugal",309,8,5,5,1,4,2
"Spain",310,3,6,2,3,-1,1
"Korea Republic",310,3,5,6,3,3,2
"England",310,4,7,5,0,5,1
"Iran",310,4,5,4,2,2,2
"Italy",310,5,9,6,0,6,1
"Tunisia",310,5,6,3,2,1,2
"Argentina",310,6,7,6,2,4,1
"Croatia",310,6,6,5,3,2,2
"Brazil",310,7,7,3,0,3,1
"Netherlands",310,7,4,2,3,-1,2
"Colombia",310,8,7,3,1,2,1
"France",310,8,5,4,1,3,2
"Costa Rica",311,1,6,6,2,4,1
"Qatar",311,1,5,2,1,1,2
"Wales",311,2,7,4,2,2,1
"England",311,2,6,6,3,3,2
"Brazil",311,3,9,10,2,8,1
"United States",311,3,6,7,8,-1,2
"Switzerland",311,4,7,3,1,2,1
"France",311,4,5,7,1,6,2
"Belgium",311,5,9,9,2,7,1
"Mexico",311,5,6,5,3,2,2
"Mexico",312,1,6,7,6,1,1
"Qatar",312,1,5,5,3,2,2
"Belgium",312,2,7,7,1,6,1
"Japan",312,2,4,2,4,-2,2
"Nigeria",312,5,7,5,3,2,1
"Uruguay",312,5,4,3,2,1,2
"France",312,8,7,5,3,2,1
"Iran",312,8,4,5,3,2,2
"Chile",313,3,6,4,3,1,1
"Spain",313,3,5,5,3,2,2
"Croatia",313,4,9,6,2,4,1
"Belgium",313,4,6,5,2,3,2
"Senegal",313,5,7,6,1,5,1
"Mexico",313,5,4,1,4,-3,2
"Portugal",313,6,7,7,2,5,1
"Italy",313,6,4,4,2,2,2
"Argentina",313,7,6,6,4,2,1
"Morocco",313,7,5,2,1,1,2
"Japan",313,8,7,5,2,3,1
"France",313,8,6,5,2,3,2
"Italy",314,1,9,10,0,10,1
"Jamaica",314,1,4,6,5,1,2
"Australia",314,2,9,5,1,4,1
"Belgium",314,2,6,7,3,4,2
"Algeria",314,4,7,2,0,2,1
"Switzerland",314,4,6,6,4,2,2
"Chile",314,5,7,3,0,3,1
"England",314,5,5,5,2,3,2
"Uruguay",314,7,9,4,0,4,1
"United States",314,7,4,2,3,-1,2
"Spain",314,8,9,5,1,4,1
"Mexico",314,8,4,5,3,2,2
"Denmark",315,1,7,3,1,2,1
"Chile",315,1,5,3,2,1,2
"Croatia",315,2,6,4,1,3,1
"Spain",315,2,5,5,4,1,2
"Wales",315,5,7,6,2,4,1
"England",315,5,6,4,4,0,2
"Mexico",315,7,9,5,2,3,1
"Korea Republic",315,7,6,5,3,2,2
"Netherlands",316,1,9,11,3,8,1
"Costa Rica",316,1,6,6,6,0,2
"Argentina",316,3,9,6,2,4,1
"Croatia",316,3,6,6,5,1,2
"Brazil",316,4,9,8,3,5,1
"Italy",316,4,4,2,2,0,2
"Belgium",316,5,9,7,2,5,1
"Switzerland",316,5,4,4,5,-1,2
"Spain",316,6,9,6,1,5,1
"Uruguay",316,6,6,5,2,3,2
"Chile",316,7,6,5,4,1,1
"Germany",316,7,5,4,2,2,2
"France",316,8,9,9,3,6,1
"Denmark",316,8,4,6,4,2,2
"Argentina",317,4,9,4,1,3,1
"Mexico",317,4,4,2,2,0,2
"France",317,6,7,9,3,6,1
"Italy",317,6,6,7,5,2,2
"Brazil",317,7,7,9,2,7,1
"Costa Rica",317,7,6,6,10,-4,2
"Jamaica",318,1,7,3,1,2,1
"Uruguay",318,1,4,5,4,1,2
"Morocco",318,5,9,5,1,4,1
"Denmark",318,5,6,4,4,0,2
"Korea Republic",318,6,7,4,2,2,1
"Argentina",318,6,6,4,1,3,2
"Brazil",318,7,9,6,1,5,1
"Germany",318,7,4,5,5,0,2
"Croatia",319,1,7,8,2,6,1
"Tunisia",319,1,4,2,5,-3,2
"Japan",319,3,9,5,0,5,1
"Portugal",319,3,6,3,3,0,2
"Spain",319,5,9,10,2,8,1
"Netherlands",319,5,6,3,2,1,2
"Brazil",319,6,7,7,2,5,1
"Wales",319,6,5,10,5,5,2
"England",319,7,6,4,2,2,1
"Denmark",319,7,5,4,3,1,2
"France",319,8,9,11,0,11,1
"Poland",319,8,4,1,3,-2,2
"Mexico",320,1,9,3,0,3,1
"Algeria",320,1,4,2,2,0,2
"Brazil",320,3,9,9,1,8,1
"Croatia",320,3,4,3,3,0,2
"Korea Republic",320,5,7,4,2,2,1
"Chile",320,5,5,2,1,1,2
"Italy",320,7,7,6,2,4,1
"Australia",320,7,5,4,3,1,2
"United States",320,8,6,3,2,1,1
"Denmark",320,8,5,2,1,1,2
"Senegal",321,1,9,6,0,6,1
"Colombia",321,1,4,2,5,-3,2
"Netherlands",321,7,9,7,2,5,1
"Argentina",321,7,6,5,3,2,2
"England",321,8,7,6,1,5,1
"Croatia",321,8,6,2,3,-1,2
"Uruguay",322,1,7,3,1,2,1
"Qatar",322,1,4,3,3,0,2
"Iran",322,2,9,5,2,3,1
"Argentina",322,2,6,4,2,2,2
"Chile",322,4,7,7,2,5,1
"Germany",322,4,4,3,3,0,2
"Japan",322,5,9,6,2,4,1
"Italy",322,5,6,3,2,1,2
"Spain",322,6,9,6,2,4,1
"Korea Republic",322,6,6,4,1,3,2
"France",322,8,9,7,0,7,1
"Switzerland",322,8,4,5,3,2,2
"Netherlands",323,1,9,5,2,3,1
"Qatar",323,1,4,6,5,1,2
"Belgium",323,2,7,7,0,7,1
"Algeria",323,2,4,1,1,0,2
"Spain",323,6,7,9,1,8,1
"Uruguay",323,6,4,4,4,0,2
"Brazil",323,8,7,4,1,3,1
"Germany",323,8,6,6,5,1,2
"Spain",324,3,7,4,1,3,1
"Japan",324,3,4,2,3,-1,2
"England",324,4,9,4,1,3,1
"Australia",324,4,6,5,2,3,2
"Italy",324,5,7,6,3,3,1
"Brazil",324,5,6,8,2,6,2
"Belgium",324,7,9,8,1,7,1
"Wales",324,7,4,4,5,-1,2
"Argentina",324,8,7,8,3,5,1
"Croatia",324,8,6,2,2,0,2
"Poland",325,1,9,7,3,4,1
"Morocco",325,1,6,5,3,2,2
"Portugal",325,3,9,6,0,6,1
"Switzerland",325,3,6,3,3,0,2
"Korea Republic",325,4,7,6,3,3,1
"Brazil",325,4,6,8,2,6,2
"Spain",325,6,9,13,0,13,1
"Nigeria",325,6,4,3,6,-3,2
"Netherlands",325,7,7,6,2,4,1
"Australia",325,7,4,5,5,0,2
"Denmark",325,8,9,4,1,3,1
"Japan",325,8,6,4,1,3,2
"Netherlands",326,4,7,6,1,5,1
"Portugal",326,4,5,2,0,2,2
"Korea Republic",326,5,7,5,2,3,1
"Colombia",326,5,6,3,2,1,2
"Germany",326,8,7,5,1,4,1
"Poland",326,8,5,4,3,1,2
"France",327,6,9,6,1,5,1
"Jamaica",327,6,6,4,3,1,2
"Denmark",328,1,9,4,0,4,1
"Senegal",328,1,6,7,3,4,2
"Iran",328,3,7,6,3,3,1
"Belgium",328,3,5,2,1,1,2
"Netherlands",328,4,6,6,2,4,1
"Morocco",328,4,5,3,2,1,2
"Spain",328,5,7,7,2,5,1
"Nigeria",328,5,4,3,2,1,2
"Chile",328,6,7,3,1,2,1
"Portugal",328,6,4,5,3,2,2
"England",328,7,7,3,1,2,1
"Poland",328,7,4,3,2,1,2
"Italy",328,8,9,10,2,8,1
"France",328,8,6,5,3,2,2
"Algeria",329,1,6,5,1,4,1
"Qatar",329,1,5,4,3,1,2
"France",329,2,9,9,0,9,1
"Netherlands",329,2,4,4,4,0,2
"Germany",329,3,7,3,0,3,1
"Argentina",329,3,5,1,0,1,2
"England",329,4,9,11,1,10,1
"Colombia",329,4,6,3,3,0,2
"Portugal",329,5,7,5,2,3,1
"Chile",329,5,6,4,2,2,2
"Belgium",329,6,9,6,0,6,1
"Australia",329,6,6,3,3,0,2
"Spain",329,8,7,4,1,3,1
"Denmark",329,8,6,3,2,1,2
"England",330,2,7,6,3,3,1
"Netherlands",330,2,5,7,5,2,2
"Brazil",330,4,7,8,0,8,1
"Italy",330,4,4,4,4,0,2
"Croatia",330,5,7,4,2,2,1
"Argentina",330,5,5,3,2,1,2
"Switzerland",330,6,7,3,1,2,1
"Uruguay",330,6,4,1,1,0,2
"Mexico",330,7,7,5,1,4,1
"Chile",330,7,6,3,1,2,2
"Chile",331,1,9,5,1,4,1
"Croatia",331,1,6,3,1,2,2
"Argentina",331,2,7,5,1,4,1
"Denmark",331,2,6,4,4,0,2
"Germany",331,3,9,10,4,6,1
"Belgium",331,3,6,8,6,2,2
"England",331,4,7,5,1,4,1
"Netherlands",331,4,6,3,1,2,2
"Portugal",331,6,7,6,0,6,1
"Morocco",331,6,4,5,8,-3,2
"Belgium",332,3,9,7,3,4,1
"Croatia",332,3,6,4,3,1,2
"Wales",332,4,7,5,1,4,1
"Denmark",332,4,4,2,4,-2,2
"France",332,6,9,9,1,8,1
"Costa Rica",332,6,6,7,4,3,2
"Korea Republic",332,7,9,6,2,4,1
"Netherlands",332,7,6,6,2,4,2
"Uruguay",332,8,7,8,4,4,1
"England",332,8,4,7,3,4,2
"Uruguay",333,1,9,8,3,5,1
"Costa Rica",333,1,4,3,5,-2,2
"Chile",333,2,7,6,3,3,1
"England",333,2,6,6,4,2,2
"Italy",333,3,9,10,2,8,1
"Argentina",333,3,6,9,3,6,2
"France",333,4,9,6,1,5,1
"Switzerland",333,4,4,1,1,0,2
"Iran",333,5,7,6,3,3,1
"Germany",333,5,6,5,4,1,2
"Denmark",333,6,9,5,1,4,1
"Belgium",333,6,6,7,2,5,2
"Brazil",333,8,9,7,1,6,1
"United States",333,8,6,5,5,0,2
"Poland",334,1,7,3,0,3,1
"Qatar",334,1,5,6,4,2,2
"United States",334,2,7,6,2,4,1
"Brazil",334,2,4,4,3,1,2
"Germany",334,3,7,5,3,2,1
"Argentina",334,3,6,4,3,1,2
"Portugal",334,4,7,6,3,3,1
"Colombia",334,4,4,4,4,0,2
"France",334,6,9,12,1,11,1
"Denmark",334,6,4,4,5,-1,2
"Belgium",334,7,9,6,2,4,1
"Korea Republic",334,7,6,4,2,2,2
"Brazil",335,2,9,11,0,11,1
"Algeria",335,2,6,3,5,-2,2
"Spain",335,4,9,6,2,4,1
"Korea Republic",335,4,4,1,1,0,2
"Denmark",335,6,7,4,2,2,1
"Argentina",335,6,6,8,3,5,2
"England",335,8,7,3,1,2,1
"Wales",335,8,6,5,3,2,2
"Tunisia",336,1,9,7,2,5,1
"Netherlands",336,1,6,7,6,1,2
"Spain",336,2,9,9,1,8,1
"Mexico",336,2,6,3,3,0,2
"Germany",336,4,9,7,1,6,1
"England",336,4,4,4,4,0,2
"Argentina",336,5,9,7,1,6,1
"Iran",336,5,4,3,4,-1,2
"Belgium",336,6,7,3,1,2,1
"Uruguay",336,6,5,3,1,2,2
"Italy",336,7,9,5,2,3,1
"United States",336,7,4,4,3,1,2
"Japan",336,8,7,3,0,3,1
"Colombia",336,8,4,2,2,0,2
"Netherlands",337,1,7,3,1,2,1
"Algeria",337,1,4,2,2,0,2
"Portugal",337,2,7,10,1,9,1
"Uruguay",337,2,4,5,5,0,2
"France",337,3,9,8,4,4,1
"Japan",337,3,6,6,4,2,2
"Brazil",337,4,9,5,0,5,1
"Denmark",337,4,4,3,3,0,2
"Belgium",337,7,7,5,2,3,1
"Costa Rica",337,7,5,5,3,2,2
"Mexico",337,8,7,4,2,2,1
"England",337,8,6,4,3,1,2
"Qatar",338,1,9,7,1,6,1
"Switzerland",338,1,4,3,2,1,2
"Iran",338,2,9,5,2,3,1
"Argentina",338,2,4,4,3,1,2
"Poland",338,4,7,4,2,2,1
"Denmark",338,4,6,4,2,2,2
"France",338,6,7,5,1,4,1
"Netherlands",338,6,6,4,2,2,2
"Uruguay",339,1,7,5,1,4,1
"Qatar",339,1,4,4,6,-2,2
"Netherlands",339,2,9,6,2,4,1
"United States",339,2,6,5,2,3,2
"Belgium",339,3,7,3,1,2,1
"Chile",339,3,6,2,1,1,2
"France",339,4,9,9,2,7,1
"Colombia",339,4,6,5,5,0,2
"Brazil",339,8,9,7,1,6,1
"Germany",339,8,4,1,2,-1,2
"Uruguay",340,1,7,8,3,5,1
"Senegal",340,1,5,5,3,2,2
"France",340,3,6,6,5,1,1
"Wales",340,3,5,4,1,3,2
"Mexico",340,5,9,3,0,3,1
"Portugal",340,5,6,4,2,2,2
"Argentina",340,6,7,5,2,3,1
"Netherlands",340,6,4,2,3,-1,2
"Belgium",340,8,7,8,1,7,1
"Germany",340,8,4,4,4,0,2
"Argentina",341,2,7,4,0,4,1
"Mexico",341,2,5,2,1,1,2
"Germany",341,8,7,3,1,2,1
"Chile",341,8,5,4,2,2,2
"Germany",342,6,7,4,1,3,1
"Costa Rica",342,6,4,1,2,-1,2
"Uruguay",342,7,7,6,2,4,1
"Belgium",342,7,5,3,2,1,2
"Spain",343,3,9,11,2,9,1
"Morocco",343,3,6,6,6,0,2
"France",343,7,7,6,0,6,1
"Uruguay",343,7,4,3,1,2,2
"Netherlands",343,8,7,4,1,3,1
"Portugal",343,8,6,5,2,3,2
"England",344,3,7,5,1,4,1
"Australia",344,3,4,5,6,-1,2
"Spain",344,5,9,13,4,9,1
"Uruguay",344,5,6,3,3,0,2
"Belgium",344,6,9,9,2,7,1
"Japan",344,6,4,4,6,-2,2
"Italy",344,7,9,6,1,5,1
"Argentina",344,7,6,5,2,3,2
"Denmark",344,8,7,5,2,3,1
"Brazil",344,8,6,7,3,4,2
"Uruguay",345,1,7,7,3,4,1
"Qatar",345,1,6,6,5,1,2
"Chile",345,3,5,5,4,1,1
"Spain",345,3,4,5,4,1,2
"Belgium",345,5,9,11,1,10,1
"Korea Republic",345,5,6,4,6,-2,2
"Iran",345,6,7,5,3,2,1
"Italy",345,6,6,6,5,1,2
"Wales",345,8,7,7,3,4,1
"Argentina",345,8,6,7,3,4,2
"Morocco",346,1,7,4,2,2,1
"United States",346,1,6,6,2,4,2
"Italy",346,3,9,4,0,4,1
"Spain",346,3,4,3,2,1,2
"England",346,4,7,7,5,2,1
"Japan",346,4,6,5,3,2,2
"France",346,6,7,6,4,2,1
"Uruguay",346,6,5,4,3,1,2
"Argentina",346,7,9,9,2,7,1
"Denmark",346,7,6,5,4,1,2
"Poland",347,2,9,4,0,4,1
"England",347,2,6,7,1,6,2
"Portugal",347,3,7,5,2,3,1
"Mexico",347,3,6,7,1,6,2
"Italy",347,5,7,8,4,4,1
"Argentina",347,5,4,4,5,-1,2
"Spain",347,7,7,8,2,6,1
"Japan",347,7,4,3,3,0,2
"Uruguay",348,1,7,9,3,6,1
"Tunisia",348,1,6,5,3,2,2
"Croatia",348,2,7,5,2,3,1
"France",348,2,6,6,5,1,2
"Belgium",348,5,9,4,0,4,1
"Poland",348,5,6,5,1,4,2
"Argentina",348,6,7,8,2,6,1
"Morocco",348,6,6,3,6,-3,2
"Denmark",348,8,9,9,3,6,1
"Spain",348,8,6,7,4,3,2
"England",349,2,9,6,2,4,1
"Poland",349,2,4,4,4,0,2
"France",349,4,9,5,2,3,1
"Korea Republic",349,4,4,4,2,2,2
"Argentina",349,5,5,4,3,1,1
"Costa Rica",349,5,4,2,2,0,2
"Spain",349,6,7,3,1,2,1
"Uruguay",349,6,5,4,2,2,2
"Portugal",349,7,9,13,2,11,1
"Mexico",349,7,6,5,7,-2,2
"Brazil",349,8,7,9,3,6,1
"Italy",349,8,6,5,6,-1,2
"Brazil",350,2,7,6,3,3,1
"Korea Republic",350,2,4,6,6,0,2
"Belgium",350,3,9,4,0,4,1
"Croatia",350,3,4,2,1,1,2
"Uruguay",350,4,9,5,2,3,1
"England",350,4,4,5,4,1,2
"Colombia",350,5,7,6,1,5,1
"Spain",350,5,5,9,2,7,2
"Australia",350,6,7,7,3,4,1
"Poland",350,6,5,4,3,1,2
"France",350,7,9,11,1,10,1
"Switzerland",350,7,4,3,4,-1,2
"Denmark",350,8,9,7,2,5,1
"Argentina",350,8,6,4,3,1,2
"Netherlands",351,2,7,7,2,5,1
"England",351,2,4,5,6,-1,2
"Belgium",351,4,7,6,2,4,1
"Mexico",351,4,6,3,2,1,2
"Brazil",351,7,9,9,1,8,1
"United States",351,7,4,2,4,-2,2
"Portugal",351,8,9,9,2,7,1
"Germany",351,8,6,6,4,2,2
"Poland",352,1,9,6,2,4,1
"Germany",352,1,6,5,3,2,2
"France",352,4,7,4,0,4,1
"Netherlands",352,4,6,7,4,3,2
"Denmark",352,5,7,4,1,3,1
"Brazil",352,5,6,6,3,3,2
"Argentina",352,6,9,8,3,5,1
"Switzerland",352,6,4,4,3,1,2
"Italy",352,8,7,7,2,5,1
"Belgium",352,8,6,4,2,2,2
"Colombia",353,1,9,8,0,8,1
"United States",353,1,4,4,5,-1,2
"Belgium",353,2,7,7,2,5,1
"Netherlands",353,2,6,7,2,5,2
"Italy",353,4,9,10,0,10,1
"Portugal",353,4,4,1,2,-1,2
"Germany",353,6,9,6,2,4,1
"Brazil",353,6,6,8,5,3,2
"Argentina",353,7,7,8,1,7,1
"Croatia",353,7,5,4,2,2,2
"England",353,8,7,4,0,4,1
"Uruguay",353,8,4,3,4,-1,2
"Wales",354,1,5,5,3,2,1
"Qatar",354,1,4,6,5,1,2
"England",354,2,7,3,0,3,1
"Korea Republic",354,2,4,1,1,0,2
"Spain",354,3,7,5,1,4,1
"Iran",354,3,4,3,2,1,2
"Netherlands",354,6,7,4,1,3,1
"Senegal",354,6,5,2,1,1,2
"Portugal",354,7,7,8,2,6,1
"Croatia",354,7,5,2,1,1,2
"France",355,2,7,3,1,2,1
"Japan",355,2,4,5,5,0,2
"Portugal",355,5,9,7,2,5,1
"Croatia",355,5,4,6,4,2,2
"England",355,7,7,7,4,3,1
"Germany",355,7,6,10,5,5,2
"Germany",356,3,7,5,3,2,1
"Belgium",356,3,5,3,1,2,2
"France",356,5,9,9,0,9,1
"Croatia",356,5,4,3,4,-1,2
"Denmark",356,7,7,6,2,4,1
"Argentina",356,7,5,3,1,2,2
"Mexico",356,8,6,4,1,3,1
"Portugal",356,8,5,2,1,1,2
"Germany",357,1,9,11,2,9,1
"Chile",357,1,6,3,4,-1,2
"Mexico",357,2,7,3,1,2,1
"Iran",357,2,4,6,3,3,2
"Belgium",357,3,7,8,1,7,1
"United States",357,3,6,2,3,-1,2
"Croatia",357,4,9,7,2,5,1
"Spain",357,4,6,3,2,1,2
"Portugal",357,5,7,4,2,2,1
"Netherlands",357,5,5,7,5,2,2
"Brazil",357,6,9,4,0,4,1
"Japan",357,6,6,4,3,1,2
"Uruguay",357,7,7,4,1,3,1
"France",357,7,6,5,2,3,2
"England",357,8,9,8,1,7,1
"Italy",357,8,6,5,5,0,2
"Portugal",358,2,7,4,1,3,1
"Netherlands",358,2,6,6,4,2,2
"England",358,3,7,3,1,2,1
"Australia",358,3,6,3,1,2,2
"Mexico",358,5,7,4,2,2,1
"France",358,5,5,5,2,3,2
"Brazil",358,8,7,5,2,3,1
"Wales",358,8,6,6,3,3,2
"Poland",359,1,9,7,4,3,1
"Mexico",359,1,4,6,4,2,2
"Brazil",359,4,7,6,3,3,1
"Wales",359,4,4,2,3,-1,2
"Croatia",359,6,7,5,2,3,1
"Argentina",359,6,4,3,2,1,2
"Italy",359,7,9,5,0,5,1
"England",359,7,6,5,2,3,2
"Germany",360,2,7,4,0,4,1
"France",360,2,6,7,4,3,2
"Spain",360,3,7,3,0,3,1
"Korea Republic",360,3,6,2,1,1,2
"England",360,4,9,7,3,4,1
"Uruguay",360,4,6,6,3,3,2
"Brazil",360,6,7,7,2,5,1
"Croatia",360,6,4,5,5,0,2
"Portugal",360,7,7,7,3,4,1
"Colombia",360,7,4,2,1,1,2
"Italy",360,8,7,5,3,2,1
"Argentina",360,8,6,4,2,2,2
"Uruguay",361,1,7,7,1,6,1
"Qatar",361,1,4,2,3,-1,2
"Portugal",361,2,9,7,1,6,1
"Netherlands",361,2,6,7,2,5,2
"United States",361,3,9,4,1,3,1
"Colombia",361,3,4,2,1,1,2
"Spain",361,4,7,9,3,6,1
"Japan",361,4,5,5,4,1,2
"England",361,5,7,5,1,4,1
"Mexico",361,5,5,3,1,2,2
"Brazil",361,6,7,4,2,2,1
"Senegal",361,6,6,5,4,1,2
"Iran",361,7,9,4,1,3,1
"Switzerland",361,7,4,1,1,0,2
"Belgium",361,8,7,7,2,5,1
"Croatia",361,8,6,6,4,2,2
"Germany",362,1,9,10,1,9,1
"Costa Rica",362,1,4,2,3,-1,2
"Portugal",362,3,9,5,0,5,1
"Uruguay",362,3,6,3,3,0,2
"Argentina",362,4,7,8,3,5,1
"United States",362,4,5,4,3,1,2
"Belgium",362,6,7,5,2,3,1
"Colombia",362,6,6,4,4,0,2
"Denmark",363,7,9,8,3,5,1
"England",363,7,6,2,2,0,2
"Chile",364,3,7,6,2,4,1
"Australia",364,3,4,4,5,-1,2
"Portugal",364,5,7,3,1,2,1
"Colombia",364,5,4,5,3,2,2
"Croatia",364,7,7,4,1,3,1
"Korea Republic",364,7,4,3,1,2,2
"Jamaica",365,1,6,3,2,1,1
"Italy",365,1,5,2,1,1,2
"United States",365,2,7,5,2,3,1
"Netherlands",365,2,5,7,2,5,2
"Belgium",365,3,9,6,1,5,1
"Poland",365,3,6,5,4,1,2
"Portugal",365,5,7,6,1,5,1
"Mexico",365,5,6,3,1,2,2
"Brazil",365,6,9,5,0,5,1
"Germany",365,6,6,8,4,4,2
"England",365,8,7,4,2,2,1
"Croatia",365,8,6,3,1,2,2
"Colombia",366,1,9,8,3,5,1
"Poland",366,1,6,3,2,1,2
"Brazil",366,2,9,6,0,6,1
"Morocco",366,2,6,2,1,1,2
"Belgium",366,4,9,8,1,7,1
"Iran",366,4,4,4,3,1,2
"Italy",366,5,9,6,0,6,1
"Nigeria",366,5,4,2,2,0,2
"Netherlands",367,1,7,8,4,4,1
"Poland",367,1,6,6,4,2,2
"Nigeria",367,3,7,4,2,2,1
"Germany",367,3,6,7,5,2,2
"Chile",367,4,7,7,3,4,1
"France",367,4,6,6,7,-1,2
"Brazil",367,5,9,5,2,3,1
"Denmark",367,5,4,3,2,1,2
"Senegal",367,7,7,4,2,2,1
"Mexico",367,7,5,4,2,2,2
"United States",367,8,6,5,3,2,1
"Portugal",367,8,5,3,2,1,2
"Colombia",368,1,7,4,0,4,1
"Algeria",368,1,4,2,3,-1,2
"England",368,4,9,8,2,6,1
"Morocco",368,4,4,4,6,-2,2
"Germany",368,5,9,4,0,4,1
"Spain",368,5,4,1,1,0,2
"Brazil",368,6,9,8,2,6,1
"Mexico",368,6,4,2,3,-1,2
"France",368,8,7,6,2,4,1
"Italy",368,8,4,2,2,0,2
"Uruguay",369,3,9,3,0,3,1
"England",369,3,6,8,2,6,2
"Argentina",369,4,7,5,3,2,1
"Italy",369,4,3,4,4,0,2
"Colombia",369,7,7,3,0,3,1
"Morocco",369,7,5,4,3,1,2
"Italy",370,1,6,4,3,1,1
"Costa Rica",370,1,5,3,2,1,2
"Argentina",370,4,9,9,4,5,1
"Mexico",370,4,4,6,4,2,2
"France",370,5,7,6,1,5,1
"Senegal",370,5,4,5,6,-1,2
"Brazil",370,7,7,9,4,5,1
"Poland",370,7,6,4,4,0,2
"Switzerland",370,8,9,5,2,3,1
"Germany",370,8,6,7,4,3,2
"Algeria",371,2,7,3,1,2,1
"France",371,2,5,2,1,1,2
"Spain",371,6,9,8,2,6,1
"Chile",371,6,6,6,3,3,2
"Germany",371,8,7,7,3,4,1
"United States",371,8,4,5,5,0,2
"Wales",372,1,9,6,1,5,1
"Mexico",372,1,6,6,2,4,2
"Germany",372,2,7,5,1,4,1
"Japan",372,2,6,3,1,2,2
"Argentina",372,3,6,3,2,1,1
"Italy",372,3,5,3,2,1,2
"Portugal",372,4,9,6,2,4,1
"Colombia",372,4,6,6,1,5,2
"United States",372,7,7,4,0,4,1
"Uruguay",372,7,4,6,3,3,2
"Netherlands",372,8,9,7,2,5,1
"Iran",372,8,6,4,3,1,2
"Poland",373,1,7,4,2,2,1
"Nigeria",373,1,4,4,5,-1,2
"Spain",373,2,7,4,1,3,1
"Mexico",373,2,5,1,0,1,2
"Brazil",373,3,7,4,1,3,1
"Iran",373,3,4,3,3,0,2
"Argentina",373,5,7,8,2,6,1
"Netherlands",373,5,5,6,4,2,2
"Belgium",373,7,7,4,2,2,1
"Italy",373,7,6,7,2,5,2
"Australia",373,8,7,3,0,3,1
"Germany",373,8,5,2,0,2,2
"Italy",374,1,9,5,1,4,1
"Senegal",374,1,4,7,4,3,2
"Brazil",374,2,9,7,1,6,1
"Mexico",374,2,4,1,2,-1,2
"Portugal",374,5,9,7,2,5,1
"Netherlands",374,5,6,5,4,1,2
"Algeria",374,7,9,6,2,4,1
"Germany",374,7,6,5,4,1,2
"France",375,2,7,6,1,5,1
"Wales",375,2,5,4,1,3,2
"Spain",375,3,9,4,1,3,1
"Italy",375,3,4,5,4,1,2
"Portugal",375,4,7,4,1,3,1
"Germany",375,4,6,5,4,1,2
"Korea Republic",375,5,7,4,2,2,1
"Netherlands",375,5,5,6,4,2,2
"Brazil",376,2,7,10,5,5,1
"Iran",376,2,5,4,3,1,2
"England",376,4,7,7,1,6,1
"Netherlands",376,4,5,1,0,1,2
"Italy",376,5,7,6,3,3,1
"Spain",376,5,6,4,3,1,2
"Switzerland",376,6,7,6,4,2,1
"Denmark",376,6,5,6,3,3,2
"Portugal",376,8,7,6,2,4,1
"Colombia",376,8,5,2,1,1,2
"Denmark",377,1,7,5,3,2,1
"Qatar",377,1,6,6,4,2,2
"Japan",377,2,7,5,3,2,1
"Croatia",377,2,3,2,2,0,2
"France",377,3,9,6,1,5,1
"Poland",377,3,4,5,3,2,2
"Brazil",377,4,6,5,1,4,1
"Italy",377,4,5,3,2,1,2
"England",377,5,7,7,5,2,1
"Iran",377,5,5,6,5,1,2
"Uruguay",377,6,7,3,1,2,1
"Portugal",377,6,6,4,2,2,2
"Spain",377,8,6,3,2,1,1
"Nigeria",377,8,5,2,1,1,2
"Netherlands",378,1,7,4,2,2,1
"Qatar",378,1,5,5,4,1,2
"Brazil",378,2,9,8,3,5,1
"Mexico",378,2,4,4,4,0,2
"Spain",378,4,9,10,0,10,1
"Denmark",378,4,6,4,6,-2,2
"Germany",378,5,7,2,0,2,1
"Japan",378,5,6,4,1,3,2
"Switzerland",378,6,7,3,1,2,1
"Uruguay",378,6,6,5,4,1,2
"Germany",379,1,9,3,0,3,1
"Qatar",379,1,6,7,5,2,2
"Argentina",379,4,7,5,2,3,1
"Wales",379,4,6,4,2,2,2
"England",379,7,7,6,0,6,1
"Colombia",379,7,6,4,4,0,2
"Poland",380,1,9,5,1,4,1
"Nigeria",380,1,4,3,3,0,2
"Brazil",380,2,9,10,1,9,1
"Wales",380,2,6,5,7,-2,2
"Belgium",380,3,7,4,1,3,1
"Switzerland",380,3,5,3,2,1,2
"Argentina",380,6,7,5,2,3,1
"Senegal",380,6,4,1,2,-1,2
"Spain",380,8,9,9,2,7,1
"Jamaica",380,8,6,4,4,0,2
"Japan",381,2,6,5,1,4,1
"Brazil",381,2,5,2,1,1,2
"Portugal",381,3,9,6,0,6,1
"Korea Republic",381,3,6,2,4,-2,2
"France",381,4,9,5,0,5,1
"Netherlands",381,4,6,3,2,1,2
"Italy",381,5,7,4,1,3,1
"England",381,5,6,5,3,2,2
"Argentina",381,7,9,8,1,7,1
"Mexico",381,7,6,3,1,2,2
"Belgium",381,8,9,5,0,5,1
"Uruguay",381,8,4,1,1,0,2
"Germany",382,1,9,14,1,13,1
"Qatar",382,1,4,1,3,-2,2
"Mexico",382,3,9,4,0,4,1
"Wales",382,3,6,4,3,1,2
"Belgium",382,5,7,5,2,3,1
"Italy",382,5,6,5,3,2,2
"Argentina",382,6,9,9,2,7,1
"Denmark",382,6,6,8,2,6,2
"Korea Republic",382,8,9,6,1,5,1
"England",382,8,4,5,5,0,2
"France",383,2,9,8,1,7,1
"Wales",383,2,4,4,4,0,2
"Portugal",383,4,7,5,2,3,1
"Uruguay",383,4,5,3,2,1,2
"Belgium",383,5,7,3,0,3,1
"Algeria",383,5,4,1,2,-1,2
"Colombia",384,1,7,4,1,3,1
"Qatar",384,1,6,7,5,2,2
"Argentina",384,2,7,6,1,5,1
"Japan",384,2,6,5,5,0,2
"Portugal",384,3,9,7,1,6,1
"Italy",384,3,6,6,5,1,2
"Mexico",384,4,6,4,3,1,1
"Brazil",384,4,5,4,3,1,2
"Spain",384,8,9,4,0,4,1
"Netherlands",384,8,6,5,4,1,2
"Jamaica",385,1,7,6,2,4,1
"Colombia",385,1,6,8,1,7,2
"Netherlands",385,2,7,6,0,6,1
"Argentina",385,2,4,4,5,-1,2
"Germany",385,3,7,4,1,3,1
"Spain",385,3,6,6,4,2,2
"Mexico",385,4,7,6,1,5,1
"Switzerland",385,4,4,3,3,0,2
"Croatia",385,5,9,9,1,8,1
"Belgium",385,5,6,7,3,4,2
"Denmark",385,8,5,2,1,1,1
"Iran",385,8,4,3,3,0,2
"Uruguay",386,1,9,7,0,7,1
"Qatar",386,1,4,3,5,-2,2
"Australia",386,3,7,4,1,3,1
"United States",386,3,4,2,3,-1,2
"Korea Republic",386,4,6,6,4,2,1
"Mexico",386,4,5,8,5,3,2
"France",386,6,9,11,0,11,1
"Nigeria",386,6,4,2,6,-4,2
"Spain",386,7,9,6,1,5,1
"Algeria",386,7,6,4,4,0,2
"Portugal",387,2,7,9,4,5,1
"Poland",387,2,5,4,2,2,2
"Belgium",387,5,9,10,0,10,1
"Iran",387,5,4,5,7,-2,2
"Spain",387,8,7,6,1,5,1
"Wales",387,8,6,4,6,-2,2
"Qatar",388,1,7,4,1,3,1
"Netherlands",388,1,6,8,3,5,2
"Australia",388,3,6,3,2,1,1
"Denmark",388,3,5,4,2,2,2
"Spain",388,5,6,4,1,3,1
"Italy",388,5,5,3,2,1,2
"Brazil",388,6,7,8,1,7,1
"Croatia",388,6,4,5,6,-1,2
"France",388,7,7,5,1,4,1
"Iran",388,7,5,3,2,1,2
"Uruguay",388,8,7,6,2,4,1
"Portugal",388,8,5,2,1,1,2
"Uruguay",389,1,9,6,0,6,1
"Nigeria",389,1,6,3,2,1,2
"Belgium",389,2,9,8,3,5,1
"Italy",389,2,6,5,4,1,2
"Costa Rica",389,3,7,6,4,2,1
"Netherlands",389,3,6,5,2,3,2
"Spain",389,4,7,7,2,5,1
"Germany",389,4,4,2,5,-3,2
"France",389,6,7,5,1,4,1
"Algeria",389,6,4,3,3,0,2
"Switzerland",389,7,9,7,2,5,1
"Morocco",389,7,4,3,3,0,2
"Argentina",389,8,9,6,1,5,1
"Senegal",389,8,6,3,2,1,2
"Uruguay",390,3,7,6,1,5,1
"Poland",390,3,6,4,3,1,2
"Germany",390,4,5,6,1,5,1
"Senegal",390,4,4,3,6,-3,2
"Belgium",390,5,9,6,1,5,1
"Croatia",390,5,4,3,1,2,2
"Iran",390,7,5,2,0,2,1
"Switzerland",390,7,4,2,2,0,2
"Uruguay",391,1,9,6,0,6,1
"Morocco",391,1,4,5,2,3,2
"Brazil",391,2,7,8,1,7,1
"Italy",391,2,4,5,8,-3,2
"Belgium",391,3,7,7,4,3,1
"Wales",391,3,4,4,5,-1,2
"Poland",391,4,7,5,3,2,1
"Netherlands",391,4,6,9,4,5,2
"England",391,5,9,10,0,10,1
"Costa Rica",391,5,4,3,5,-2,2
"Portugal",391,8,6,4,3,1,1
"Chile",391,8,5,4,2,2,2
"Korea Republic",392,3,7,4,2,2,1
"Mexico",392,3,6,3,2,1,2
"Japan",392,4,6,4,3,1,1
"Netherlands",392,4,5,3,1,2,2
"Spain",392,8,9,6,0,6,1
"Italy",392,8,6,5,5,0,2
"Netherlands",393,1,9,5,0,5,1
"Algeria",393,1,4,3,2,1,2
"Uruguay",393,4,7,4,0,4,1
"Jamaica",393,4,6,4,3,1,2
"Portugal",393,5,7,7,3,4,1
"Australia",393,5,3,4,4,0,2
"Italy",393,6,7,3,1,2,1
"Wales",393,6,5,3,1,2,2
"Tunisia",394,1,7,5,2,3,1
"Netherlands",394,1,6,3,2,1,2
"Brazil",394,5,9,9,1,8,1
"Mexico",394,5,4,4,3,1,2
"Argentina",394,7,7,5,2,3,1
"Germany",394,7,4,7,6,1,2
"Spain",395,2,7,9,3,6,1
"Switzerland",395,2,5,6,4,2,2
"Netherlands",395,3,7,5,2,3,1
"Belgium",395,3,6,3,2,1,2
"Portugal",395,4,9,7,1,6,1
"Uruguay",395,4,6,4,4,0,2
"Mexico",395,5,7,5,1,4,1
"Wales",395,5,4,3,4,-1,2
"England",395,6,9,6,1,5,1
"Korea Republic",395,6,6,8,3,5,2
"Brazil",395,7,7,6,1,5,1
"Denmark",395,7,4,2,2,0,2
"France",395,8,7,3,0,3,1
"Chile",395,8,5,2,1,1,2
"Belgium",396,2,9,8,2,6,1
"Germany",396,2,4,5,7,-2,2
"Spain",396,4,9,8,2,6,1
"Netherlands",396,4,4,3,2,1,2
"Brazil",396,5,9,6,3,3,1
"Tunisia",396,5,6,3,1,2,2
"Argentina",396,6,9,9,0,9,1
"Italy",396,6,6,6,5,1,2
"Portugal",396,7,7,6,3,3,1
"Colombia",396,7,6,5,4,1,2
"Denmark",396,8,7,5,3,2,1
"Australia",396,8,5,2,1,1,2
"Tunisia",397,3,7,9,3,6,1
"Argentina",397,3,5,6,5,1,2
"Korea Republic",397,5,7,4,2,2,1
"Spain",397,5,4,6,5,1,2
"Brazil",397,7,9,9,1,8,1
"Costa Rica",397,7,4,3,7,-4,2
"France",398,2,9,10,2,8,1
"Denmark",398,2,6,7,4,3,2
"Japan",398,3,7,4,1,3,1
"Argentina",398,3,6,3,1,2,2
"Italy",398,4,7,8,3,5,1
"Australia",398,4,6,6,8,-2,2
"Portugal",398,5,9,6,0,6,1
"Poland",398,5,6,3,4,-1,2
"Uruguay",398,6,7,5,3,2,1
"Belgium",398,6,4,5,6,-1,2
"Spain",398,7,9,7,2,5,1
"Netherlands",398,7,4,4,5,-1,2
"Germany",398,8,5,3,2,1,1
"Switzerland",398,8,4,2,2,0,2
"Chile",399,1,7,4,1,3,1
"Qatar",399,1,3,3,3,0,2
"France",399,5,7,5,2,3,1
"Algeria",399,5,4,4,4,0,2
"Portugal",399,7,7,4,0,4,1
"Costa Rica",399,7,4,5,5,0,2
"Poland",400,1,7,3,1,2,1
"Morocco",400,1,5,4,3,1,2
"France",400,4,7,5,1,4,1
"Germany",400,4,4,3,4,-1,2
"Portugal",400,5,7,3,1,2,1
"United States",400,5,4,5,5,0,2
"Belgium",400,6,7,6,4,2,1
"Chile",400,6,4,3,3,0,2
"Tunisia",401,1,7,9,5,4,1
"Colombia",401,1,6,4,3,1,2
"Netherlands",401,2,7,8,5,3,1
"Portugal",401,2,5,6,3,3,2
"Denmark",401,3,5,2,0,2,1
"Australia",401,3,4,2,3,-1,2
"Switzerland",401,4,9,4,1,3,1
"Korea Republic",401,4,6,2,1,1,2
"Spain",401,7,9,10,3,7,1
"Chile",401,7,6,5,6,-1,2
"Croatia",402,1,6,4,2,2,1
"Morocco",402,1,5,3,2,1,2
"Brazil",402,2,9,10,0,10,1
"Poland",402,2,6,8,8,0,2
"Costa Rica",402,3,7,4,2,2,1
"France",402,3,5,3,2,1,2
"Belgium",402,4,7,7,0,7,1
"Australia",402,4,3,3,3,0,2
"Denmark",402,5,9,5,1,4,1
"Algeria",402,5,4,2,2,0,2
"Colombia",402,6,7,5,0,5,1
"Korea Republic",402,6,6,5,3,2,2
"Germany",402,7,7,5,2,3,1
"Nigeria",402,7,4,1,2,-1,2
"Uruguay",403,1,9,7,0,7,1
"Qatar",403,1,6,4,4,0,2
"France",403,3,7,5,3,2,1
"Chile",403,3,4,5,5,0,2
"Brazil",403,5,7,6,0,6,1
"Mexico",403,5,6,4,3,1,2
"Australia",403,6,7,4,1,3,1
"Denmark",403,6,6,5,3,2,2
"Belgium",403,8,7,4,1,3,1
"Italy",403,8,6,3,1,2,2
"Portugal",404,2,7,7,3,4,1
"Iran",404,2,4,4,2,2,2
"Brazil",404,3,7,7,3,4,1
"Denmark",404,3,5,5,4,1,2
"Belgium",404,5,7,5,3,2,1
"Algeria",404,5,5,5,4,1,2
"Netherlands",404,6,7,8,2,6,1
"Argentina",404,6,5,4,3,1,2
"Spain",404,7,9,9,2,7,1
"Uruguay",404,7,6,7,3,4,2
"Qatar",405,1,9,9,2,7,1
"Wales",405,1,4,3,3,0,2
"Denmark",405,3,7,4,2,2,1
"Brazil",405,3,6,7,2,5,2
"Belgium",405,4,7,7,1,6,1
"Uruguay",405,4,4,3,3,0,2
"Netherlands",405,7,9,5,0,5,1
"United States",405,7,6,6,3,3,2
"Spain",406,2,6,6,3,3,1
"Croatia",406,2,5,4,3,1,2
"Belgium",406,4,7,5,2,3,1
"Senegal",406,4,6,3,3,0,2
"Netherlands",406,7,7,6,0,6,1
"Costa Rica",406,7,6,3,3,0,2
"Argentina",407,2,7,4,1,3,1
"Germany",407,2,5,2,0,2,2
"England",407,3,9,7,1,6,1
"Iran",407,3,6,4,2,2,2
"Spain",407,6,7,6,1,5,1
"Mexico",407,6,4,3,4,-1,2
"Portugal",407,8,9,5,1,4,1
"Senegal",407,8,6,4,3,1,2
"Italy",408,1,7,6,3,3,1
"Costa Rica",408,1,6,6,2,4,2
"Switzerland",408,2,7,4,1,3,1
"Korea Republic",408,2,6,4,3,1,2
"Wales",408,3,6,4,3,1,1
"Germany",408,3,5,3,1,2,2
"England",408,4,9,7,1,6,1
"Colombia",408,4,4,3,3,0,2
"Uruguay",408,5,6,5,5,0,1
"Poland",408,5,5,6,3,3,2
"Belgium",408,6,7,6,3,3,1
"Chile",408,6,5,6,5,1,2
"Denmark",408,8,7,5,2,3,1
"Portugal",408,8,6,7,1,6,2
"Germany",409,1,7,3,0,3,1
"Qatar",409,1,6,4,3,1,2
"France",409,3,9,4,0,4,1
"Italy",409,3,4,3,4,-1,2
"Argentina",409,4,7,3,1,2,1
"Croatia",409,4,5,2,1,1,2
"Portugal",409,6,9,5,2,3,1
"Netherlands",409,6,6,8,2,6,2
"Mexico",409,7,7,5,2,3,1
"Brazil",409,7,4,5,4,1,2
"Iran",410,3,9,6,2,4,1
"Argentina",410,3,4,3,3,0,2
"Portugal",410,4,7,5,2,3,1
"Colombia",410,4,6,4,3,1,2
"Belgium",410,6,9,7,1,6,1
"Australia",410,6,4,2,4,-2,2
"Brazil",410,8,6,13,5,8,1
"Denmark",410,8,5,9,4,5,2
"France",411,3,9,9,0,9,1
"Jamaica",411,3,4,1,2,-1,2
"Spain",411,4,7,6,1,5,1
"Denmark",411,4,6,4,5,-1,2
"Brazil",411,8,9,7,1,6,1
"Croatia",411,8,6,4,3,1,2
"Germany",412,1,7,5,0,5,1
"Qatar",412,1,5,4,1,3,2
"Portugal",412,2,9,7,2,5,1
"United States",412,2,6,5,4,1,2
"England",412,3,9,6,0,6,1
"Italy",412,3,4,6,1,5,2
"Argentina",412,5,7,5,2,3,1
"Australia",412,5,4,4,3,1,2
"Spain",412,6,9,7,1,6,1
"Poland",412,6,4,2,3,-1,2
"Spain",413,4,6,4,3,1,1
"Korea Republic",413,4,5,4,3,1,2
"Portugal",413,5,6,5,2,3,1
"Croatia",413,5,5,5,3,2,2
"Germany",414,1,9,6,2,4,1
"Tunisia",414,1,6,4,3,1,2
"Italy",414,4,7,6,2,4,1
"Belgium",414,4,6,5,2,3,2
"Argentina",414,5,7,6,4,2,1
"United States",414,5,4,5,3,2,2
"France",414,6,7,6,1,5,1
"Japan",414,6,6,4,4,0,2
"England",414,7,9,6,2,4,1
"Wales",414,7,4,1,1,0,2
"Portugal",414,8,7,5,3,2,1
"Australia",414,8,6,6,3,3,2
"Germany",415,1,9,5,1,4,1
"Switzerland",415,1,6,7,1,6,2
"Brazil",415,4,7,9,1,8,1
"Australia",415,4,5,2,1,1,2
"Netherlands",415,8,7,4,2,2,1
"England",415,8,5,5,3,2,2
"Italy",416,1,9,7,2,5,1
"Tunisia",416,1,4,2,3,-1,2
"Belgium",416,2,7,4,0,4,1
"Netherlands",416,2,5,2,1,1,2
"Germany",416,3,9,5,1,4,1
"Portugal",416,3,4,5,3,2,2
"Spain",416,7,7,7,2,5,1
"Australia",416,7,4,4,6,-2,2
"Poland",417,1,7,7,3,4,1
"Qatar",417,1,6,6,5,1,2
"Denmark",417,3,7,4,0,4,1
"Belgium",417,3,5,6,0,6,2
"Uruguay",417,8,7,8,2,6,1
"Portugal",417,8,5,3,1,2,2
"Croatia",418,1,7,3,1,2,1
"Costa Rica",418,1,5,4,2,2,2
"Brazil",418,5,9,7,3,4,1
"Algeria",418,5,4,6,4,2,2
"Portugal",418,7,9,9,0,9,1
"Australia",418,7,4,2,5,-3,2
"Belgium",418,8,9,6,1,5,1
"Colombia",418,8,4,4,2,2,2
"Colombia",419,1,7,7,2,5,1
"Qatar",419,1,6,4,4,0,2
"Brazil",419,2,9,5,1,4,1
"Japan",419,2,6,3,2,1,2
"Croatia",419,3,9,7,2,5,1
"Chile",419,3,6,3,1,2,2
"Netherlands",419,4,9,6,2,4,1
"Korea Republic",419,4,6,3,2,1,2
"Mexico",419,5,7,4,2,2,1
"Tunisia",419,5,4,3,5,-2,2
"Spain",419,6,9,11,2,9,1
"Switzerland",419,6,4,8,6,2,2
"Poland",419,8,7,2,0,2,1
"Uruguay",419,8,6,3,2,1,2
"Colombia",420,2,6,4,2,2,1
"France",420,2,5,5,3,2,2
"Germany",420,3,7,6,1,5,1
"Belgium",420,3,5,3,2,1,2
"Spain",420,4,9,8,4,4,1
"Uruguay",420,4,6,7,4,3,2
"Brazil",420,5,9,3,0,3,1
"Croatia",420,5,6,6,4,2,2
"Jamaica",420,6,7,4,2,2,1
"Portugal",420,6,6,4,2,2,2
"Wales",420,7,7,4,0,4,1
"Argentina",420,7,5,7,1,6,2
"England",420,8,7,8,4,4,1
"Netherlands",420,8,4,3,4,-1,2
"Switzerland",421,1,9,10,1,9,1
"Italy",421,1,4,4,6,-2,2
"Germany",421,2,9,6,0,6,1
"Portugal",421,2,6,9,5,4,2
"Argentina",421,3,7,5,3,2,1
"Wales",421,3,4,4,3,1,2
"Spain",421,5,7,5,2,3,1
"Netherlands",421,5,6,4,3,1,2
"Belgium",421,6,7,7,3,4,1
"Uruguay",421,6,6,4,3,1,2
"Denmark",421,8,9,8,3,5,1
"England",421,8,6,7,5,2,2
"Argentina",422,2,7,7,2,5,1
"Poland",422,2,3,5,5,0,2
"Algeria",422,5,7,3,1,2,1
"England",422,5,4,6,4,2,2
"Spain",422,6,7,3,1,2,1
"Australia",422,6,4,3,3,0,2
"Brazil",422,7,7,8,1,7,1
"Netherlands",422,7,4,3,3,0,2
"Germany",423,1,9,9,1,8,1
"Qatar",423,1,6,7,7,0,2
"Japan",423,2,7,4,0,4,1
"Mexico",423,2,4,3,3,0,2
"Belgium",423,3,7,6,3,3,1
"Italy",423,3,6,6,6,0,2
"France",423,4,7,3,1,2,1
"Tunisia",423,4,6,6,2,4,2
"Korea Republic",423,5,9,5,0,5,1
"Croatia",423,5,6,4,1,3,2
"Portugal",423,8,7,5,1,4,1
"Netherlands",423,8,5,5,2,3,2
"Denmark",424,1,7,4,0,4,1
"Qatar",424,1,6,2,2,0,2
"Belgium",424,2,7,11,3,8,1
"Germany",424,2,6,6,4,2,2
"Brazil",424,4,7,9,2,7,1
"Italy",424,4,5,2,1,1,2
"Mexico",424,5,9,10,1,9,1
"Argentina",424,5,6,3,2,1,2
"Colombia",424,6,6,6,3,3,1
"England",424,6,5,4,3,1,2
"Uruguay",424,7,9,6,0,6,1
"United States",424,7,4,4,3,1,2
"Nigeria",425,1,7,5,3,2,1
"Denmark",425,1,4,2,2,0,2
"Iran",425,2,9,6,1,5,1
"United States",425,2,6,2,2,0,2
"Netherlands",425,4,7,6,3,3,1
"Spain",425,4,5,6,1,5,2
"France",425,5,9,4,1,3,1
"Uruguay",425,5,4,3,3,0,2
"Portugal",425,7,9,10,2,8,1
"Algeria",425,7,4,2,4,-2,2
"England",426,2,7,4,1,3,1
"Mexico",426,2,5,3,2,1,2
"France",426,5,9,7,2,5,1
"Wales",426,5,4,3,4,-1,2
"Spain",426,6,7,5,1,4,1
"Italy",426,6,5,7,5,2,2
"Argentina",426,7,9,9,1,8,1
"Netherlands",426,7,6,4,4,0,2
"Croatia",426,8,6,3,1,2,1
"Portugal",426,8,5,3,2,1,2
"Germany",427,1,7,3,0,3,1
"Chile",427,1,6,6,3,3,2
"Spain",427,2,9,7,0,7,1
"Colombia",427,2,6,7,3,4,2
"Uruguay",427,6,7,5,1,4,1
"England",427,6,4,4,2,2,2
"Portugal",427,7,6,8,4,4,1
"Denmark",427,7,5,6,4,2,2
"Belgium",427,8,9,10,3,7,1
"Italy",427,8,6,3,3,0,2
"Denmark",428,1,7,5,2,3,1
"Algeria",428,1,5,4,2,2,2
"Portugal",428,2,7,2,0,2,1
"Switzerland",428,2,4,2,2,0,2
"Spain",428,4,7,5,1,4,1
"Colombia",428,4,5,3,2,1,2
"Brazil",428,5,9,10,0,10,1
"Italy",428,5,6,4,1,3,2
"Belgium",428,7,9,7,2,5,1
"Uruguay",428,7,6,4,3,1,2
"Croatia",428,8,9,6,1,5,1
"Nigeria",428,8,4,2,2,0,2
"Qatar",429,1,7,5,1,4,1
"Colombia",429,1,5,4,1,3,2
"Brazil",429,2,9,9,0,9,1
"Senegal",429,2,6,4,3,1,2
"Spain",429,5,7,7,2,5,1
"Denmark",429,5,4,3,3,0,2
"Argentina",429,6,7,5,1,4,1
"Germany",429,6,6,5,1,4,2
"England",429,7,9,7,0,7,1
"Italy",429,7,4,2,3,-1,2
"Croatia",429,8,7,6,2,4,1
"France",429,8,6,7,3,4,2
"Belgium",430,7,9,6,1,5,1
"Morocco",430,7,4,3,4,-1,2
"Germany",430,8,9,8,2,6,1
"Tunisia",430,8,6,4,5,-1,2
"Qatar",431,1,7,8,4,4,1
"Mexico",431,1,4,3,3,0,2
"Brazil",431,4,9,5,1,4,1
"Netherlands",431,4,6,6,3,3,2
"England",431,5,9,9,2,7,1
"Italy",431,5,6,3,3,0,2
"Argentina",431,6,7,4,1,3,1
"Denmark",431,6,6,7,3,4,2
"Germany",431,7,7,6,3,3,1
"Belgium",431,7,5,2,1,1,2
"Brazil",432,3,9,6,0,6,1
"Italy",432,3,6,8,5,3,2
"France",432,5,9,9,0,9,1
"Switzerland",432,5,4,1,3,-2,2
"Mexico",433,1,9,3,0,3,1
"Poland",433,1,6,4,1,3,2
"Brazil",433,2,7,7,2,5,1
"Italy",433,2,5,4,3,1,2
"Portugal",433,3,9,11,3,8,1
"Uruguay",433,3,6,7,7,0,2
"Belgium",433,5,7,10,0,10,1
"Croatia",433,5,4,2,2,0,2
"Netherlands",433,8,6,9,3,6,1
"England",433,8,5,4,3,1,2
"Germany",434,1,9,6,0,6,1
"Qatar",434,1,6,5,2,3,2
"Spain",434,2,9,5,1,4,1
"Japan",434,2,6,3,2,1,2
"Switzerland",434,3,7,7,4,3,1
"England",434,3,4,4,4,0,2
"Algeria",434,7,7,4,2,2,1
"Denmark",434,7,4,5,5,0,2
"Uruguay",434,8,7,5,1,4,1
"Poland",434,8,6,5,1,4,2
"United States",435,1,9,5,1,4,1
"Denmark",435,1,4,5,5,0,2
"England",435,4,7,5,2,3,1
"Senegal",435,4,4,4,3,1,2
"Poland",435,6,9,4,0,4,1
"Spain",435,6,6,6,2,4,2
"Wales",435,8,7,3,1,2,1
"Croatia",435,8,6,4,2,2,2
"France",436,3,7,8,4,4,1
"Chile",436,3,4,5,5,0,2
"Mexico",436,6,7,4,2,2,1
"Japan",436,6,6,3,2,1,2
"Spain",436,8,7,9,2,7,1
"Uruguay",436,8,6,4,4,0,2
"Switzerland",437,1,7,6,3,3,1
"Qatar",437,1,5,4,2,2,2
"Brazil",437,2,9,10,1,9,1
"Croatia",437,2,6,2,3,-1,2
"Argentina",437,3,9,6,0,6,1
"Costa Rica",437,3,6,3,5,-2,2
"Netherlands",437,4,9,7,0,7,1
"France",437,4,6,6,2,4,2
"England",437,7,7,4,2,2,1
"Australia",437,7,6,4,2,2,2
"Netherlands",438,1,7,5,0,5,1
"Qatar",438,1,4,1,2,-1,2
"France",438,2,7,5,3,2,1
"Colombia",438,2,6,5,4,1,2
"Italy",438,4,7,9,3,6,1
"Brazil",438,4,6,5,4,1,2
"Spain",438,7,7,4,2,2,1
"Germany",438,7,4,2,2,0,2
"Mexico",438,8,7,7,5,2,1
"England",438,8,6,6,3,3,2
"Jamaica",439,1,7,6,1,5,1
"Germany",439,1,5,2,1,1,2
"Brazil",439,3,9,8,3,5,1
"Netherlands",439,3,6,6,3,3,2
"Switzerland",439,4,7,6,1,5,1
"Belgium",439,4,5,6,1,5,2
"Spain",439,6,9,9,0,9,1
"Poland",439,6,6,5,5,0,2
"Portugal",439,7,9,8,3,5,1
"Denmark",439,7,4,3,4,-1,2
"Argentina",439,8,9,7,0,7,1
"Croatia",439,8,6,3,3,0,2
"Qatar",440,1,6,3,3,0,1
"Wales",440,1,5,4,1,3,2
"Brazil",440,2,7,6,1,5,1
"Italy",440,2,5,2,1,1,2
"Denmark",440,3,7,3,1,2,1
"Poland",440,3,4,3,3,0,2
"Netherlands",440,4,7,7,3,4,1
"Argentina",440,4,5,2,1,1,2
"Uruguay",440,5,9,6,2,4,1
"Korea Republic",440,5,6,9,7,2,2
"Spain",440,7,9,7,3,4,1
"Mexico",440,7,6,6,3,3,2
"Portugal",440,8,7,6,1,5,1
"Senegal",440,8,4,6,4,2,2
"Qatar",441,1,7,6,1,5,1
"Colombia",441,1,5,4,2,2,2
"Iran",441,2,9,8,5,3,1
"Portugal",441,2,6,6,2,4,2
"Spain",441,5,9,6,1,5,1
"Wales",441,5,6,5,4,1,2
"Belgium",441,6,7,3,1,2,1
"Korea Republic",441,6,5,3,2,1,2
"France",441,7,7,6,1,5,1
"Netherlands",441,7,6,3,3,0,2
"Qatar",442,1,9,6,1,5,1
"Wales",442,1,4,3,3,0,2
"Nigeria",442,2,7,7,5,2,1
"Spain",442,2,5,3,2,1,2
"Portugal",442,5,9,12,2,10,1
"Uruguay",442,5,6,7,3,4,2
"Brazil",442,6,7,3,1,2,1
"Germany",442,6,5,4,1,3,2
"Belgium",442,7,9,6,0,6,1
"Croatia",442,7,4,1,2,-1,2
"Korea Republic",442,8,6,4,2,2,1
"Netherlands",442,8,5,5,3,2,2
"France",443,2,9,12,2,10,1
"Croatia",443,2,4,6,7,-1,2
"Germany",443,3,6,5,3,2,1
"Spain",443,3,5,5,4,1,2
"Belgium",443,5,9,6,1,5,1
"Australia",443,5,4,2,2,0,2
"Brazil",443,8,7,7,4,3,1
"Iran",443,8,5,6,5,1,2
"Colombia",444,1,7,3,0,3,1
"Wales",444,1,4,3,4,-1,2
"Chile",444,3,7,7,4,3,1
"Netherlands",444,3,6,5,3,2,2
"Portugal",444,4,9,9,2,7,1
"Nigeria",444,4,6,8,6,2,2
"France",444,5,7,5,3,2,1
"Japan",444,5,4,5,4,1,2
"Mexico",444,7,7,7,1,6,1
"Argentina",444,7,6,5,6,-1,2
"England",444,8,9,9,1,8,1
"Italy",444,8,6,3,3,0,2
"Croatia",445,1,7,3,1,2,1
"Wales",445,1,6,6,5,1,2
"Spain",445,2,7,4,1,3,1
"Italy",445,2,4,3,3,0,2
"Brazil",445,5,9,14,2,12,1
"Denmark",445,5,6,5,4,1,2
"Iran",445,6,7,3,0,3,1
"Belgium",445,6,6,8,2,6,2
"France",445,7,7,4,1,3,1
"Uruguay",445,7,4,2,1,1,2
"Algeria",445,8,7,5,1,4,1
"Netherlands",445,8,3,3,3,0,2
"Portugal",446,2,9,8,2,6,1
"Denmark",446,2,6,8,4,4,2
"Spain",446,4,7,7,3,4,1
"Colombia",446,4,6,4,4,0,2
"Switzerland",446,5,7,4,0,4,1
"Belgium",446,5,6,6,5,1,2
"England",446,6,7,7,1,6,1
"Germany",446,6,5,3,2,1,2
"Italy",446,8,7,7,2,5,1
"Costa Rica",446,8,5,4,1,3,2
"Spain",447,4,7,5,2,3,1
"Denmark",447,4,6,5,5,0,2
"France",447,5,9,7,1,6,1
"Italy",447,5,4,2,2,0,2
"England",447,7,7,5,2,3,1
"Uruguay",447,7,6,4,2,2,2
"Portugal",447,8,9,4,0,4,1
"Colombia",447,8,6,2,2,0,2
"Wales",448,1,5,4,2,2,1
"Italy",448,1,4,5,3,2,2
"France",448,2,9,9,1,8,1
"Colombia",448,2,6,7,5,2,2
"Croatia",448,3,7,6,4,2,1
"England",448,3,6,6,2,4,2
"Belgium",448,4,9,5,1,4,1
"Uruguay",448,4,6,4,3,1,2
"Argentina",448,5,9,7,4,3,1
"Mexico",448,5,4,5,3,2,2
"Portugal",448,6,9,10,2,8,1
"Chile",448,6,4,3,3,0,2
"Brazil",448,8,7,4,2,2,1
"Denmark",448,8,5,5,3,2,2
"Croatia",449,1,9,5,1,4,1
"Costa Rica",449,1,4,4,3,1,2
"Nigeria",449,2,9,6,3,3,1
"Switzerland",449,2,4,5,4,1,2
"Spain",449,3,7,6,1,5,1
"Wales",449,3,6,3,3,0,2
"Belgium",449,5,9,8,0,8,1
"Colombia",449,5,6,4,2,2,2
"England",449,6,9,6,3,3,1
"Iran",449,6,6,6,2,4,2
"Mexico",449,7,9,6,2,4,1
"France",449,7,6,9,4,5,2
"Netherlands",449,8,7,10,6,4,1
"Portugal",449,8,5,7,6,1,2
"France",450,2,9,7,1,6,1
"Colombia",450,2,4,6,5,1,2
"England",450,3,6,4,2,2,1
"Mexico",450,3,5,3,2,1,2
"Portugal",450,4,7,5,2,3,1
"Australia",450,4,4,2,3,-1,2
"Belgium",450,8,9,12,4,8,1
"Algeria",450,8,4,2,6,-4,2
"Uruguay",451,1,7,6,2,4,1
"Qatar",451,1,6,5,5,0,2
"Germany",451,4,7,7,3,4,1
"France",451,4,6,8,2,6,2
"Brazil",451,6,7,9,2,7,1
"Denmark",451,6,6,3,5,-2,2
"Argentina",452,2,7,7,3,4,1
"Netherlands",452,2,4,5,5,0,2
"Brazil",452,3,9,5,1,4,1
"Denmark",452,3,6,5,3,2,2
"Germany",452,5,9,7,1,6,1
"Portugal",452,5,6,7,2,5,2
"Algeria",452,8,7,5,2,3,1
"Italy",452,8,5,4,3,1,2
"Qatar",453,1,7,3,0,3,1
"Croatia",453,1,4,4,3,1,2
"Brazil",453,2,7,12,4,8,1
"Denmark",453,2,6,5,5,0,2
"Colombia",453,4,7,3,0,3,1
"Portugal",453,4,5,2,1,1,2
"England",453,5,9,8,1,7,1
"Germany",453,5,6,4,5,-1,2
"Netherlands",453,6,7,7,4,3,1
"Argentina",453,6,5,6,3,3,2
"Italy",453,7,9,7,2,5,1
"Belgium",453,7,4,3,3,0,2
"France",453,8,9,9,1,8,1
"Mexico",453,8,4,2,4,-2,2
"Senegal",454,1,7,7,4,3,1
"Croatia",454,1,4,3,3,0,2
"Denmark",454,2,9,7,3,4,1
"Brazil",454,2,6,10,2,8,2
"France",454,3,9,9,1,8,1
"Italy",454,3,6,5,5,0,2
"Portugal",454,4,7,5,3,2,1
"Colombia",454,4,5,5,4,1,2
"Belgium",454,8,7,7,1,6,1
"Poland",454,8,4,3,5,-2,2
"Denmark",455,1,9,4,0,4,1
"Senegal",455,1,4,4,4,0,2
"England",455,2,9,8,1,7,1
"Tunisia",455,2,4,2,3,-1,2
"Belgium",455,5,7,8,4,4,1
"United States",455,5,5,6,4,2,2
"Argentina",455,6,9,9,2,7,1
"Germany",455,6,6,5,7,-2,2
"Italy",455,7,5,5,4,1,1
"Japan",455,7,4,2,2,0,2
"Nigeria",455,8,7,6,2,4,1
"France",455,8,5,5,1,4,2
"Mexico",456,1,7,8,3,5,1
"Switzerland",456,1,5,6,3,3,2
"Nigeria",456,2,7,6,1,5,1
"Colombia",456,2,4,3,6,-3,2
"Denmark",456,4,9,5,1,4,1
"Poland",456,4,4,1,2,-1,2
"Italy",456,6,7,6,1,5,1
"Brazil",456,6,6,9,3,6,2
"France",456,7,7,5,2,3,1
"Croatia",456,7,5,2,1,1,2
"Portugal",456,8,7,8,5,3,1
"Netherlands",456,8,4,6,5,1,2
"Switzerland",457,1,7,3,1,2,1
"Qatar",457,1,4,3,2,1,2
"Italy",457,4,6,8,2,6,1
"Algeria",457,4,5,2,1,1,2
"Belgium",457,5,9,6,1,5,1
"Iran",457,5,6,4,4,0,2
"France",457,7,7,7,5,2,1
"Croatia",457,7,4,6,4,2,2
"France",458,3,9,9,1,8,1
"Poland",458,3,6,4,5,-1,2
"Denmark",458,4,7,2,0,2,1
"Korea Republic",458,4,6,8,2,6,2
"Brazil",458,5,7,5,1,4,1
"United States",458,5,6,4,2,2,2
"Belgium",458,7,7,9,2,7,1
"Costa Rica",458,7,6,5,7,-2,2
"Algeria",458,8,9,5,2,3,1
"Germany",458,8,4,3,2,1,2
"Germany",459,1,7,7,1,6,1
"Switzerland",459,1,6,5,4,1,2
"Senegal",459,4,7,4,1,3,1
"Belgium",459,4,3,3,3,0,2
"Spain",459,5,9,5,1,4,1
"Colombia",459,5,4,3,4,-1,2
"Brazil",459,6,9,8,0,8,1
"Tunisia",459,6,4,2,1,1,2
"Portugal",459,7,7,5,2,3,1
"Chile",459,7,3,2,2,0,2
"Argentina",460,4,7,3,1,2,1
"Netherlands",460,4,5,5,1,4,2
"Chile",460,5,7,3,1,2,1
"Spain",460,5,6,5,3,2,2
"Belgium",460,6,7,3,1,2,1
"United States",460,6,6,3,1,2,2
"England",460,7,7,7,2,5,1
"Croatia",460,7,6,5,4,1,2
"Switzerland",460,8,6,3,3,0,1
"France",460,8,5,4,1,3,2
"Uruguay",461,1,9,10,1,9,1
"Tunisia",461,1,4,3,4,-1,2
"Portugal",461,2,7,5,2,3,1
"Morocco",461,2,5,6,5,1,2
"France",461,3,7,6,3,3,1
"Colombia",461,3,5,8,4,4,2
"Algeria",461,4,6,2,5,-3,1
"Denmark",461,4,5,7,2,5,2
"Belgium",461,7,9,4,1,3,1
"Iran",461,7,6,5,4,1,2
"Germany",461,8,7,3,0,3,1
"England",461,8,6,4,1,3,2
"Brazil",462,4,9,8,2,6,1
"Japan",462,4,4,4,3,1,2
"Spain",462,5,7,4,2,2,1
"Chile",462,5,5,5,3,2,2
"Italy",462,6,9,8,2,6,1
"Wales",462,6,6,3,3,0,2
"Korea Republic",462,7,7,6,3,3,1
"Croatia",462,7,5,3,2,1,2
"Netherlands",462,8,9,4,1,3,1
"France",462,8,6,3,2,1,2
"Argentina",463,2,6,6,1,5,1
"Wales",463,2,5,2,1,1,2
"Germany",463,3,9,7,2,5,1
"Senegal",463,3,6,5,3,2,2
"Mexico",463,4,7,6,3,3,1
"Chile",463,4,4,5,3,2,2
"Uruguay",463,6,9,6,1,5,1
"Switzerland",463,6,6,5,4,1,2
"Belgium",463,7,9,11,2,9,1
"Italy",463,7,6,5,2,3,2
"Netherlands",463,8,7,3,1,2,1
"Spain",463,8,5,3,1,2,2
"Italy",464,1,9,5,0,5,1
"Poland",464,1,4,7,3,4,2
"Australia",464,4,7,7,2,5,1
"Spain",464,4,3,2,2,0,2
"Brazil",464,5,9,9,0,9,1
"Algeria",464,5,6,4,5,-1,2
"Belgium",464,8,9,6,0,6,1
"Uruguay",464,8,4,3,3,0,2
"Netherlands",465,1,7,3,1,2,1
"Qatar",465,1,5,3,1,2,2
"Italy",465,3,9,10,3,7,1
"Brazil",465,3,6,7,4,3,2
"Belgium",465,4,7,6,3,3,1
"Korea Republic",465,4,5,5,3,2,2
"Switzerland",465,5,7,4,1,3,1
"Colombia",465,5,4,5,5,0,2
"Argentina",465,6,9,7,4,3,1
"Poland",465,6,6,4,3,1,2
"France",465,8,9,7,3,4,1
"Chile",465,8,6,6,4,2,2
"Uruguay",466,1,9,11,3,8,1
"Nigeria",466,1,6,3,3,0,2
"Croatia",466,2,7,5,3,2,1
"Belgium",466,2,5,4,2,2,2
"Denmark",466,5,7,5,2,3,1
"Australia",466,5,4,3,4,-1,2
"Portugal",466,7,7,6,3,3,1
"Netherlands",466,7,6,8,2,6,2
"Argentina",466,8,9,6,2,4,1
"Senegal",466,8,6,3,2,1,2
"Brazil",467,2,7,8,3,5,1
"Algeria",467,2,6,3,2,1,2
"Portugal",467,3,7,7,3,4,1
"Wales",467,3,6,3,2,1,2
"England",467,4,7,5,1,4,1
"Mexico",467,4,6,6,4,2,2
"Argentina",467,6,9,6,2,4,1
"Italy",467,6,6,6,3,3,2
"Korea Republic",467,7,7,5,1,4,1
"Poland",467,7,4,4,5,-1,2
"Germany",467,8,9,6,0,6,1
"Spain",467,8,6,6,2,4,2
"Netherlands",468,1,7,9,5,4,1
"Jamaica",468,1,6,7,6,1,2
"Iran",468,4,7,6,4,2,1
"Mexico",468,4,5,4,3,1,2
"France",468,5,9,9,1,8,1
"Chile",468,5,4,8,5,3,2
"England",468,7,7,8,3,5,1
"Morocco",468,7,4,4,3,1,2
"Belgium",468,8,7,6,1,5,1
"United States",468,8,5,5,2,3,2
"Qatar",469,1,7,3,0,3,1
"Switzerland",469,1,4,2,3,-1,2
"Uruguay",469,4,9,6,2,4,1
"Poland",469,4,6,5,4,1,2
"Italy",469,5,9,6,3,3,1
"England",469,5,6,7,2,5,2
"Netherlands",470,1,9,8,2,6,1
"Switzerland",470,1,6,4,2,2,2
"Italy",470,2,9,8,2,6,1
"Argentina",470,2,6,3,1,2,2
"Mexico",470,3,6,7,5,2,1
"Iran",470,3,5,3,2,1,2
"Belgium",470,4,9,9,1,8,1
"Costa Rica",470,4,4,2,5,-3,2
"Brazil",470,5,7,5,2,3,1
"Germany",470,5,4,3,3,0,2
"Uruguay",470,6,7,4,1,3,1
"Poland",470,6,5,3,1,2,2
"Colombia",470,7,9,3,0,3,1
"England",470,7,6,5,2,3,2
"Denmark",470,8,9,10,2,8,1
"Australia",470,8,4,3,7,-4,2
"Korea Republic",471,3,6,5,3,2,1
"Colombia",471,3,5,2,1,1,2
"Mexico",471,4,9,6,2,4,1
"Argentina",471,4,6,6,3,3,2
"Italy",471,5,9,6,0,6,1
"France",471,5,6,4,2,2,2
"Germany",471,6,7,7,3,4,1
"England",471,6,6,5,2,3,2
"Spain",471,7,7,8,2,6,1
"Switzerland",471,7,6,5,5,0,2
"Uruguay",472,1,9,6,2,4,1
"Poland",472,1,6,4,3,1,2
"Italy",472,3,9,9,1,8,1
"Korea Republic",472,3,4,2,2,0,2
"England",472,4,9,6,2,4,1
"Netherlands",472,4,6,5,2,3,2
"France",472,7,9,6,0,6,1
"Colombia",472,7,4,3,4,-1,2
"Spain",472,8,7,6,2,4,1
"Wales",472,8,4,3,5,-2,2
"Switzerland",473,1,7,4,2,2,1
"Nigeria",473,1,6,5,3,2,2
"Germany",473,2,7,6,2,4,1
"Senegal",473,2,4,3,3,0,2
"France",473,3,9,10,3,7,1
"Mexico",473,3,4,8,5,3,2
"Chile",473,6,7,4,2,2,1
"England",473,6,4,2,2,0,2
"Belgium",473,7,7,5,1,4,1
"Uruguay",473,7,4,3,3,0,2
"Algeria",473,8,9,3,0,3,1
"Japan",473,8,4,3,1,2,2
"Belgium",474,2,9,5,1,4,1
"Italy",474,2,4,4,3,1,2
"Korea Republic",474,5,7,5,2,3,1
"Poland",474,5,4,4,5,-1,2
"Netherlands",474,6,7,5,3,2,1
"Brazil",474,6,6,6,5,1,2
"England",474,7,6,6,4,2,1
"Chile",474,7,5,4,3,1,2
"Germany",475,1,7,7,3,4,1
"Chile",475,1,6,4,3,1,2
"Portugal",475,2,7,5,2,3,1
"Iran",475,2,6,4,2,2,2
"Italy",475,3,7,5,0,5,1
"France",475,3,5,3,2,1,2
"Denmark",475,5,9,9,1,8,1
"Brazil",475,5,6,8,4,4,2
"Netherlands",475,6,9,9,0,9,1
"England",475,6,6,4,3,1,2
"Belgium",475,8,9,6,2,4,1
"Poland",475,8,6,5,3,2,2
"Uruguay",476,1,9,7,3,4,1
"Algeria",476,1,6,6,4,2,2
"Wales",476,3,6,3,1,2,1
"Argentina",476,3,5,3,2,1,2
"France",476,5,7,4,1,3,1
"Iran",476,5,4,4,3,1,2
"Portugal",476,6,7,4,1,3,1
"Denmark",476,6,6,4,4,0,2
"Germany",476,7,6,5,3,2,1
"Switzerland",476,7,5,2,1,1,2
"Brazil",477,2,9,5,1,4,1
"Morocco",477,2,6,2,2,0,2
"England",477,3,7,8,2,6,1
"Uruguay",477,3,4,4,3,1,2
"Colombia",477,4,6,5,1,4,1
"Belgium",477,4,5,4,3,1,2
"Germany",477,5,9,7,3,4,1
"Chile",477,5,4,3,4,-1,2
"Italy",477,7,9,7,1,6,1
"Argentina",477,7,6,4,3,1,2
"Portugal",477,8,9,5,0,5,1
"Iran",477,8,6,4,2,2,2
"Belgium",478,3,9,9,0,9,1
"Croatia",478,3,6,6,4,2,2
"Brazil",478,4,9,7,0,7,1
"Denmark",478,4,4,4,5,-1,2
"Germany",478,8,9,7,1,6,1
"Poland",478,8,6,3,3,0,2
"Poland",479,1,9,5,1,4,1
"Denmark",479,1,6,5,4,1,2
"Argentina",479,2,7,4,0,4,1
"Mexico",479,2,5,2,1,1,2
"Italy",479,3,9,9,1,8,1
"Brazil",479,3,6,6,5,1,2
"England",479,4,7,6,3,3,1
"Switzerland",479,4,3,5,5,0,2
"France",479,5,9,8,0,8,1
"Germany",479,5,6,7,5,2,2
"Belgium",479,7,7,6,2,4,1
"Netherlands",479,7,5,6,3,3,2
"Qatar",480,1,7,5,2,3,1
"Morocco",480,1,6,6,2,4,2
"Belgium",480,2,7,3,0,3,1
"Korea Republic",480,2,6,4,2,2,2
"Netherlands",480,3,9,6,2,4,1
"Argentina",480,3,6,7,2,5,2
"Brazil",480,4,9,7,1,6,1
"Italy",480,4,6,8,5,3,2
"Costa Rica",480,7,7,6,4,2,1
"France",480,7,5,5,2,3,2
"Uruguay",481,1,9,6,2,4,1
"Qatar",481,1,4,4,2,2,2
"Brazil",481,3,7,5,2,3,1
"Italy",481,3,6,4,2,2,2
"Croatia",481,7,7,4,2,2,1
"Portugal",481,7,4,4,2,2,2
"Netherlands",481,8,7,6,3,3,1
"Japan",481,8,6,3,2,1,2
"Qatar",482,1,7,4,1,3,1
"Colombia",482,1,6,9,4,5,2
"England",482,2,9,6,1,5,1
"Denmark",482,2,6,3,1,2,2
"Netherlands",482,5,9,10,1,9,1
"Belgium",482,5,6,4,4,0,2
"Argentina",482,6,7,6,3,3,1
"Germany",482,6,6,6,3,3,2
"Brazil",482,7,7,5,2,3,1
"Wales",482,7,5,2,1,1,2
"France",482,8,9,9,1,8,1
"Japan",482,8,4,1,3,-2,2
"Switzerland",483,1,7,6,1,5,1
"Denmark",483,1,3,3,3,0,2
"Netherlands",483,2,7,4,0,4,1
"Spain",483,2,6,8,7,1,2
"Uruguay",483,3,9,8,2,6,1
"Portugal",483,3,4,3,2,1,2
"Mexico",483,4,9,6,0,6,1
"Argentina",483,4,4,3,1,2,2
"Brazil",483,7,9,7,3,4,1
"Wales",483,7,4,5,3,2,2
"Morocco",484,1,7,4,2,2,1
"Poland",484,1,6,4,2,2,2
"Brazil",484,2,9,8,0,8,1
"Switzerland",484,2,4,2,1,1,2
"France",484,3,9,6,1,5,1
"Nigeria",484,3,4,6,5,1,2
"Portugal",484,4,7,5,2,3,1
"Iran",484,4,4,3,3,0,2
"Japan",484,8,7,6,3,3,1
"Belgium",484,8,6,7,4,3,2
"Belgium",485,2,7,5,2,3,1
"Switzerland",485,2,5,4,2,2,2
"Portugal",485,4,9,11,0,11,1
"Morocco",485,4,4,1,3,-2,2
"England",485,8,7,6,1,5,1
"Korea Republic",485,8,4,2,4,-2,2
"Belgium",486,2,9,8,0,8,1
"Switzerland",486,2,4,3,4,-1,2
"Croatia",486,4,9,5,1,4,1
"Chile",486,4,6,6,2,4,2
"Wales",486,5,7,5,2,3,1
"Mexico",486,5,6,5,2,3,2
"Denmark",486,6,9,8,1,7,1
"Portugal",486,6,6,4,3,1,2
"Argentina",486,8,7,5,1,4,1
"Netherlands",486,8,4,3,4,-1,2
"Croatia",487,1,7,7,2,5,1
"Morocco",487,1,4,3,5,-2,2
"Belgium",487,6,9,5,2,3,1
"Uruguay",487,6,6,6,3,3,2
"England",487,7,9,6,1,5,1
"Iran",487,7,4,4,4,0,2
"Germany",488,1,9,8,2,6,1
"Senegal",488,1,4,4,5,-1,2
"Australia",488,2,9,5,1,4,1
"Belgium",488,2,6,7,2,5,2
"Spain",488,3,9,6,2,4,1
"Uruguay",488,3,4,3,2,1,2
"Netherlands",488,5,7,3,0,3,1
"Argentina",488,5,6,6,2,4,2
"Portugal",488,6,9,8,0,8,1
"Colombia",488,6,6,4,3,1,2
"Brazil",488,7,7,5,1,4,1
"Nigeria",488,7,6,6,4,2,2
"England",489,2,9,4,0,4,1
"Uruguay",489,2,6,4,1,3,2
"Japan",489,3,7,6,1,5,1
"Italy",489,3,5,2,1,1,2
"Chile",489,5,7,4,0,4,1
"Portugal",489,5,4,3,1,2,2
"France",489,6,7,3,1,2,1
"Netherlands",489,6,6,4,2,2,2
"Mexico",489,7,9,6,1,5,1
"Nigeria",489,7,4,1,3,-2,2
"Uruguay",490,1,7,10,5,5,1
"Morocco",490,1,4,3,6,-3,2
"Belgium",490,2,7,11,4,7,1
"Japan",490,2,4,2,4,-2,2
"Chile",490,6,7,3,1,2,1
"England",490,6,5,2,1,1,2
"Netherlands",491,2,7,7,5,2,1
"Morocco",491,2,5,3,2,1,2
"Spain",491,3,9,8,2,6,1
"United States",491,3,6,8,4,4,2
"Italy",491,6,9,7,0,7,1
"France",491,6,4,3,4,-1,2
"Germany",491,7,6,4,2,2,1
"Argentina",491,7,5,4,2,2,2
"Korea Republic",492,2,7,4,2,2,1
"Italy",492,2,6,6,4,2,2
"Croatia",492,4,9,7,1,6,1
"Argentina",492,4,6,3,2,1,2
"Brazil",492,5,6,6,2,4,1
"Senegal",492,5,5,3,2,1,2
"Netherlands",492,6,6,4,4,0,1
"England",492,6,5,5,3,2,2
"Spain",492,7,7,8,3,5,1
"Switzerland",492,7,4,4,5,-1,2
"France",492,8,7,3,0,3,1
"Uruguay",492,8,6,4,2,2,2
"Jamaica",493,1,7,5,2,3,1
"Italy",493,1,6,5,3,2,2
"Brazil",493,4,9,8,0,8,1
"Netherlands",493,4,4,5,5,0,2
"Belgium",493,6,7,8,1,7,1
"Mexico",493,6,6,5,2,3,2
"Spain",494,3,9,5,0,5,1
"Senegal",494,3,6,3,3,0,2
"Netherlands",494,4,7,7,3,4,1
"England",494,4,4,6,6,0,2
"Brazil",494,7,7,7,2,5,1
"Croatia",494,7,5,7,3,4,2
"Belgium",495,2,7,5,3,2,1
"Japan",495,2,4,2,2,0,2
"England",495,3,9,7,1,6,1
"Croatia",495,3,4,3,4,-1,2
"Switzerland",495,4,7,5,2,3,1
"Mexico",495,4,4,2,2,0,2
"Spain",495,6,9,7,0,7,1
"Colombia",495,6,6,6,3,3,2
"Argentina",496,3,9,7,1,6,1
"Mexico",496,3,4,4,6,-2,2
"Brazil",496,4,7,5,1,4,1
"Nigeria",496,4,4,3,4,-1,2
"Algeria",496,5,7,4,0,4,1
"Spain",496,5,5,1,0,1,2
"Colombia",496,6,7,6,3,3,1
"Portugal",496,6,5,6,3,3,2
"England",496,8,9,6,3,3,1
"Switzerland",496,8,6,5,4,1,2
"Colombia",497,1,9,5,0,5,1
"Qatar",497,1,6,6,5,1,2
"Netherlands",497,2,5,3,2,1,1
"Brazil",497,2,4,4,4,0,2
"Belgium",497,4,9,9,2,7,1
"Croatia",497,4,4,3,4,-1,2
"Mexico",497,5,7,4,2,2,1
"England",497,5,6,4,3,1,2
"France",497,6,7,5,1,4,1
"Italy",497,6,5,2,1,1,2
"Argentina",497,7,7,3,1,2,1
"Iran",497,7,6,4,1,3,2
"Japan",497,8,9,6,3,3,1
"Germany",497,8,6,6,1,5,2
"Switzerland",498,1,7,2,0,2,1
"Denmark",498,1,6,3,1,2,2
"Italy",498,2,7,5,2,3,1
"Argentina",498,2,6,10,4,6,2
"Colombia",498,4,6,5,4,1,1
"France",498,4,5,5,1,4,2
"Portugal",498,5,7,3,1,2,1
"Mexico",498,5,6,5,2,3,2
"Belgium",498,8,9,6,0,6,1
"Uruguay",498,8,4,3,4,-1,2
"Netherlands",499,3,7,7,5,2,1
"Poland",499,3,4,6,6,0,2
"France",499,6,7,4,0,4,1
"Chile",499,6,6,3,4,-1,2
"Spain",499,7,9,9,1,8,1
"Colombia",499,7,6,6,5,1,2
"France",500,3,9,9,2,7,1
"Uruguay",500,3,4,4,4,0,2
"England",500,4,7,3,1,2,1
"Chile",500,4,6,4,1,3,2
"Germany",500,6,7,5,3,2,1
"Portugal",500,6,6,6,1,5,2
"Italy",500,7,9,5,1,4,1
"Argentina",500,7,4,3,3,0,2
"Brazil",500,8,7,5,1,4,1
"Netherlands",500,8,4,5,2,3,2
"Germany",501,1,7,8,4,4,1
"Poland",501,1,5,7,6,1,2
"Italy",501,4,7,6,2,4,1
"Australia",501,4,4,6,5,1,2
"Wales",501,7,7,2,0,2,1
"Spain",501,7,6,6,4,2,2
"Portugal",501,8,7,5,1,4,1
"Netherlands",501,8,6,7,3,4,2
"Italy",502,1,9,7,1,6,1
"United States",502,1,6,4,3,1,2
"Germany",502,2,7,7,3,4,1
"Tunisia",502,2,4,3,5,-2,2
"France",502,3,9,6,1,5,1
"Uruguay",502,3,6,5,3,2,2
"Portugal",502,6,9,7,3,4,1
"Colombia",502,6,6,5,2,3,2
"Belgium",502,7,9,7,1,6,1
"Denmark",502,7,6,4,2,2,2
"England",503,2,6,6,4,2,1
"Switzerland",503,2,5,7,4,3,2
"Colombia",503,7,9,6,1,5,1
"Costa Rica",503,7,4,3,3,0,2
"Germany",503,8,9,9,3,6,1
"Spain",503,8,4,4,6,-2,2
"Qatar",504,1,9,5,1,4,1
"Wales",504,1,4,2,3,-1,2
"Senegal",504,4,7,4,1,3,1
"Netherlands",504,4,5,4,3,1,2
"Mexico",504,6,9,6,3,3,1
"Argentina",504,6,4,4,4,0,2
"Germany",504,8,7,7,0,7,1
"Portugal",504,8,5,3,1,2,2
"Mexico",505,1,9,4,1,3,1
"Qatar",505,1,6,3,1,2,2
"Italy",505,2,7,8,5,3,1
"Belgium",505,2,6,4,3,1,2
"Croatia",505,4,9,5,1,4,1
"France",505,4,6,9,2,7,2
"Colombia",505,5,7,4,0,4,1
"Spain",505,5,6,7,2,5,2
"Argentina",505,6,9,10,1,9,1
"Denmark",505,6,4,1,3,-2,2
"Germany",505,7,9,6,1,5,1
"Brazil",505,7,6,2,1,1,2
"Uruguay",506,1,9,7,0,7,1
"Qatar",506,1,4,4,5,-1,2
"Chile",506,2,7,7,5,2,1
"Iran",506,2,6,5,4,1,2
"England",506,3,6,3,6,-3,1
"Netherlands",506,3,5,6,0,6,2
"Brazil",506,4,7,5,3,2,1
"Japan",506,4,6,5,3,2,2
"Germany",506,7,9,5,0,5,1
"Portugal",506,7,6,5,1,4,2
"Mexico",507,1,7,5,2,3,1
"Switzerland",507,1,5,5,4,1,2
"Portugal",507,2,7,4,0,4,1
"Uruguay",507,2,3,2,2,0,2
"Brazil",507,3,9,7,3,4,1
"Korea Republic",507,3,4,5,4,1,2
"Netherlands",507,8,7,3,0,3,1
"Poland",507,8,5,4,2,2,2
"Croatia",508,1,7,5,2,3,1
"Qatar",508,1,4,3,3,0,2
"Mexico",508,2,7,4,0,4,1
"Iran",508,2,5,1,0,1,2
"France",508,3,7,3,1,2,1
"Chile",508,3,6,3,1,2,2
"Germany",508,4,7,7,5,2,1
"Spain",508,4,6,8,4,4,2
"Netherlands",508,6,9,7,4,3,1
"Switzerland",508,6,6,7,6,1,2
"Wales",509,1,7,5,3,2,1
"Jamaica",509,1,6,5,3,2,2
"Switzerland",509,7,7,2,0,2,1
"England",509,7,6,3,1,2,2
"Qatar",510,1,7,7,3,4,1
"Costa Rica",510,1,6,4,5,-1,2
"Uruguay",510,2,9,5,1,4,1
"England",510,2,6,6,3,3,2
"Belgium",510,3,9,6,0,6,1
"United States",510,3,6,4,5,-1,2
"Argentina",510,6,7,7,3,4,1
"Australia",510,6,6,8,5,3,2
"Wales",510,7,9,7,3,4,1
"Brazil",510,7,6,7,5,2,2
"Spain",510,8,7,3,1,2,1
"Italy",510,8,6,5,1,4,2
"Brazil",511,2,9,6,0,6,1
"Switzerland",511,2,4,1,1,0,2
"Italy",511,3,6,4,3,1,1
"Iran",511,3,5,4,3,1,2
"Uruguay",511,4,9,7,0,7,1
"England",511,4,6,3,3,0,2
"Spain",511,6,7,6,2,4,1
"Nigeria",511,6,5,2,1,1,2
"Croatia",511,8,7,5,2,3,1
"Belgium",511,8,6,6,4,2,2
"Denmark",512,1,7,5,0,5,1
"Chile",512,1,6,2,2,0,2
"Switzerland",512,3,6,7,3,4,1
"Nigeria",512,3,5,4,2,2,2
"Poland",512,5,7,3,0,3,1
"Colombia",512,5,4,4,5,-1,2
"France",512,6,9,6,0,6,1
"Croatia",512,6,6,4,3,1,2
"Uruguay",512,7,7,4,1,3,1
"Japan",512,7,5,3,1,2,2
"Brazil",512,8,6,7,2,5,1
"Senegal",512,8,5,3,1,2,2
"Senegal",513,1,7,8,3,5,1
"Germany",513,1,6,3,3,0,2
"Algeria",513,2,7,4,1,3,1
"Italy",513,2,5,5,2,3,2
"Spain",513,3,9,6,0,6,1
"Uruguay",513,3,4,3,5,-2,2
"Switzerland",513,4,7,7,1,6,1
"France",513,4,5,3,2,1,2
"Netherlands",513,6,9,10,5,5,1
"Iran",513,6,4,4,4,0,2
"Colombia",513,7,9,5,1,4,1
"Poland",513,7,4,4,2,2,2
"Mexico",514,1,7,7,2,5,1
"Poland",514,1,5,4,3,1,2
"Uruguay",514,2,7,7,0,7,1
"Spain",514,2,4,2,3,-1,2
"Switzerland",514,4,7,5,1,4,1
"Belgium",514,4,6,5,4,1,2
"Brazil",514,5,6,4,1,3,1
"United States",514,5,5,2,1,1,2
"Denmark",514,6,7,8,3,5,1
"England",514,6,5,3,2,1,2
"Germany",514,8,7,10,1,9,1
"Portugal",514,8,5,4,2,2,2
"Switzerland",515,1,9,5,1,4,1
"Croatia",515,1,6,6,3,3,2
"Netherlands",515,2,9,7,1,6,1
"France",515,2,6,3,2,1,2
"Germany",515,3,9,5,2,3,1
"Brazil",515,3,4,6,4,2,2
"Italy",515,4,7,9,3,6,1
"Argentina",515,4,6,11,5,6,2
"Portugal",515,5,9,7,3,4,1
"Uruguay",515,5,6,5,3,2,2
"Spain",515,6,7,5,1,4,1
"Denmark",515,6,5,3,2,1,2
"Wales",515,7,7,6,3,3,1
"England",515,7,4,5,5,0,2
"Belgium",515,8,9,9,2,7,1
"Colombia",515,8,4,2,2,0,2
"Uruguay",516,3,7,4,1,3,1
"Wales",516,3,6,8,3,5,2
"Germany",516,4,9,10,0,10,1
"Brazil",516,4,6,6,1,5,2
"Switzerland",516,6,7,10,3,7,1
"Colombia",516,6,6,4,4,0,2
"Netherlands",516,8,9,10,2,8,1
"France",516,8,6,9,2,7,2
"Mexico",517,2,6,7,4,3,1
"Switzerland",517,2,5,5,4,1,2
"Netherlands",517,5,7,8,3,5,1
"Brazil",517,5,5,6,2,4,2
"Germany",517,7,7,3,1,2,1
"Portugal",517,7,4,3,3,0,2
"England",517,8,5,3,0,3,1
"United States",517,8,4,2,4,-2,2
"Wales",518,1,7,5,3,2,1
"Mexico",518,1,4,4,5,-1,2
"England",518,2,7,6,2,4,1
"Netherlands",518,2,4,2,2,0,2
"Argentina",518,3,7,3,1,2,1
"Australia",518,3,6,6,3,3,2
"Brazil",518,4,9,12,1,11,1
"Croatia",518,4,6,5,4,1,2
"Japan",518,5,7,6,4,2,1
"Spain",518,5,4,4,3,1,2
"Senegal",518,7,7,3,1,2,1
"Korea Republic",518,7,4,4,3,1,2
"Italy",518,8,7,5,3,2,1
"Belgium",518,8,5,5,2,3,2
"France",519,2,9,6,1,5,1
"Chile",519,2,6,8,5,3,2
"Germany",519,3,9,5,2,3,1
"England",519,3,4,4,3,1,2
"Spain",519,5,7,2,0,2,1
"Japan",519,5,6,5,3,2,2
"Australia",519,6,7,7,5,2,1
"Netherlands",519,6,5,6,4,2,2
"Belgium",520,2,7,8,0,8,1
"Italy",520,2,5,2,1,1,2
"Chile",520,3,6,2,2,0,1
"England",520,3,5,4,2,2,2
"Netherlands",520,4,9,7,0,7,1
"Argentina",520,4,6,5,5,0,2
"Portugal",520,6,9,7,1,6,1
"Algeria",520,6,4,4,4,0,2
"Spain",520,7,9,7,1,6,1
"Uruguay",520,7,4,3,3,0,2
"France",520,8,7,7,2,5,1
"Australia",520,8,6,3,3,0,2
"Mexico",521,2,9,8,3,5,1
"Belgium",521,2,6,4,2,2,2
"France",521,3,7,2,0,2,1
"Korea Republic",521,3,6,3,1,2,2
"Italy",521,4,9,8,2,6,1
"England",521,4,4,4,4,0,2
"Argentina",521,7,7,5,2,3,1
"Denmark",521,7,6,5,3,2,2
"Germany",521,8,9,10,0,10,1
"Brazil",521,8,6,8,2,6,2
"Portugal",522,5,7,4,2,2,1
"Italy",522,5,6,4,1,3,2
"England",522,7,9,7,2,5,1
"Senegal",522,7,6,5,4,1,2
"Mexico",523,1,7,3,0,3,1
"Chile",523,1,5,3,2,1,2
"Brazil",523,2,9,9,1,8,1
"Iran",523,2,6,4,5,-1,2
"Belgium",523,3,7,4,2,2,1
"Denmark",523,3,4,3,2,1,2
"Portugal",523,6,9,5,1,4,1
"Netherlands",523,6,4,3,3,0,2
"France",523,7,7,8,4,4,1
"Germany",523,7,5,6,3,3,2
"Korea Republic",523,8,9,8,3,5,1
"Senegal",523,8,6,3,2,1,2
"Italy",524,2,9,9,2,7,1
"Belgium",524,2,6,6,3,3,2
"Chile",524,3,7,6,0,6,1
"Algeria",524,3,4,3,6,-3,2
"Netherlands",524,4,9,6,1,5,1
"England",524,4,6,8,4,4,2
"Brazil",524,5,9,11,2,9,1
"Senegal",524,5,4,1,1,0,2
"Uruguay",524,7,7,4,2,2,1
"Spain",524,7,6,6,2,4,2
"Belgium",525,3,7,13,3,10,1
"Uruguay",525,3,6,3,6,-3,2
"Portugal",525,4,7,5,1,4,1
"Senegal",525,4,4,2,3,-1,2
"Poland",525,5,9,4,1,3,1
"Mexico",525,5,6,3,2,1,2
"France",525,6,9,7,3,4,1
"Switzerland",525,6,6,6,2,4,2
"Denmark",525,7,7,7,3,4,1
"Brazil",525,7,5,5,3,2,2
"Spain",525,8,7,5,1,4,1
"Croatia",525,8,5,3,2,1,2
"Belgium",526,2,7,4,2,2,1
"Senegal",526,2,6,6,5,1,2
"Italy",526,3,9,7,2,5,1
"Argentina",526,3,6,7,5,2,2
"England",526,5,7,7,3,4,1
"Wales",526,5,4,6,5,1,2
"Portugal",526,7,9,7,1,6,1
"Croatia",526,7,6,6,3,3,2
"Brazil",526,8,9,6,0,6,1
"Japan",526,8,6,4,5,-1,2
"Mexico",527,1,7,6,4,2,1
"Morocco",527,1,5,6,5,1,2
"Belgium",527,3,9,7,0,7,1
"Uruguay",527,3,6,2,2,0,2
"England",527,4,7,9,4,5,1
"Croatia",527,4,6,9,9,0,2
"Brazil",527,8,9,8,1,7,1
"Germany",527,8,6,4,3,1,2
"Italy",528,2,7,5,3,2,1
"Argentina",528,2,4,3,3,0,2
"Brazil",528,5,9,6,0,6,1
"Netherlands",528,5,6,6,3,3,2
"Germany",528,6,7,5,1,4,1
"Senegal",528,6,6,3,2,1,2
"Denmark",528,7,9,11,3,8,1
"England",528,7,4,6,6,0,2
"United States",528,8,9,5,2,3,1
"Morocco",528,8,4,2,2,0,2
"Mexico",529,3,7,7,1,6,1
"Portugal",529,3,5,7,2,5,2
"Switzerland",529,4,7,5,0,5,1
"Germany",529,4,6,5,3,2,2
"Uruguay",529,5,7,3,0,3,1
"Wales",529,5,4,1,2,-1,2
"Argentina",529,6,6,3,3,0,1
"Japan",529,6,5,4,2,2,2
"Spain",529,7,7,4,0,4,1
"Italy",529,7,3,0,0,0,2
"Netherlands",529,8,9,11,1,10,1
"Belgium",529,8,4,3,2,1,2
"Netherlands",530,1,9,5,1,4,1
"Wales",530,1,4,4,2,2,2
"Japan",530,3,6,3,4,-1,1
"Mexico",530,3,5,5,2,3,2
"Uruguay",530,4,7,7,1,6,1
"France",530,4,5,2,1,1,2
"Spain",530,5,9,7,1,6,1
"Colombia",530,5,6,8,5,3,2
"Croatia",530,7,9,11,0,11,1
"Portugal",530,7,6,4,5,-1,2
"Germany",530,8,7,5,1,4,1
"Brazil",530,8,6,6,3,3,2
"Spain",531,2,9,6,2,4,1
"Australia",531,2,4,5,5,0,2
"Argentina",531,3,7,5,1,4,1
"Tunisia",531,3,6,5,2,3,2
"Brazil",531,4,9,7,2,5,1
"Denmark",531,4,6,8,4,4,2
"Poland",531,5,6,2,3,-1,1
"France",531,5,5,4,1,3,2
"Algeria",531,7,7,6,3,3,1
"Belgium",531,7,5,5,4,1,2
"Italy",532,1,9,9,2,7,1
"Chile",532,1,6,4,3,1,2
"Uruguay",532,3,7,5,3,2,1
"Belgium",532,3,4,2,2,0,2
"France",532,6,7,6,3,3,1
"Switzerland",532,6,4,4,4,0,2
"England",532,7,7,5,2,3,1
"Costa Rica",532,7,4,3,4,-1,2
"Colombia",532,8,7,3,1,2,1
"Australia",532,8,6,4,2,2,2
"Netherlands",533,1,9,8,1,7,1
"Qatar",533,1,6,6,2,4,2
"Korea Republic",533,3,7,3,1,2,1
"Spain",533,3,5,4,3,1,2
"Italy",533,5,7,8,3,5,1
"Japan",533,5,6,3,2,1,2
"Uruguay",533,6,7,5,2,3,1
"Portugal",533,6,5,3,1,2,2
"Chile",534,1,7,6,1,5,1
"Croatia",534,1,5,6,2,4,2
"Poland",534,5,6,4,5,-1,1
"Portugal",534,5,5,4,1,3,2
"Poland",535,1,6,4,3,1,1
"Mexico",535,1,5,2,1,1,2
"France",535,2,9,5,0,5,1
"Jamaica",535,2,4,3,4,-1,2
"Italy",535,3,9,7,1,6,1
"Brazil",535,3,4,5,3,2,2
"Netherlands",535,5,7,5,2,3,1
"Australia",535,5,3,3,3,0,2
"Denmark",535,7,7,5,2,3,1
"England",535,7,5,3,2,1,2
"Spain",535,8,9,8,0,8,1
"Colombia",535,8,4,5,4,1,2
"Brazil",536,3,7,2,0,2,1
"Mexico",536,3,4,2,2,0,2
"England",536,5,9,8,3,5,1
"Italy",536,5,4,1,2,-1,2
"Senegal",536,6,7,4,1,3,1
"Denmark",536,6,4,4,4,0,2
"Germany",536,8,7,5,3,2,1
"Belgium",536,8,6,7,6,1,2
"Tunisia",537,1,7,4,1,3,1
"Netherlands",537,1,5,5,3,2,2
"Spain",537,2,7,5,2,3,1
"Senegal",537,2,5,3,2,1,2
"Portugal",537,3,9,8,2,6,1
"Nigeria",537,3,4,2,3,-1,2
"Belgium",537,4,9,7,1,6,1
"Algeria",537,4,4,4,4,0,2
"Brazil",537,5,6,3,2,1,1
"Australia",537,5,5,4,3,1,2
"France",537,6,7,3,0,3,1
"Switzerland",537,6,6,4,3,1,2
"Argentina",537,8,7,4,1,3,1
"Poland",537,8,5,3,2,1,2
"Japan",538,2,7,4,2,2,1
"Portugal",538,2,6,3,2,1,2
"Spain",538,4,7,8,2,6,1
"Uruguay",538,4,5,3,2,1,2
"Netherlands",538,5,7,5,2,3,1
"Argentina",538,5,4,4,5,-1,2
"England",538,7,7,5,3,2,1
"Chile",538,7,4,1,1,0,2
"Croatia",538,8,7,2,0,2,1
"Iran",538,8,4,1,1,0,2
"Denmark",539,1,7,3,0,3,1
"Chile",539,1,6,7,3,4,2
"Brazil",539,3,9,6,0,6,1
"Italy",539,3,6,7,2,5,2
"Wales",539,4,9,5,1,4,1
"Uruguay",539,4,6,3,1,2,2
"Belgium",539,5,9,8,2,6,1
"Senegal",539,5,4,3,4,-1,2
"Netherlands",539,8,7,7,3,4,1
"Argentina",539,8,5,4,1,3,2
"Qatar",540,1,5,1,0,1,1
"Germany",540,1,4,3,2,1,2
"Mexico",540,2,9,6,1,5,1
"Argentina",540,2,4,4,3,1,2
"Portugal",540,3,7,6,2,4,1
"Nigeria",540,3,6,3,4,-1,2
"Italy",540,5,7,3,1,2,1
"Switzerland",540,5,5,2,1,1,2
"Belgium",540,8,7,7,3,4,1
"United States",540,8,4,3,5,-2,2
"Uruguay",541,1,9,7,0,7,1
"Wales",541,1,4,1,4,-3,2
"England",541,2,7,5,1,4,1
"Chile",541,2,6,4,3,1,2
"France",541,4,6,4,3,1,1
"Germany",541,4,5,6,4,2,2
"Brazil",541,6,9,4,0,4,1
"Japan",541,6,6,6,2,4,2
"Belgium",541,8,9,6,1,5,1
"Australia",541,8,4,4,3,1,2
"Croatia",542,1,7,3,0,3,1
"Qatar",542,1,6,5,2,3,2
"Portugal",542,2,7,3,1,2,1
"Algeria",542,2,4,2,1,1,2
"Brazil",542,3,9,8,0,8,1
"Netherlands",542,3,6,7,4,3,2
"Spain",542,5,9,8,3,5,1
"Australia",542,5,6,6,4,2,2
"Wales",542,6,5,4,3,1,1
"Argentina",542,6,4,6,4,2,2
"Croatia",543,2,7,6,2,4,1
"Argentina",543,2,4,4,3,1,2
"Switzerland",543,3,7,6,3,3,1
"France",543,3,6,7,3,4,2
"Portugal",543,4,9,6,0,6,1
"Colombia",543,4,6,2,1,1,2
"Germany",543,5,7,6,2,4,1
"Brazil",543,5,6,7,5,2,2
"England",543,6,7,6,1,5,1
"Denmark",543,6,6,4,3,1,2
"Italy",543,7,7,8,3,5,1
"Belgium",543,7,4,5,3,2,2
"Spain",543,8,7,4,0,4,1
"Mexico",543,8,5,1,0,1,2
"Qatar",544,1,7,5,2,3,1
"Costa Rica",544,1,4,1,1,0,2
"Algeria",544,3,7,3,1,2,1
"Denmark",544,3,6,5,2,3,2
"Netherlands",544,5,7,4,2,2,1
"Brazil",544,5,4,5,4,1,2
"Portugal",544,6,7,7,1,6,1
"Uruguay",544,6,6,3,1,2,2
"Colombia",544,7,7,7,2,5,1
"Wales",544,7,6,5,6,-1,2
"Netherlands",545,1,7,6,3,3,1
"Chile",545,1,5,4,3,1,2
"Spain",545,2,9,5,1,4,1
"Croatia",545,2,6,5,1,4,2
"Belgium",545,3,9,5,0,5,1
"Wales",545,3,4,4,4,0,2
"England",545,4,9,6,1,5,1
"Denmark",545,4,6,7,1,6,2
"Argentina",545,5,7,6,2,4,1
"Italy",545,5,6,4,3,1,2
"Brazil",545,7,6,4,1,3,1
"Senegal",545,7,5,2,1,1,2
"Japan",545,8,9,5,1,4,1
"Uruguay",545,8,6,5,2,3,2
"Qatar",546,1,7,5,0,5,1
"Costa Rica",546,1,4,3,4,-1,2
"France",546,3,9,10,1,9,1
"Germany",546,3,6,7,5,2,2
"Poland",546,5,9,8,2,6,1
"Brazil",546,5,6,5,3,2,2
"England",546,6,7,8,4,4,1
"Croatia",546,6,5,2,1,1,2
"Portugal",546,8,7,9,4,5,1
"Denmark",546,8,6,6,4,2,2
"Australia",547,2,7,6,3,3,1
"Chile",547,2,6,6,5,1,2
"Brazil",547,3,9,11,2,9,1
"Morocco",547,3,6,3,5,-2,2
"Germany",547,4,7,4,2,2,1
"Argentina",547,4,6,7,2,5,2
"Portugal",547,6,9,6,3,3,1
"Iran",547,6,6,5,2,3,2
"Netherlands",547,7,7,6,1,5,1
"Belgium",547,7,5,7,3,4,2
"Spain",547,8,9,10,2,8,1
"Korea Republic",547,8,4,3,4,-1,2
"Qatar",548,1,7,6,2,4,1
"Uruguay",548,1,4,2,3,-1,2
"Japan",548,2,7,5,3,2,1
"Brazil",548,2,6,4,1,3,2
"Italy",548,4,9,8,1,7,1
"Portugal",548,4,6,6,4,2,2
"England",548,5,9,8,1,7,1
"Mexico",548,5,6,7,5,2,2
"Spain",548,6,7,3,1,2,1
"Korea Republic",548,6,4,4,4,0,2
"Denmark",548,8,9,5,0,5,1
"Chile",548,8,4,3,4,-1,2
"Argentina",549,2,7,8,2,6,1
"United States",549,2,4,3,5,-2,2
"France",549,3,9,10,0,10,1
"Tunisia",549,3,4,2,6,-4,2
"Brazil",549,4,7,4,1,3,1
"Senegal",549,4,5,4,3,1,2
"Spain",549,5,7,5,2,3,1
"Morocco",549,5,6,3,2,1,2
"Poland",550,1,9,7,1,6,1
"Netherlands",550,1,6,6,2,4,2
"Italy",550,2,6,4,1,3,1
"Algeria",550,2,5,4,3,1,2
"Spain",550,3,7,4,1,3,1
"Wales",550,3,4,3,4,-1,2
"Belgium",550,5,9,8,2,6,1
"Denmark",550,5,4,4,3,1,2
"Brazil",550,6,7,10,1,9,1
"Korea Republic",550,6,4,2,6,-4,2
"Portugal",550,7,7,7,2,5,1
"Mexico",550,7,6,8,2,6,2
"France",550,8,7,6,2,4,1
"Nigeria",550,8,4,4,6,-2,2
"Portugal",551,3,7,8,2,6,1
"Uruguay",551,3,4,4,4,0,2
"Brazil",551,5,7,9,2,7,1
"Denmark",551,5,6,6,3,3,2
"Japan",551,7,7,5,2,3,1
"Italy",551,7,6,5,3,2,2
"Spain",552,2,9,8,1,7,1
"Chile",552,2,4,4,4,0,2
"Mexico",552,3,9,7,1,6,1
"Iran",552,3,6,3,1,2,2
"Germany",552,5,7,7,1,6,1
"Brazil",552,5,4,4,6,-2,2
"France",552,6,9,6,3,3,1
"Japan",552,6,6,7,4,3,2
"Belgium",552,7,9,6,1,5,1
"Netherlands",552,7,4,5,4,1,2
"Italy",552,8,6,2,1,1,1
"Poland",552,8,5,4,3,1,2
"Netherlands",553,2,7,3,1,2,1
"Portugal",553,2,5,3,2,1,2
"Brazil",553,4,9,5,2,3,1
"Croatia",553,4,6,7,2,5,2
"Argentina",553,5,9,4,1,3,1
"Japan",553,5,6,8,6,2,2
"Switzerland",553,6,7,4,1,3,1
"Spain",553,6,5,2,1,1,2
"France",553,8,7,5,3,2,1
"Senegal",553,8,4,3,3,0,2
"Germany",554,1,7,4,1,3,1
"United States",554,1,6,2,2,0,2
"Netherlands",554,2,7,6,3,3,1
"Switzerland",554,2,5,4,2,2,2
"France",554,3,7,6,1,5,1
"Uruguay",554,3,4,2,2,0,2
"Portugal",554,5,7,6,2,4,1
"Mexico",554,5,4,5,5,0,2
"Croatia",554,6,6,4,3,1,1
"Wales",554,6,5,4,2,2,2
"Brazil",554,7,7,6,1,5,1
"Denmark",554,7,4,2,1,1,2
"Belgium",554,8,9,12,3,9,1
"Senegal",554,8,4,4,8,-4,2
"Morocco",555,1,7,5,2,3,1
"Denmark",555,1,6,5,2,3,2
"Japan",555,2,7,6,3,3,1
"Uruguay",555,2,4,3,3,0,2
"Belgium",555,5,9,9,1,8,1
"Colombia",555,5,4,4,5,-1,2
"Costa Rica",555,6,7,6,4,2,1
"France",555,6,6,5,3,2,2
"Italy",555,8,7,7,1,6,1
"Portugal",555,8,5,5,3,2,2
"Switzerland",556,2,7,3,0,3,1
"Belgium",556,2,5,5,2,3,2
"Netherlands",556,4,6,4,4,0,1
"Portugal",556,4,5,4,0,4,2
"England",556,5,9,9,3,6,1
"Japan",556,5,4,4,6,-2,2
"France",556,8,7,6,1,5,1
"Wales",556,8,4,2,5,-3,2
"Netherlands",557,1,9,7,3,4,1
"Qatar",557,1,4,5,5,0,2
"England",557,3,7,6,2,4,1
"Colombia",557,3,5,5,2,3,2
"Korea Republic",557,4,9,12,2,10,1
"Mexico",557,4,4,3,4,-1,2
"Spain",557,6,7,4,1,3,1
"Italy",557,6,5,5,4,1,2
"England",558,2,7,7,2,5,1
"United States",558,2,4,4,4,0,2
"Croatia",558,3,7,2,0,2,1
"Argentina",558,3,5,1,0,1,2
"Korea Republic",558,4,7,4,1,3,1
"Portugal",558,4,4,3,3,0,2
"Brazil",558,5,7,10,4,6,1
"Algeria",558,5,4,2,4,-2,2
"Nigeria",558,6,6,3,2,1,1
"Denmark",558,6,5,2,0,2,2
"France",558,8,6,5,3,2,1
"Wales",558,8,5,3,0,3,2
"Qatar",559,1,9,9,3,6,1
"United States",559,1,6,6,3,3,2
"Belgium",559,2,9,7,1,6,1
"Tunisia",559,2,4,1,2,-1,2
"Wales",559,4,9,7,1,6,1
"Uruguay",559,4,6,2,3,-1,2
"France",559,5,9,6,1,5,1
"Australia",559,5,4,4,1,3,2
"Italy",559,6,9,5,2,3,1
"Jamaica",559,6,4,5,5,0,2
"Netherlands",559,7,9,9,2,7,1
"Iran",559,7,6,4,1,3,2
"Qatar",560,1,6,3,2,1,1
"Colombia",560,1,5,6,4,2,2
"Belgium",560,4,7,5,1,4,1
"Tunisia",560,4,6,5,3,2,2
"Switzerland",560,5,7,3,0,3,1
"England",560,5,4,2,2,0,2
"Argentina",560,7,9,7,1,6,1
"Germany",560,7,4,3,4,-1,2
"Netherlands",560,8,9,10,1,9,1
"Jamaica",560,8,4,2,6,-4,2
"Uruguay",561,1,7,3,1,2,1
"Switzerland",561,1,6,2,1,1,2
"Portugal",561,3,9,5,1,4,1
"Germany",561,3,4,3,3,0,2
"Korea Republic",561,4,7,4,1,3,1
"Mexico",561,4,5,4,1,3,2
"Croatia",561,5,9,5,0,5,1
"Nigeria",561,5,4,2,1,1,2
"Netherlands",561,7,9,7,1,6,1
"Belgium",561,7,6,6,2,4,2
"Italy",561,8,9,6,2,4,1
"France",561,8,6,7,3,4,2
"Argentina",562,3,9,9,2,7,1
"Morocco",562,3,6,3,5,-2,2
"Netherlands",562,4,7,3,1,2,1
"England",562,4,4,3,3,0,2
"Brazil",562,6,9,7,1,6,1
"Italy",562,6,4,4,4,0,2
"Italy",563,1,9,5,0,5,1
"Qatar",563,1,4,1,1,0,2
"Croatia",563,2,7,3,0,3,1
"Japan",563,2,6,4,3,1,2
"Uruguay",563,5,5,4,2,2,1
"Wales",563,5,4,1,2,-1,2
"Portugal",563,6,9,7,0,7,1
"Colombia",563,6,4,3,4,-1,2
"France",563,8,7,4,2,2,1
"Chile",563,8,4,3,3,0,2
"Brazil",564,3,7,4,1,3,1
"Switzerland",564,3,5,2,1,1,2
"Denmark",564,4,7,3,1,2,1
"United States",564,4,4,3,3,0,2
"Senegal",564,5,6,3,2,1,1
"Spain",564,5,5,2,1,1,2
"Belgium",564,6,7,6,1,5,1
"Colombia",564,6,6,2,2,0,2
"Chile",564,7,7,5,0,5,1
"Germany",564,7,4,3,5,-2,2
"Italy",564,8,7,3,0,3,1
"Portugal",564,8,6,5,2,3,2
"Algeria",565,1,5,4,3,1,1
"Croatia",565,1,4,3,3,0,2
"France",565,2,9,4,0,4,1
"Korea Republic",565,2,4,1,1,0,2
"Brazil",565,3,9,5,1,4,1
"Germany",565,3,4,3,3,0,2
"Wales",565,5,7,7,1,6,1
"Colombia",565,5,5,5,2,3,2
"Portugal",565,6,9,6,1,5,1
"Iran",565,6,6,3,3,0,2
"Iran",566,4,6,3,1,2,1
"Poland",566,4,5,2,1,1,2
"Belgium",566,6,7,5,1,4,1
"Colombia",566,6,4,3,2,1,2
"England",566,7,7,10,3,7,1
"Italy",566,7,5,5,2,3,2
"Portugal",566,8,7,3,1,2,1
"Netherlands",566,8,6,5,1,4,2
"Poland",567,1,6,4,2,2,1
"Germany",567,1,5,5,3,2,2
"Italy",567,2,7,5,0,5,1
"Belgium",567,2,4,3,2,1,2
"France",567,3,9,9,2,7,1
"Colombia",567,3,6,4,3,1,2
"England",567,4,7,4,2,2,1
"Denmark",567,4,6,5,3,2,2
"Japan",567,5,7,8,2,6,1
"Uruguay",567,5,6,6,4,2,2
"Argentina",567,6,9,6,0,6,1
"Mexico",567,6,4,3,3,0,2
"Brazil",567,7,7,6,2,4,1
"Netherlands",567,7,5,4,1,3,2
"Chile",567,8,7,5,3,2,1
"Spain",567,8,4,3,3,0,2
"Argentina",568,2,7,3,1,2,1
"Italy",568,2,4,2,1,1,2
"Poland",568,3,5,7,2,5,1
"Uruguay",568,3,4,4,5,-1,2
"Belgium",568,4,9,6,1,5,1
"Japan",568,4,6,3,2,1,2
"Brazil",568,5,9,5,2,3,1
"Korea Republic",568,5,6,3,1,2,2
"Spain",568,6,9,7,2,5,1
"Colombia",568,6,6,5,2,3,2
"Mexico",568,7,7,4,1,3,1
"Portugal",568,7,4,3,4,-1,2
"France",568,8,7,3,1,2,1
"Denmark",568,8,6,6,4,2,2
"Belgium",569,4,9,7,3,4,1
"Uruguay",569,4,6,6,3,3,2
"Portugal",569,5,7,5,3,2,1
"Croatia",569,5,6,4,1,3,2
"Australia",569,6,9,8,3,5,1
"United States",569,6,4,2,2,0,2
"Italy",569,7,9,8,2,6,1
"Argentina",569,7,6,9,2,7,2
"Mexico",570,1,6,6,4,2,1
"Chile",570,1,5,3,1,2,2
"Portugal",570,2,7,6,1,5,1
"Croatia",570,2,6,7,5,2,2
"Argentina",570,4,7,3,1,2,1
"Iran",570,4,6,4,1,3,2
"France",570,6,9,9,2,7,1
"Denmark",570,6,6,5,3,2,2
"Italy",570,7,7,5,3,2,1
"Tunisia",570,7,4,5,5,0,2
"Brazil",570,8,9,5,0,5,1
"Netherlands",570,8,4,5,5,0,2
"Argentina",571,4,7,3,0,3,1
"Netherlands",571,4,6,6,1,5,2
"Brazil",571,6,7,6,3,3,1
"Denmark",571,6,4,4,4,0,2
"Germany",571,7,9,8,4,4,1
"Belgium",571,7,6,5,3,2,2
"Switzerland",572,1,9,6,1,5,1
"Mexico",572,1,6,6,2,4,2
"Korea Republic",572,2,9,4,0,4,1
"Brazil",572,2,6,2,1,1,2
"Belgium",572,3,7,6,2,4,1
"Netherlands",572,3,4,1,1,0,2
"Denmark",572,4,7,3,1,2,1
"Wales",572,4,6,4,3,1,2
"Tunisia",572,6,7,4,1,3,1
"Uruguay",572,6,6,6,4,2,2
"Colombia",572,7,9,8,1,7,1
"Spain",572,7,6,6,3,3,2
"Denmark",573,1,9,5,2,3,1
"Qatar",573,1,4,3,2,1,2
"Germany",573,2,9,9,1,8,1
"Argentina",573,2,4,4,5,-1,2
"Iran",573,3,9,6,2,4,1
"Belgium",573,3,4,3,3,0,2
"Korea Republic",573,4,7,4,2,2,1
"France",573,4,6,5,3,2,2
"Brazil",573,5,7,5,0,5,1
"Poland",573,5,4,5,6,-1,2
"Spain",573,6,9,9,0,9,1
"Tunisia",573,6,6,4,6,-2,2
"Uruguay",573,8,9,7,1,6,1
"Australia",573,8,6,3,1,2,2
"Italy",574,2,9,4,0,4,1
"Argentina",574,2,6,7,2,5,2
"Denmark",574,3,7,4,1,3,1
"Brazil",574,3,6,5,1,4,2
"Switzerland",574,4,9,6,1,5,1
"Spain",574,4,4,4,4,0,2
"Uruguay",574,5,7,5,2,3,1
"Iran",574,5,6,2,2,0,2
"England",574,6,7,3,0,3,1
"Chile",574,6,5,3,1,2,2
"Korea Republic",574,7,9,4,1,3,1
"Germany",574,7,6,6,4,2,2
"France",574,8,7,4,2,2,1
"United States",574,8,4,4,4,0,2
"England",575,2,7,4,1,3,1
"Iran",575,2,5,5,3,2,2
"Spain",575,3,9,6,2,4,1
"Algeria",575,3,4,4,5,-1,2
"Germany",575,5,7,5,1,4,1
"Argentina",575,5,4,4,3,1,2
"Belgium",575,6,7,5,1,4,1
"Uruguay",575,6,6,6,1,5,2
"Mexico",575,7,7,7,3,4,1
"Morocco",575,7,5,5,3,2,2
"France",575,8,9,8,2,6,1
"Colombia",575,8,6,6,3,3,2
"Korea Republic",576,2,7,3,1,2,1
"Brazil",576,2,5,3,1,2,2
"Belgium",576,3,9,4,0,4,1
"Netherlands",576,3,6,5,5,0,2
"Spain",576,5,7,6,3,3,1
"Iran",576,5,6,5,2,3,2
"France",576,7,7,7,2,5,1
"Colombia",576,7,5,6,3,3,2
"Uruguay",577,1,7,6,1,5,1
"Algeria",577,1,4,4,4,0,2
"Croatia",577,2,7,6,2,4,1
"Nigeria",577,2,4,3,5,-2,2
"Colombia",577,6,7,4,2,2,1
"Australia",577,6,5,6,4,2,2
"Italy",577,7,9,6,2,4,1
"Brazil",577,7,6,6,2,4,2
"Brazil",578,2,7,9,2,7,1
"Mexico",578,2,6,4,4,0,2
"Netherlands",578,3,9,7,0,7,1
"Spain",578,3,6,5,5,0,2
"France",578,4,9,10,1,9,1
"Morocco",578,4,4,1,3,-2,2
"Poland",578,5,5,2,1,1,1
"Portugal",578,5,4,4,3,1,2
"Uruguay",578,7,7,8,3,5,1
"England",578,7,5,6,3,3,2
"Argentina",578,8,7,4,1,3,1
"Denmark",578,8,5,4,1,3,2
"England",579,2,9,8,2,6,1
"Nigeria",579,2,6,3,1,2,2
"France",579,3,7,5,1,4,1
"Italy",579,3,5,5,3,2,2
"Belgium",579,5,9,5,0,5,1
"Australia",579,5,4,2,4,-2,2
"Chile",579,6,6,2,2,0,1
"Mexico",579,6,5,4,2,2,2
"Netherlands",579,7,7,5,3,2,1
"Brazil",579,7,4,2,2,0,2
"Morocco",580,2,5,6,4,2,1
"Belgium",580,2,4,5,5,0,2
"Spain",580,3,7,4,1,3,1
"Uruguay",580,3,6,5,3,2,2
"Mexico",580,4,7,7,3,4,1
"Portugal",580,4,4,1,2,-1,2
"France",580,5,7,2,0,2,1
"Croatia",580,5,5,3,0,3,2
"Argentina",580,8,7,9,3,6,1
"Germany",580,8,5,6,3,3,2
"Netherlands",581,1,9,11,1,10,1
"Tunisia",581,1,4,2,7,-5,2
"Brazil",581,4,7,8,1,7,1
"Denmark",581,4,5,5,2,3,2
"Belgium",581,6,9,5,1,4,1
"Italy",581,6,6,3,2,1,2
"Croatia",582,1,7,6,2,4,1
"Qatar",582,1,4,4,3,1,2
"Brazil",582,5,9,6,0,6,1
"Germany",582,5,4,2,2,0,2
"Italy",582,7,7,6,3,3,1
"Belgium",582,7,6,8,4,4,2
"Switzerland",582,8,6,4,1,3,1
"Netherlands",582,8,5,2,1,1,2
"Algeria",583,1,7,5,1,4,1
"Mexico",583,1,6,4,2,2,2
"Croatia",583,2,7,7,1,6,1
"Belgium",583,2,6,6,4,2,2
"Colombia",583,4,7,2,0,2,1
"England",583,4,5,3,2,1,2
"Portugal",583,5,7,6,4,2,1
"Iran",583,5,6,8,6,2,2
"Spain",583,6,7,9,2,7,1
"Uruguay",583,6,5,5,3,2,2
"Argentina",583,7,9,7,2,5,1
"Netherlands",583,7,4,4,5,-1,2
"Brazil",584,2,9,6,0,6,1
"Italy",584,2,6,4,1,3,2
"England",584,3,6,4,1,3,1
"Switzerland",584,3,5,3,2,1,2
"Spain",584,4,7,8,2,6,1
"Germany",584,4,4,4,5,-1,2
"Portugal",584,5,7,5,1,4,1
"Morocco",584,5,5,3,1,2,2
"France",584,6,7,5,2,3,1
"Chile",584,6,5,2,1,1,2
"Netherlands",584,7,7,5,1,4,1
"Australia",584,7,3,2,2,0,2
"Uruguay",584,8,7,5,2,3,1
"Algeria",584,8,6,4,3,1,2
"Germany",585,1,6,4,2,2,1
"Costa Rica",585,1,5,2,0,2,2
"Algeria",585,2,7,4,2,2,1
"Japan",585,2,5,3,2,1,2
"Iran",585,3,9,6,2,4,1
"Brazil",585,3,6,4,2,2,2
"Mexico",585,4,7,3,1,2,1
"Nigeria",585,4,5,3,2,1,2
"Netherlands",585,6,7,7,2,5,1
"France",585,6,5,4,1,3,2
"Senegal",586,1,7,5,2,3,1
"Qatar",586,1,5,4,2,2,2
"Portugal",586,2,7,6,3,3,1
"Colombia",586,2,5,5,4,1,2
"Chile",586,3,7,2,0,2,1
"France",586,3,5,2,0,2,2
"Brazil",586,5,9,6,2,4,1
"Australia",586,5,6,5,2,3,2
"Italy",586,7,7,6,2,4,1
"Spain",586,7,4,7,6,1,2
"Croatia",586,8,9,5,1,4,1
"Poland",586,8,4,3,2,1,2
"Brazil",587,3,7,3,0,3,1
"Denmark",587,3,4,2,2,0,2
"Spain",587,4,9,6,0,6,1
"Australia",587,4,6,6,5,1,2
"Portugal",587,5,7,3,0,3,1
"United States",587,5,4,6,5,1,2
"Italy",587,7,6,3,1,2,1
"Belgium",587,7,5,1,0,1,2
"England",587,8,7,3,1,2,1
"Poland",587,8,6,6,1,5,2
"Italy",588,1,7,4,2,2,1
"Qatar",588,1,4,5,5,0,2
"Japan",588,6,7,6,3,3,1
"Spain",588,6,5,3,1,2,2
"Iran",588,8,7,4,2,2,1
"Tunisia",588,8,4,3,4,-1,2
"Chile",589,3,9,5,1,4,1
"Netherlands",589,3,6,3,2,1,2
"Costa Rica",589,5,9,6,2,4,1
"Denmark",589,5,4,7,7,0,2
"Belgium",589,6,9,5,1,4,1
"Australia",589,6,4,3,3,0,2
"Uruguay",589,8,7,9,3,6,1
"Spain",589,8,4,3,3,0,2
"Belgium",590,2,7,3,0,3,1
"Netherlands",590,2,6,3,1,2,2
"Argentina",590,3,7,9,2,7,1
"Denmark",590,3,5,8,6,2,2
"Portugal",590,4,7,10,3,7,1
"Wales",590,4,6,5,6,-1,2
"Brazil",590,7,9,8,2,6,1
"Senegal",590,7,4,3,3,0,2
"Netherlands",591,3,9,7,1,6,1
"Brazil",591,3,6,5,3,2,2
"Korea Republic",591,4,7,4,1,3,1
"England",591,4,6,4,3,1,2
"Colombia",591,5,9,11,1,10,1
"France",591,5,6,7,5,2,2
"Spain",591,7,9,5,1,4,1
"Denmark",591,7,6,4,2,2,2
"Belgium",591,8,5,6,4,2,1
"Uruguay",591,8,4,5,4,1,2
"Japan",592,2,9,7,2,5,1
"Costa Rica",592,2,4,4,4,0,2
"Brazil",592,3,7,8,3,5,1
"Germany",592,3,5,6,3,3,2
"Uruguay",592,4,7,6,3,3,1
"Belgium",592,4,6,6,3,3,2
"Spain",592,7,7,3,1,2,1
"Poland",592,7,5,5,4,1,2
"Chile",593,1,7,6,3,3,1
"Qatar",593,1,6,5,4,1,2
"Portugal",593,5,7,4,2,2,1
"Colombia",593,5,4,4,5,-1,2
"Belgium",593,6,9,5,2,3,1
"Germany",593,6,6,7,4,3,2
"Brazil",593,7,7,8,4,4,1
"Switzerland",593,7,3,5,5,0,2
"Brazil",594,2,7,6,0,6,1
"Japan",594,2,5,3,2,1,2
"Belgium",594,4,7,5,2,3,1
"Mexico",594,4,5,2,0,2,2
"Senegal",594,5,7,2,0,2,1
"England",594,5,4,4,2,2,2
"Argentina",594,6,9,9,1,8,1
"Poland",594,6,6,5,4,1,2
"Switzerland",594,7,7,6,2,4,1
"Italy",594,7,5,9,6,3,2
"Netherlands",595,1,9,5,0,5,1
"Qatar",595,1,6,2,1,1,2
"Mexico",595,2,7,6,1,5,1
"Argentina",595,2,4,2,2,0,2
"Italy",595,3,9,7,2,5,1
"Wales",595,3,4,4,4,0,2
"Denmark",595,8,7,5,1,4,1
"Belgium",595,8,4,2,2,0,2
"Argentina",596,2,9,8,3,5,1
"Italy",596,2,6,4,2,2,2
"Uruguay",596,4,9,7,0,7,1
"Portugal",596,4,6,3,1,2,2
"Spain",596,5,7,5,2,3,1
"Mexico",596,5,5,3,2,1,2
"Costa Rica",596,6,7,3,1,2,1
"Tunisia",596,6,5,3,2,1,2
"Colombia",596,7,7,4,0,4,1
"Wales",596,7,4,2,2,0,2
"Iran",596,8,9,7,2,5,1
"England",596,8,4,2,3,-1,2
"Qatar",597,1,7,5,2,3,1
"Morocco",597,1,5,4,3,1,2
"Portugal",597,2,9,9,2,7,1
"Uruguay",597,2,4,3,3,0,2
"Netherlands",597,3,7,6,0,6,1
"Belgium",597,3,5,2,0,2,2
"Argentina",597,4,9,8,0,8,1
"Croatia",597,4,4,4,3,1,2
"Qatar",598,1,6,3,3,0,1
"Croatia",598,1,5,4,2,2,2
"Brazil",598,2,7,8,3,5,1
"Switzerland",598,2,4,5,4,1,2
"Belgium",598,3,7,6,2,4,1
"Poland",598,3,4,4,5,-1,2
"Australia",598,7,7,5,1,4,1
"Portugal",598,7,6,4,2,2,2
"Spain",598,8,9,5,1,4,1
"Germany",598,8,6,9,1,8,2
"Spain",599,2,7,6,2,4,1
"Australia",599,2,5,4,1,3,2
"Netherlands",599,4,7,5,1,4,1
"Korea Republic",599,4,5,4,3,1,2
"Italy",599,5,7,8,2,6,1
"Belgium",599,5,5,4,3,1,2
"France",599,7,7,4,1,3,1
"Chile",599,7,4,3,3,0,2
"Qatar",600,1,7,5,1,4,1
"Switzerland",600,1,6,6,3,3,2
"Korea Republic",600,2,7,6,1,5,1
"Belgium",600,2,6,4,5,-1,2
"Italy",600,3,6,3,3,0,1
"Argentina",600,3,5,2,0,2,2
"Brazil",600,4,9,7,0,7,1
"Poland",600,4,4,3,3,0,2
"France",600,5,9,5,0,5,1
"Australia",600,5,6,3,2,1,2
"England",600,7,9,5,1,4,1
"Nigeria",600,7,4,2,3,-1,2
"Portugal",600,8,7,6,2,4,1
"Denmark",600,8,6,7,6,1,2
"Iran",601,3,9,7,2,5,1
"Spain",601,3,6,5,3,2,2
"Algeria",601,5,5,6,2,4,1
"Portugal",601,5,4,3,4,-1,2
"Italy",601,7,7,6,1,5,1
"England",601,7,4,3,3,0,2
"Brazil",601,8,7,8,2,6,1
"Netherlands",601,8,6,4,4,0,2
"Morocco",602,1,9,4,0,4,1
"Netherlands",602,1,6,5,4,1,2
"Portugal",602,2,9,8,3,5,1
"Mexico",602,2,4,3,3,0,2
"Brazil",602,3,9,7,1,6,1
"Tunisia",602,3,4,1,2,-1,2
"Belgium",602,6,9,14,3,11,1
"Colombia",602,6,6,5,2,3,2
"Italy",602,7,7,8,3,5,1
"France",602,7,6,4,4,0,2
"Iran",603,2,7,5,1,4,1
"Mexico",603,2,4,2,1,1,2
"Brazil",603,3,9,5,1,4,1
"Denmark",603,3,6,3,2,1,2
"Belgium",603,4,9,7,2,5,1
"Costa Rica",603,4,4,3,3,0,2
"Argentina",603,5,9,5,2,3,1
"Croatia",603,5,6,3,2,1,2
"France",603,6,9,6,3,3,1
"Uruguay",603,6,6,7,4,3,2
"Italy",603,8,9,8,1,7,1
"Algeria",603,8,4,3,5,-2,2
"Switzerland",604,1,6,3,4,-1,1
"Colombia",604,1,5,7,4,3,2
"France",604,2,7,2,0,2,1
"Japan",604,2,5,4,1,3,2
"Spain",604,4,9,7,1,6,1
"Tunisia",604,4,6,4,3,1,2
"Brazil",605,2,9,7,0,7,1
"Germany",605,2,6,5,3,2,2
"Italy",605,3,7,6,3,3,1
"Senegal",605,3,6,3,2,1,2
"Japan",605,4,7,4,2,2,1
"Belgium",605,4,6,9,4,5,2
"Poland",605,5,6,6,5,1,1
"Portugal",605,5,5,5,3,2,2
"Netherlands",606,1,9,9,1,8,1
"Tunisia",606,1,4,5,8,-3,2
"Portugal",606,7,9,5,1,4,1
"Italy",606,7,6,5,2,3,2
"Japan",606,8,9,9,4,5,1
"Colombia",606,8,4,5,5,0,2
"Qatar",607,1,7,4,2,2,1
"Netherlands",607,1,6,3,2,1,2
"Brazil",607,2,9,4,1,3,1
"Croatia",607,2,6,9,3,6,2
"Uruguay",607,3,9,6,2,4,1
"Belgium",607,3,6,7,4,3,2
"Germany",607,4,7,6,2,4,1
"Argentina",607,4,6,5,2,3,2
"Portugal",607,5,7,4,0,4,1
"Denmark",607,5,5,2,1,1,2
"Japan",607,7,6,3,2,1,1
"England",607,7,5,3,1,2,2
"Spain",607,8,7,3,1,2,1
"Mexico",607,8,3,2,2,0,2
"Netherlands",608,2,7,6,2,4,1
"Brazil",608,2,5,5,1,4,2
"Spain",608,3,9,6,1,5,1
"Nigeria",608,3,6,4,2,2,2
"Italy",608,4,9,5,0,5,1
"Belgium",608,4,6,4,4,0,2
"Uruguay",608,5,9,7,2,5,1
"England",608,5,6,5,3,2,2
"France",608,6,9,3,0,3,1
"Croatia",608,6,6,4,2,2,2
"France",609,2,7,4,2,2,1
"Iran",609,2,4,4,4,0,2
"Germany",609,3,7,5,3,2,1
"England",609,3,6,9,2,7,2
"Brazil",609,4,9,9,2,7,1
"Denmark",609,4,6,7,3,4,2
"Argentina",609,5,7,4,2,2,1
"Japan",609,5,5,3,2,1,2
"Switzerland",609,6,6,5,3,2,1
"Spain",609,6,5,4,3,1,2
"Netherlands",609,8,9,6,1,5,1
"Belgium",609,8,6,7,3,4,2
"Germany",610,1,9,9,1,8,1
"Wales",610,1,6,5,4,1,2
"France",610,3,7,6,1,5,1
"Croatia",610,3,3,1,1,0,2
"Mexico",610,4,9,8,4,4,1
"Brazil",610,4,4,4,2,2,2
"Spain",610,5,9,7,2,5,1
"United States",610,5,6,3,3,0,2
"Poland",610,7,6,5,2,3,1
"Argentina",610,7,5,3,2,1,2
"Colombia",610,8,7,6,2,4,1
"Portugal",610,8,6,8,3,5,2
"Denmark",611,1,7,6,2,4,1
"Qatar",611,1,4,3,4,-1,2
"Iran",611,2,5,2,1,1,1
"England",611,2,4,4,3,1,2
"Brazil",611,6,9,7,1,6,1
"Japan",611,6,6,3,3,0,2
"Mexico",611,7,7,5,0,5,1
"Wales",611,7,4,3,3,0,2
"Portugal",611,8,9,3,0,3,1
"Switzerland",611,8,4,2,2,0,2
"Spain",612,2,9,10,1,9,1
"Germany",612,2,4,5,6,-1,2
"Brazil",612,5,7,5,1,4,1
"Algeria",612,5,5,2,1,1,2
"Korea Republic",612,6,9,3,0,3,1
"Denmark",612,6,4,4,2,2,2
"Belgium",612,8,7,8,3,5,1
"Switzerland",612,8,5,6,5,1,2
"Mexico",613,1,7,4,2,2,1
"Switzerland",613,1,5,5,2,3,2
"Germany",613,2,7,3,1,2,1
"France",613,2,6,5,3,2,2
"Brazil",613,3,7,10,2,8,1
"Netherlands",613,3,4,6,5,1,2
"Belgium",613,4,7,5,1,4,1
"Italy",613,4,6,4,1,3,2
"Argentina",613,5,7,8,2,6,1
"Tunisia",613,5,6,4,3,1,2
"Portugal",613,6,5,2,1,1,1
"Morocco",613,6,4,4,3,1,2
"Spain",613,8,9,8,3,5,1
"Colombia",613,8,6,5,3,2,2
"Australia",614,2,7,3,1,2,1
"Brazil",614,2,5,3,2,1,2
"Belgium",614,3,9,4,1,3,1
"United States",614,3,4,2,2,0,2
"Argentina",614,4,7,3,1,2,1
"Netherlands",614,4,6,8,3,5,2
"Croatia",614,6,7,4,2,2,1
"Poland",614,6,6,5,3,2,2
"Denmark",614,7,7,8,3,5,1
"Switzerland",614,7,5,4,2,2,2
"France",615,3,9,4,0,4,1
"Chile",615,3,4,2,3,-1,2
"Poland",615,4,6,5,5,0,1
"Nigeria",615,4,5,6,3,3,2
"Brazil",615,5,7,3,1,2,1
"Wales",615,5,4,3,3,0,2
"Belgium",615,6,9,6,1,5,1
"Netherlands",615,6,6,7,1,6,2
"Japan",615,7,9,3,0,3,1
"Morocco",615,7,6,2,1,1,2
"Spain",615,8,7,6,1,5,1
"Italy",615,8,5,8,6,2,2
"Italy",616,1,7,5,2,3,1
"Qatar",616,1,5,2,1,1,2
"England",616,3,9,4,1,3,1
"Algeria",616,3,6,5,3,2,2
"Portugal",616,4,9,8,0,8,1
"Denmark",616,4,6,3,2,1,2
"Argentina",616,5,5,1,0,1,1
"Netherlands",616,5,4,4,3,1,2
"Brazil",616,7,7,10,2,8,1
"Poland",616,7,4,3,4,-1,2
"Mexico",617,2,7,4,2,2,1
"Nigeria",617,2,6,6,5,1,2
"Spain",617,4,7,4,0,4,1
"Denmark",617,4,6,4,4,0,2
"France",617,5,9,4,1,3,1
"Uruguay",617,5,4,5,4,1,2
"England",617,6,9,8,0,8,1
"Algeria",617,6,6,4,2,2,2
"Netherlands",617,7,6,5,2,3,1
"Portugal",617,7,5,5,4,1,2
"Germany",618,2,7,3,1,2,1
"Nigeria",618,2,5,4,3,1,2
"Italy",618,4,6,7,2,5,1
"Chile",618,4,5,4,3,1,2
"France",618,5,9,9,1,8,1
"Croatia",618,5,4,5,7,-2,2
"Brazil",618,8,9,5,1,4,1
"Netherlands",618,8,6,7,5,2,2
"Mexico",619,1,7,6,1,5,1
"Switzerland",619,1,6,6,2,4,2
"Australia",619,2,7,3,1,2,1
"Belgium",619,2,6,5,1,4,2
"Spain",619,3,7,8,3,5,1
"Wales",619,3,4,2,3,-1,2
"United States",619,4,9,4,0,4,1
"Iran",619,4,4,1,1,0,2
"Brazil",619,5,9,11,1,10,1
"Denmark",619,5,4,3,5,-2,2
"Senegal",619,6,7,5,2,3,1
"England",619,6,5,2,1,1,2
"Netherlands",619,7,9,6,3,3,1
"Argentina",619,7,6,8,1,7,2
"Korea Republic",619,8,9,5,1,4,1
"France",619,8,6,7,2,5,2
"Italy",620,1,7,6,1,5,1
"Costa Rica",620,1,6,4,4,0,2
"France",620,3,9,8,0,8,1
"Netherlands",620,3,4,4,7,-3,2
"Switzerland",620,4,7,4,1,3,1
"Algeria",620,4,3,0,0,0,2
"Wales",620,6,7,7,3,4,1
"Spain",620,6,4,2,4,-2,2
"Iran",620,8,9,8,2,6,1
"Denmark",620,8,4,4,6,-2,2
"Italy",621,2,7,4,2,2,1
"Spain",621,2,6,7,2,5,2
"Colombia",621,3,7,3,1,2,1
"Poland",621,3,5,2,1,1,2
"Argentina",621,5,9,6,2,4,1
"Mexico",621,5,4,4,3,1,2
"Wales",622,1,7,6,2,4,1
"Germany",622,1,5,3,2,1,2
"England",622,2,9,5,1,4,1
"Korea Republic",622,2,4,2,2,0,2
"France",622,3,7,8,3,5,1
"Mexico",622,3,5,5,4,1,2
"Colombia",622,4,9,7,1,6,1
"Australia",622,4,6,4,3,1,2
"Chile",622,5,9,4,1,3,1
"Belgium",622,5,6,4,3,1,2
"United States",622,6,9,5,0,5,1
"Morocco",622,6,4,2,3,-1,2
"Denmark",622,8,9,5,2,3,1
"Argentina",622,8,6,7,2,5,2
"Germany",623,1,7,7,3,4,1
"Qatar",623,1,4,3,1,2,2
"Denmark",623,2,7,4,0,4,1
"Jamaica",623,2,6,4,4,0,2
"England",623,3,7,7,4,3,1
"Iran",623,3,4,2,6,-4,2
"France",623,4,9,8,1,7,1
"Switzerland",623,4,4,1,4,-3,2
"Tunisia",623,5,7,3,1,2,1
"Argentina",623,5,4,2,2,0,2
"Spain",623,6,9,5,0,5,1
"Mexico",623,6,6,5,1,4,2
"Wales",623,8,9,4,0,4,1
"Portugal",623,8,6,4,2,2,2
"Denmark",624,1,7,6,2,4,1
"Chile",624,1,6,3,3,0,2
"Brazil",624,2,7,6,1,5,1
"Iran",624,2,4,4,6,-2,2
"France",624,3,9,7,2,5,1
"Uruguay",624,3,4,7,3,4,2
"Korea Republic",624,4,9,6,0,6,1
"Wales",624,4,6,4,4,0,2
"England",624,5,7,7,0,7,1
"Australia",624,5,6,4,4,0,2
"Belgium",624,6,7,6,3,3,1
"United States",624,6,4,3,3,0,2
"Netherlands",624,7,9,8,2,6,1
"Spain",624,7,6,7,4,3,2
"Qatar",625,1,9,6,2,4,1
"Poland",625,1,4,3,3,0,2
"Argentina",625,2,7,5,2,3,1
"Italy",625,2,6,5,4,1,2
"England",625,4,7,8,2,6,1
"Wales",625,4,4,6,6,0,2
"Portugal",625,8,7,7,3,4,1
"Croatia",625,8,4,4,5,-1,2
"Germany",626,1,7,3,0,3,1
"Poland",626,1,6,3,3,0,2
"Croatia",626,2,7,4,2,2,1
"Senegal",626,2,6,2,1,1,2
"Belgium",626,4,9,7,2,5,1
"Costa Rica",626,4,4,3,4,-1,2
"Spain",626,6,9,4,1,3,1
"Japan",626,6,4,2,1,1,2
"Denmark",627,1,9,8,2,6,1
"Poland",627,1,4,6,7,-1,2
"Brazil",627,2,7,5,1,4,1
"Iran",627,2,6,4,3,1,2
"Belgium",627,4,9,8,4,4,1
"Uruguay",627,4,6,5,4,1,2
"Italy",627,6,9,8,1,7,1
"Australia",627,6,6,4,2,2,2
"Colombia",628,1,9,9,0,9,1
"Qatar",628,1,6,6,2,4,2
"Australia",628,2,7,5,1,4,1
"Portugal",628,2,5,6,3,3,2
"France",628,3,7,6,1,5,1
"Iran",628,3,4,2,4,-2,2
"Spain",628,4,7,5,2,3,1
"Uruguay",628,4,6,6,3,3,2
"Argentina",628,5,9,6,0,6,1
"Korea Republic",628,5,4,2,2,0,2
"Chile",628,6,7,7,1,6,1
"Jamaica",628,6,6,3,4,-1,2
"Mexico",628,7,9,6,1,5,1
"Belgium",628,7,4,6,3,3,2
"Brazil",628,8,9,8,1,7,1
"Germany",628,8,6,7,4,3,2
"Uruguay",629,1,9,8,1,7,1
"Poland",629,1,6,5,3,2,2
"Italy",629,4,7,4,1,3,1
"Argentina",629,4,6,7,2,5,2
"Wales",629,8,9,7,0,7,1
"Portugal",629,8,4,3,3,0,2
"Croatia",630,3,7,5,2,3,1
"Spain",630,3,5,2,1,1,2
"Brazil",630,4,7,10,2,8,1
"Mexico",630,4,6,3,4,-1,2
"Colombia",630,6,7,7,2,5,1
"England",630,6,4,6,6,0,2
"Belgium",630,8,9,5,1,4,1
"Netherlands",630,8,4,4,3,1,2
"Qatar",631,1,7,3,0,3,1
"Tunisia",631,1,5,1,0,1,2
"Japan",631,2,9,6,1,5,1
"England",631,2,6,6,4,2,2
"Brazil",631,3,9,8,1,7,1
"Croatia",631,3,6,7,5,2,2
"Belgium",631,4,7,4,2,2,1
"Switzerland",631,4,4,2,2,0,2
"Italy",631,5,9,9,2,7,1
"Argentina",631,5,4,5,5,0,2
"Germany",631,6,9,3,0,3,1
"Spain",631,6,6,4,2,2,2
"Netherlands",631,7,9,10,0,10,1
"France",631,7,4,4,6,-2,2
"Portugal",631,8,7,6,3,3,1
"Uruguay",631,8,5,6,4,2,2
"Qatar",632,1,7,6,4,2,1
"Chile",632,1,4,5,4,1,2
"Wales",632,2,7,4,1,3,1
"Argentina",632,2,5,4,1,3,2
"Belgium",632,3,9,7,0,7,1
"United States",632,3,4,4,4,0,2
"Brazil",632,4,9,9,2,7,1
"Germany",632,4,6,5,2,3,2
"Spain",632,5,7,7,1,6,1
"Uruguay",632,5,3,0,0,0,2
"England",632,7,7,8,2,6,1
"Italy",632,7,4,4,3,1,2
"Croatia",633,2,7,7,3,4,1
"Brazil",633,2,5,4,1,3,2
"Portugal",633,3,7,7,4,3,1
"Uruguay",633,3,4,3,2,1,2
"Belgium",633,4,6,4,2,2,1
"Denmark",633,4,5,3,1,2,2
"Colombia",633,8,7,4,2,2,1
"France",633,8,5,5,2,3,2
"Portugal",634,5,7,7,2,5,1
"Japan",634,5,6,6,5,1,2
"Senegal",635,1,7,4,1,3,1
"Jamaica",635,1,4,3,4,-1,2
"Portugal",635,2,9,9,0,9,1
"Italy",635,2,6,4,1,3,2
"Spain",635,4,7,6,2,4,1
"Algeria",635,4,6,2,1,1,2
"Belgium",635,5,9,9,1,8,1
"Japan",635,5,6,7,6,1,2
"Brazil",635,6,5,4,3,1,1
"Australia",635,6,4,4,2,2,2
"France",635,8,7,7,3,4,1
"Switzerland",635,8,5,5,3,2,2
"Italy",636,1,7,6,1,5,1
"Qatar",636,1,6,6,3,3,2
"Iran",636,2,7,5,1,4,1
"Spain",636,2,6,5,2,3,2
"Argentina",636,3,9,5,2,3,1
"Netherlands",636,3,6,7,3,4,2
"Uruguay",636,4,9,10,3,7,1
"Belgium",636,4,6,9,5,4,2
"Senegal",636,5,7,6,4,2,1
"Korea Republic",636,5,5,6,5,1,2
"France",636,7,7,6,2,4,1
"Switzerland",636,7,6,5,3,2,2
"Colombia",636,8,7,5,1,4,1
"Portugal",636,8,6,7,4,3,2
"Argentina",637,4,7,6,2,4,1
"Korea Republic",637,4,4,6,7,-1,2
"Australia",637,5,7,8,5,3,1
"Netherlands",637,5,6,6,4,2,2
"Brazil",637,6,7,6,2,4,1
"Germany",637,6,6,6,4,2,2
"Uruguay",637,7,7,6,2,4,1
"Belgium",637,7,5,4,1,3,2
"Italy",637,8,9,8,1,7,1
"Spain",637,8,6,8,4,4,2
"Uruguay",638,1,7,5,2,3,1
"Morocco",638,1,6,4,3,1,2
"Spain",638,3,6,6,2,4,1
"Mexico",638,3,5,5,4,1,2
"Belgium",638,4,9,8,2,6,1
"Denmark",638,4,4,4,5,-1,2
"Italy",638,7,7,5,2,3,1
"Argentina",638,7,5,2,0,2,2
"Netherlands",639,1,5,3,1,2,1
"Qatar",639,1,4,4,3,1,2
"France",639,2,9,8,2,6,1
"Chile",639,2,6,5,2,3,2
"Belgium",639,3,9,6,2,4,1
"Uruguay",639,3,6,6,3,3,2
"Spain",639,4,9,9,0,9,1
"Jamaica",639,4,4,3,3,0,2
"Colombia",639,5,7,2,0,2,1
"Portugal",639,5,6,6,3,3,2
"Brazil",639,6,7,7,5,2,1
"Denmark",639,6,4,4,4,0,2
"Korea Republic",639,7,7,4,2,2,1
"England",639,7,6,4,1,3,2
"Germany",639,8,6,4,3,1,1
"Wales",639,8,5,1,0,1,2
"Uruguay",640,1,9,7,1,6,1
"Qatar",640,1,6,3,1,2,2
"England",640,4,7,4,2,2,1
"Poland",640,4,5,2,1,1,2
"Netherlands",640,6,7,4,1,3,1
"Brazil",640,6,6,6,5,1,2
"Spain",640,7,9,4,0,4,1
"Mexico",640,7,6,3,2,1,2
"Germany",640,8,9,7,1,6,1
"Portugal",640,8,4,5,4,1,2
"Denmark",641,1,7,6,1,5,1
"Costa Rica",641,1,6,4,5,-1,2
"Italy",641,2,7,2,0,2,1
"Brazil",641,2,6,4,3,1,2
"France",641,3,7,5,3,2,1
"Jamaica",641,3,4,5,4,1,2
"Mexico",641,6,7,4,2,2,1
"Argentina",641,6,5,4,2,2,2
"Spain",641,7,9,8,1,7,1
"United States",641,7,6,4,4,0,2
"Belgium",641,8,7,5,2,3,1
"Switzerland",641,8,6,3,1,2,2
"Switzerland",642,1,7,3,0,3,1
"Croatia",642,1,4,3,2,1,2
"Uruguay",642,3,9,6,0,6,1
"Portugal",642,3,6,7,3,4,2
"Belgium",642,4,7,4,0,4,1
"Senegal",642,4,4,6,2,4,2
"France",642,6,9,7,2,5,1
"Mexico",642,6,6,4,3,1,2
"Argentina",642,8,7,2,0,2,1
"Italy",642,8,5,3,1,2,2
"Netherlands",643,1,9,8,5,3,1
"Chile",643,1,6,7,3,4,2
"France",643,2,7,6,1,5,1
"Colombia",643,2,4,3,5,-2,2
"England",643,3,7,6,2,4,1
"Croatia",643,3,5,3,2,1,2
"Wales",643,4,7,3,1,2,1
"Portugal",643,4,6,3,2,1,2
"Brazil",643,5,9,5,0,5,1
"Mexico",643,5,6,3,3,0,2
"Korea Republic",643,7,6,4,2,2,1
"Belgium",643,7,5,2,0,2,2
"Jamaica",644,1,7,4,1,3,1
"Colombia",644,1,6,5,3,2,2
"Mexico",644,3,7,9,2,7,1
"Poland",644,3,6,4,4,0,2
"Portugal",644,4,9,5,0,5,1
"Uruguay",644,4,4,6,2,4,2
"Australia",645,2,7,4,2,2,1
"United States",645,2,6,4,2,2,2
"England",645,3,7,7,2,5,1
"Jamaica",645,3,6,5,6,-1,2
"Iran",645,6,7,4,1,3,1
"Denmark",645,6,4,4,4,0,2
"Portugal",645,7,9,6,2,4,1
"Wales",645,7,4,2,2,0,2
"Germany",645,8,9,5,1,4,1
"Belgium",645,8,4,4,3,1,2
"Nigeria",646,1,5,5,3,2,1
"Chile",646,1,4,2,3,-1,2
"Germany",646,2,7,4,1,3,1
"Brazil",646,2,6,8,2,6,2
"Portugal",646,3,9,7,1,6,1
"Senegal",646,3,4,5,5,0,2
"Denmark",646,4,7,5,1,4,1
"Morocco",646,4,6,3,4,-1,2
"Netherlands",646,6,9,5,0,5,1
"Switzerland",646,6,6,5,3,2,2
"Italy",646,8,9,7,2,5,1
"France",646,8,6,4,2,2,2
"Mexico",647,1,5,3,2,1,1
"Poland",647,1,4,3,3,0,2
"Italy",647,2,7,5,2,3,1
"Brazil",647,2,4,4,2,2,2
"England",647,4,9,7,1,6,1
"Switzerland",647,4,4,2,5,-3,2
"Argentina",647,5,7,4,1,3,1
"Germany",647,5,6,4,3,1,2
"Croatia",647,7,9,5,2,3,1
"Spain",647,7,6,9,3,6,2
"Belgium",647,8,9,11,1,10,1
"Australia",647,8,6,4,3,1,2
"Denmark",648,1,7,4,1,3,1
"Senegal",648,1,6,5,2,3,2
"Germany",648,2,9,3,0,3,1
"Brazil",648,2,6,8,1,7,2
"Netherlands",648,3,7,5,0,5,1
"Morocco",648,3,4,3,4,-1,2
"Iran",648,7,9,5,0,5,1
"Belgium",648,7,6,3,4,-1,2
"Australia",648,8,7,5,3,2,1
"England",648,8,5,5,3,2,2
"Uruguay",649,1,9,9,3,6,1
"Wales",649,1,6,4,3,1,2
"Argentina",649,3,6,8,5,3,1
"Croatia",649,3,5,2,1,1,2
"England",649,5,9,10,1,9,1
"Chile",649,5,4,4,5,-1,2
"Germany",649,6,7,4,1,3,1
"France",649,6,4,2,2,0,2
"Belgium",649,7,7,11,4,7,1
"Denmark",649,7,6,6,6,0,2
"Chile",650,2,7,4,2,2,1
"France",650,2,5,3,2,1,2
"Italy",650,4,7,7,5,2,1
"Belgium",650,4,5,9,3,6,2
"Netherlands",650,5,9,6,3,3,1
"Brazil",650,5,6,4,2,2,2
"Denmark",650,8,9,4,0,4,1
"Argentina",650,8,6,5,3,2,2
"Croatia",651,1,7,5,0,5,1
"Poland",651,1,6,4,5,-1,2
"Netherlands",651,3,7,6,3,3,1
"Chile",651,3,6,5,2,3,2
"Portugal",651,5,9,4,1,3,1
"Colombia",651,5,4,4,4,0,2
"Italy",651,6,7,7,1,6,1
"Spain",651,6,4,3,3,0,2
"England",651,7,7,3,1,2,1
"Wales",651,7,5,2,1,1,2
"Italy",652,1,7,8,1,7,1
"Qatar",652,1,4,2,5,-3,2
"Argentina",652,3,7,7,3,4,1
"Denmark",652,3,6,4,2,2,2
"Spain",652,6,7,3,1,2,1
"Germany",652,6,4,3,3,0,2
"Japan",652,7,9,5,1,4,1
"Morocco",652,7,4,2,2,0,2
"Netherlands",653,1,9,7,1,6,1
"Switzerland",653,1,4,3,4,-1,2
"Senegal",653,2,9,5,2,3,1
"Germany",653,2,4,5,2,3,2
"Brazil",653,3,9,6,1,5,1
"Denmark",653,3,6,5,4,1,2
"France",653,4,9,7,3,4,1
"Uruguay",653,4,4,3,2,1,2
"Colombia",653,5,7,4,2,2,1
"Japan",653,5,5,3,1,2,2
"Italy",653,7,7,3,0,3,1
"Korea Republic",653,7,6,5,2,3,2
"Spain",653,8,9,5,0,5,1
"Wales",653,8,6,3,2,1,2
"Mexico",654,2,7,5,3,2,1
"Iran",654,2,6,5,3,2,2
"Portugal",654,3,5,3,2,1,1
"United States",654,3,4,3,3,0,2
"Denmark",654,4,9,7,1,6,1
"Belgium",654,4,6,5,2,3,2
"Brazil",654,6,7,4,0,4,1
"Croatia",654,6,5,3,1,2,2
"England",654,7,7,6,4,2,1
"Senegal",654,7,6,6,2,4,2
"Croatia",655,1,9,8,0,8,1
"Tunisia",655,1,6,4,5,-1,2
"Netherlands",655,2,7,8,3,5,1
"Poland",655,2,5,3,2,1,2
"United States",655,3,9,4,1,3,1
"England",655,3,6,6,4,2,2
"Portugal",655,4,7,7,1,6,1
"Jamaica",655,4,6,3,4,-1,2
"France",655,6,9,5,0,5,1
"Denmark",655,6,6,4,4,0,2
"Mexico",655,7,7,4,2,2,1
"Brazil",655,7,5,6,3,3,2
"Italy",655,8,7,8,1,7,1
"Japan",655,8,5,4,3,1,2
"United States",656,1,7,7,2,5,1
"Germany",656,1,5,3,1,2,2
"France",656,2,7,2,0,2,1
"Costa Rica",656,2,5,3,2,1,2
"Argentina",656,3,7,3,1,2,1
"Netherlands",656,3,4,4,1,3,2
"Denmark",656,5,7,7,1,6,1
"Iran",656,5,5,4,2,2,2
"Brazil",656,6,9,8,1,7,1
"Senegal",656,6,4,2,5,-3,2
"Korea Republic",656,7,7,3,1,2,1
"Mexico",656,7,4,3,2,1,2
"Colombia",656,8,7,8,3,5,1
"England",656,8,5,4,3,1,2
"Switzerland",657,1,7,2,0,2,1
"Colombia",657,1,5,4,2,2,2
"Portugal",657,2,7,6,3,3,1
"Uruguay",657,2,4,6,6,0,2
"Netherlands",657,4,9,13,2,11,1
"Brazil",657,4,6,4,4,0,2
"Mexico",657,5,9,5,2,3,1
"Australia",657,5,4,2,2,0,2
"Belgium",657,6,7,4,1,3,1
"Denmark",657,6,5,3,0,3,2
"France",657,8,7,5,3,2,1
"Iran",657,8,5,2,1,1,2
"Uruguay",658,2,7,5,2,3,1
"England",658,2,6,6,3,3,2
"Germany",658,3,6,3,3,0,1
"Spain",658,3,5,3,1,2,2
"Argentina",658,4,9,8,1,7,1
"Denmark",658,4,4,4,3,1,2
"Mexico",658,5,7,2,0,2,1
"Brazil",658,5,6,5,1,4,2
"Belgium",658,6,9,6,2,4,1
"Costa Rica",658,6,6,5,4,1,2
"Portugal",658,7,7,5,1,4,1
"Netherlands",658,7,6,7,4,3,2
"Mexico",659,1,7,4,1,3,1
"Poland",659,1,5,4,1,3,2
"Belgium",659,2,9,6,3,3,1
"Nigeria",659,2,4,2,2,0,2
"France",659,3,6,6,3,3,1
"Uruguay",659,3,5,6,5,1,2
"Senegal",659,6,6,5,6,-1,1
"Argentina",659,6,5,6,2,4,2
"Portugal",659,7,9,8,0,8,1
"Costa Rica",659,7,4,3,3,0,2
"Spain",659,8,9,3,0,3,1
"Netherlands",659,8,6,4,1,3,2
"Germany",660,1,7,3,1,2,1
"Qatar",660,1,4,2,2,0,2
"Belgium",660,2,9,8,2,6,1
"Japan",660,2,4,1,4,-3,2
"England",660,3,7,5,2,3,1
"Wales",660,3,5,4,3,1,2
"Poland",660,4,9,5,2,3,1
"Netherlands",660,4,4,3,2,1,2
"Brazil",660,5,9,6,0,6,1
"Croatia",660,5,6,3,1,2,2
"Portugal",660,8,9,7,2,5,1
"Colombia",660,8,6,3,2,1,2
"England",661,2,7,6,3,3,1
"Colombia",661,2,4,3,4,-1,2
"Portugal",661,4,9,7,2,5,1
"Croatia",661,4,6,3,2,1,2
"Italy",661,8,7,8,3,5,1
"Senegal",661,8,5,5,4,1,2
"United States",662,1,7,6,3,3,1
"Netherlands",662,1,4,4,2,2,2
"Belgium",662,2,7,3,0,3,1
"Nigeria",662,2,6,3,2,1,2
"Denmark",662,3,9,7,2,5,1
"Switzerland",662,3,6,3,3,0,2
"Germany",662,4,9,4,0,4,1
"Poland",662,4,4,3,4,-1,2
"Brazil",662,5,7,3,0,3,1
"Croatia",662,5,3,1,1,0,2
"Spain",662,6,7,3,0,3,1
"Wales",662,6,4,5,6,-1,2
"France",662,7,7,5,3,2,1
"Chile",662,7,4,3,3,0,2
"Mexico",663,1,7,3,0,3,1
"Qatar",663,1,6,4,3,1,2
"Brazil",663,3,7,3,0,3,1
"Italy",663,3,4,2,3,-1,2
"Poland",663,5,9,5,1,4,1
"Belgium",663,5,4,4,2,2,2
"Netherlands",663,6,7,6,2,4,1
"Morocco",663,6,4,2,2,0,2
"Japan",663,8,9,6,3,3,1
"Spain",663,8,6,4,3,1,2
"Portugal",664,3,9,9,3,6,1
"Germany",664,3,6,3,1,2,2
"Iran",664,6,7,6,4,2,1
"Netherlands",664,6,4,5,3,2,2
"Belgium",664,8,9,7,1,6,1
"United States",664,8,6,3,4,-1,2
"Wales",665,1,7,7,2,5,1
"Qatar",665,1,6,6,4,2,2
"Brazil",665,3,7,8,2,6,1
"Australia",665,3,4,6,4,2,2
"Belgium",665,4,9,8,2,6,1
"Croatia",665,4,6,6,4,2,2
"Jamaica",665,5,7,5,3,2,1
"France",665,5,6,8,3,5,2
"Spain",665,7,7,8,5,3,1
"Germany",665,7,4,3,4,-1,2
"Switzerland",665,8,7,5,3,2,1
"Portugal",665,8,4,7,4,3,2
"Croatia",666,1,7,8,2,6,1
"Wales",666,1,5,2,0,2,2
"Italy",666,2,9,4,0,4,1
"Spain",666,2,6,3,3,0,2
"Argentina",666,3,7,6,2,4,1
"Denmark",666,3,6,5,2,3,2
"Netherlands",666,4,9,8,3,5,1
"Belgium",666,4,4,4,1,3,2
"Brazil",666,5,7,9,3,6,1
"Germany",666,5,6,7,5,2,2
"Switzerland",666,6,9,4,1,3,1
"France",666,6,6,4,3,1,2
"Mexico",666,8,7,4,2,2,1
"England",666,8,6,5,2,3,2
"Uruguay",667,1,9,5,0,5,1
"Poland",667,1,6,5,4,1,2
"Italy",667,2,7,4,2,2,1
"Japan",667,2,5,8,5,3,2
"Argentina",667,7,7,9,3,6,1
"Germany",667,7,5,4,2,2,2
"France",668,2,9,10,1,9,1
"Netherlands",668,2,6,6,5,1,2
"Germany",668,4,6,4,4,0,1
"Iran",668,4,5,4,0,4,2
"Italy",668,6,9,8,3,5,1
"Portugal",668,6,6,4,4,0,2
"England",668,8,9,8,1,7,1
"Uruguay",668,8,6,5,5,0,2
"Netherlands",669,5,9,7,1,6,1
"Argentina",669,5,4,6,5,1,2
"Senegal",669,6,7,3,1,2,1
"Uruguay",669,6,6,6,3,3,2
"Brazil",669,7,7,6,2,4,1
"Korea Republic",669,7,5,5,3,2,2
"Spain",670,2,7,6,2,4,1
"Denmark",670,2,5,4,3,1,2
"Netherlands",670,3,9,7,1,6,1
"Belgium",670,3,6,4,3,1,2
"Brazil",670,4,9,8,1,7,1
"Germany",670,4,6,4,5,-1,2
"Argentina",670,6,9,8,3,5,1
"Senegal",670,6,4,4,5,-1,2
"France",670,7,9,6,2,4,1
"Wales",670,7,4,4,4,0,2
"Uruguay",671,1,7,2,0,2,1
"Costa Rica",671,1,4,1,1,0,2
"Switzerland",671,2,7,5,3,2,1
"France",671,2,4,3,3,0,2
"Netherlands",671,6,9,16,0,16,1
"England",671,6,6,6,5,1,2
"Belgium",671,7,7,4,0,4,1
"Colombia",671,7,4,1,1,0,2
"Brazil",672,3,9,15,2,13,1
"Poland",672,3,4,1,3,-2,2
"England",672,5,7,6,3,3,1
"Croatia",672,5,4,4,3,1,2
"Australia",672,6,7,3,1,2,1
"Uruguay",672,6,4,4,4,0,2
"France",672,7,7,7,2,5,1
"Mexico",672,7,6,8,4,4,2
"Morocco",672,8,6,3,3,0,1
"Argentina",672,8,5,3,1,2,2
"Switzerland",673,1,7,4,2,2,1
"Netherlands",673,1,6,4,2,2,2
"France",673,2,7,9,3,6,1
"Iran",673,2,5,5,4,1,2
"Mexico",673,3,7,5,1,4,1
"Argentina",673,3,4,3,2,1,2
"Spain",673,5,7,8,1,7,1
"Uruguay",673,5,4,3,3,0,2
"Germany",673,7,7,5,2,3,1
"England",673,7,5,3,2,1,2
"Wales",674,1,7,6,3,3,1
"Qatar",674,1,6,5,3,2,2
"Argentina",674,2,7,7,1,6,1
"Germany",674,2,4,2,3,-1,2
"France",674,5,9,7,0,7,1
"Colombia",674,5,6,4,2,2,2
"Brazil",675,2,9,8,0,8,1
"Korea Republic",675,2,6,8,5,3,2
"Costa Rica",675,3,6,5,4,1,1
"England",675,3,5,5,3,2,2
"Argentina",675,4,7,7,3,4,1
"Croatia",675,4,4,5,6,-1,2
"France",675,5,9,8,2,6,1
"Iran",675,5,6,7,4,3,2
"Spain",675,6,9,10,1,9,1
"Wales",675,6,6,3,4,-1,2
"Belgium",675,7,9,12,2,10,1
"Japan",675,7,6,4,3,1,2
"Netherlands",675,8,9,7,3,4,1
"Portugal",675,8,6,5,4,1,2
"England",676,2,7,7,3,4,1
"Japan",676,2,4,5,5,0,2
"Croatia",676,4,6,4,3,1,1
"Portugal",676,4,5,2,1,1,2
"Brazil",676,5,7,7,3,4,1
"Australia",676,5,6,7,4,3,2
"Uruguay",676,6,7,4,2,2,1
"Spain",676,6,6,4,1,3,2
"France",676,8,9,5,2,3,1
"Korea Republic",676,8,6,5,3,2,2
"Brazil",677,2,7,5,2,3,1
"Netherlands",677,2,6,7,2,5,2
"Portugal",677,3,9,6,2,4,1
"Colombia",677,3,4,5,3,2,2
"Belgium",677,4,9,7,0,7,1
"Italy",677,4,4,1,3,-2,2
"Croatia",677,5,9,8,2,6,1
"England",677,5,4,9,5,4,2
"Argentina",677,7,9,4,1,3,1
"Germany",677,7,4,5,2,3,2
"Uruguay",677,8,7,4,0,4,1
"Spain",677,8,6,5,4,1,2
"Croatia",678,1,7,4,1,3,1
"Qatar",678,1,6,5,1,4,2
"Mexico",678,3,7,6,1,5,1
"Belgium",678,3,5,5,0,5,2
"Portugal",678,5,7,5,1,4,1
"Netherlands",678,5,6,7,3,4,2
"England",678,8,7,4,1,3,1
"Uruguay",678,8,5,5,3,2,2
"Spain",679,3,7,7,2,5,1
"Iran",679,3,4,4,6,-2,2
"France",679,4,9,4,1,3,1
"Netherlands",679,4,6,5,2,3,2
"Denmark",679,5,9,5,0,5,1
"Argentina",679,5,6,4,3,1,2
"Brazil",679,6,7,4,2,2,1
"Australia",679,6,6,3,2,1,2
"Belgium",679,7,9,8,1,7,1
"Colombia",679,7,6,11,3,8,2
"Italy",680,1,7,6,1,5,1
"Algeria",680,1,6,5,6,-1,2
"Denmark",680,2,7,6,3,3,1
"Portugal",680,2,6,5,3,2,2
"Spain",680,3,7,7,1,6,1
"Japan",680,3,5,2,1,1,2
"Belgium",680,6,7,5,2,3,1
"Tunisia",680,6,4,5,5,0,2
"England",680,8,9,6,1,5,1
"Senegal",680,8,6,2,1,1,2
"England",681,2,9,8,1,7,1
"Croatia",681,2,4,5,6,-1,2
"Brazil",681,3,9,5,2,3,1
"Germany",681,3,4,3,2,1,2
"France",681,4,9,8,1,7,1
"Netherlands",681,4,6,5,4,1,2
"Korea Republic",681,7,7,5,1,4,1
"Spain",681,7,4,2,3,-1,2
"Portugal",681,8,9,7,1,6,1
"Uruguay",681,8,4,2,2,0,2
"Chile",682,1,7,4,2,2,1
"Italy",682,1,6,6,1,5,2
"Brazil",682,2,6,3,3,0,1
"Japan",682,2,5,4,2,2,2
"Iran",682,3,9,6,3,3,1
"Argentina",682,3,4,2,2,0,2
"England",682,4,9,7,2,5,1
"Tunisia",682,4,4,3,4,-1,2
"France",682,7,9,9,2,7,1
"Algeria",682,7,6,3,3,0,2
"Uruguay",683,3,6,5,1,4,1
"Switzerland",683,3,5,3,2,1,2
"United States",683,4,7,6,4,2,1
"Argentina",683,4,5,4,2,2,2
"Poland",683,5,6,4,2,2,1
"Portugal",683,5,5,4,3,1,2
"France",683,7,7,4,2,2,1
"Senegal",683,7,4,3,3,0,2
"Iran",684,3,7,5,3,2,1
"France",684,3,6,8,4,4,2
"Colombia",684,7,6,4,3,1,1
"Senegal",684,7,5,3,1,2,2
"Germany",684,8,9,7,2,5,1
"Belgium",684,8,6,9,3,6,2
"Qatar",685,1,9,4,0,4,1
"Colombia",685,1,6,6,2,4,2
"England",685,2,9,3,0,3,1
"Denmark",685,2,6,4,3,1,2
"Belgium",685,3,7,7,1,6,1
"Mexico",685,3,6,4,1,3,2
"Italy",685,4,7,6,3,3,1
"Wales",685,4,6,3,2,1,2
"Netherlands",685,5,7,5,2,3,1
"Portugal",685,5,3,2,2,0,2
"Germany",685,6,7,5,3,2,1
"Korea Republic",685,6,6,4,2,2,2
"France",685,7,7,6,2,4,1
"Poland",685,7,5,4,1,3,2
"Croatia",685,8,9,5,2,3,1
"Spain",685,8,6,10,2,8,2
"Germany",686,1,7,4,1,3,1
"Algeria",686,1,4,3,4,-1,2
"Italy",686,5,9,11,1,10,1
"France",686,5,6,7,3,4,2
"Belgium",686,6,9,8,2,6,1
"Japan",686,6,4,4,4,0,2
"Uruguay",686,7,9,9,2,7,1
"England",686,7,6,4,3,1,2
"Spain",687,3,7,6,1,5,1
"Uruguay",687,3,6,5,4,1,2
"Germany",687,7,9,6,3,3,1
"Iran",687,7,6,5,2,3,2
"Croatia",688,3,5,6,4,2,1
"Argentina",688,3,4,4,4,0,2
"Spain",688,4,7,7,2,5,1
"Italy",688,4,6,5,3,2,2
"Brazil",688,6,7,5,1,4,1
"Australia",688,6,6,4,5,-1,2
"Portugal",688,7,9,5,1,4,1
"Denmark",688,7,4,1,1,0,2
"Poland",689,1,7,5,1,4,1
"Qatar",689,1,6,2,3,-1,2
"Korea Republic",689,3,9,5,1,4,1
"Brazil",689,3,6,5,2,3,2
"Netherlands",689,7,9,7,0,7,1
"Senegal",689,7,6,2,1,1,2
"Denmark",689,8,7,5,3,2,1
"France",689,8,6,4,2,2,2
"Brazil",690,3,9,9,2,7,1
"Senegal",690,3,4,2,4,-2,2
"Argentina",690,4,9,4,0,4,1
"Denmark",690,4,6,4,2,2,2
"Portugal",690,6,9,6,0,6,1
"Nigeria",690,6,6,3,2,1,2
"France",690,8,7,3,1,2,1
"Switzerland",690,8,4,2,2,0,2
"Brazil",691,2,9,6,3,3,1
"Korea Republic",691,2,4,4,3,1,2
"Italy",691,3,7,4,2,2,1
"Algeria",691,3,6,5,3,2,2
"Denmark",691,4,7,9,3,6,1
"Portugal",691,4,6,6,5,1,2
"Spain",691,5,9,9,1,8,1
"Morocco",691,5,6,4,4,0,2
"Argentina",691,8,7,4,2,2,1
"Switzerland",691,8,6,5,1,4,2
"Denmark",692,1,9,7,2,5,1
"United States",692,1,4,5,4,1,2
"Portugal",692,2,9,8,2,6,1
"Korea Republic",692,2,4,2,1,1,2
"Poland",692,4,9,4,0,4,1
"Germany",692,4,6,4,1,3,2
"Netherlands",692,6,7,4,2,2,1
"Spain",692,6,6,2,1,1,2
"England",692,7,9,4,1,3,1
"Wales",692,7,4,3,3,0,2
"France",692,8,9,5,0,5,1
"Iran",692,8,4,4,4,0,2
"Netherlands",693,1,7,4,1,3,1
"Qatar",693,1,4,4,3,1,2
"Argentina",693,3,7,6,4,2,1
"Germany",693,3,6,7,2,5,2
"Uruguay",693,4,7,4,2,2,1
"France",693,4,5,7,2,5,2
"Portugal",693,5,7,5,2,3,1
"Korea Republic",693,5,4,2,2,0,2
"Algeria",693,7,6,6,3,3,1
"England",693,7,5,4,3,1,2
"Poland",694,1,6,5,4,1,1
"Morocco",694,1,5,3,2,1,2
"Argentina",694,3,7,8,3,5,1
"Croatia",694,3,5,3,2,1,2
"Portugal",694,6,7,8,2,6,1
"Switzerland",694,6,4,4,7,-3,2
"Uruguay",695,1,9,7,0,7,1
"Qatar",695,1,6,5,4,1,2
"France",695,3,9,9,0,9,1
"Croatia",695,3,4,3,7,-4,2
"Denmark",695,5,7,7,1,6,1
"Spain",695,5,5,6,4,2,2
"Netherlands",695,8,5,7,4,3,1
"Wales",695,8,4,4,6,-2,2
"Mexico",696,1,9,8,2,6,1
"Qatar",696,1,4,4,4,0,2
"Brazil",696,5,7,7,3,4,1
"Netherlands",696,5,6,5,3,2,2
"Spain",696,7,7,4,2,2,1
"Uruguay",696,7,4,3,3,0,2
"Poland",696,8,7,4,2,2,1
"Portugal",696,8,5,4,3,1,2
"Qatar",697,1,9,4,1,3,1
"Morocco",697,1,6,4,3,1,2
"France",697,3,7,4,0,4,1
"Poland",697,3,4,1,1,0,2
"Denmark",697,7,6,5,4,1,1
"Switzerland",697,7,5,2,0,2,2
"Morocco",698,1,7,5,3,2,1
"Switzerland",698,1,6,7,6,1,2
"France",698,3,7,4,1,3,1
"Colombia",698,3,6,6,2,4,2
"Italy",698,6,7,6,3,3,1
"Wales",698,6,4,3,2,1,2
"Portugal",698,7,7,5,2,3,1
"Nigeria",698,7,4,5,6,-1,2
"Spain",698,8,9,7,2,5,1
"Denmark",698,8,6,4,3,1,2
"Qatar",699,1,7,4,2,2,1
"Colombia",699,1,5,3,2,1,2
"Uruguay",699,2,7,6,4,2,1
"Switzerland",699,2,5,3,2,1,2
"Germany",699,3,9,10,2,8,1
"Brazil",699,3,4,3,3,0,2
"Italy",699,4,7,4,1,3,1
"Spain",699,4,6,8,4,4,2
"Croatia",699,5,9,6,0,6,1
"France",699,5,4,2,2,0,2
"Netherlands",699,6,9,10,2,8,1
"Portugal",699,6,6,7,3,4,2
"Mexico",699,7,7,3,1,2,1
"Korea Republic",699,7,5,3,2,1,2
"United States",699,8,9,4,1,3,1
"Belgium",699,8,6,8,3,5,2
"Spain",700,2,7,5,1,4,1
"Uruguay",700,2,6,5,4,1,2
"France",701,2,7,6,2,4,1
"Denmark",701,2,4,3,3,0,2
"Argentina",701,4,7,3,1,2,1
"Japan",701,4,3,1,1,0,2
"Brazil",701,6,9,14,0,14,1
"United States",701,6,6,3,5,-2,2
"Portugal",701,7,9,6,1,5,1
"Chile",701,7,6,4,3,1,2
"Spain",701,8,7,3,0,3,1
"Netherlands",701,8,4,1,2,-1,2
"Qatar",702,1,9,10,3,7,1
"Tunisia",702,1,6,4,5,-1,2
"Uruguay",702,4,9,5,1,4,1
"United States",702,4,6,2,2,0,2
"Belgium",702,6,7,4,2,2,1
"Poland",702,6,4,3,3,0,2
"Portugal",702,7,7,3,1,2,1
"Japan",702,7,5,5,3,2,2
"Netherlands",702,8,7,5,2,3,1
"Brazil",702,8,5,6,1,5,2
"Italy",703,2,7,5,1,4,1
"Switzerland",703,2,5,3,2,1,2
"Portugal",703,5,9,3,0,3,1
"United States",703,5,4,4,3,1,2
"Spain",703,6,7,13,1,12,1
"Uruguay",703,6,6,6,2,4,2
"Belgium",703,7,7,7,2,5,1
"Senegal",703,7,4,5,4,1,2
"France",703,8,7,6,3,3,1
"Mexico",703,8,4,4,4,0,2
"Uruguay",704,1,9,8,2,6,1
"Qatar",704,1,6,3,4,-1,2
"Colombia",704,3,9,6,1,5,1
"France",704,3,6,4,2,2,2
"England",704,5,7,4,1,3,1
"Korea Republic",704,5,6,5,5,0,2
"Belgium",704,6,9,5,2,3,1
"Mexico",704,6,6,4,3,1,2
"United States",704,7,7,6,3,3,1
"Denmark",704,7,4,3,2,1,2
"Italy",705,1,9,7,1,6,1
"Qatar",705,1,4,4,3,1,2
"Germany",705,5,7,6,1,5,1
"Wales",705,5,6,4,4,0,2
"France",705,6,7,4,0,4,1
"Chile",705,6,6,6,3,3,2
"Brazil",705,7,7,12,4,8,1
"Korea Republic",705,7,5,4,3,1,2
"Uruguay",705,8,7,5,2,3,1
"Portugal",705,8,4,5,3,2,2
"Portugal",706,2,9,5,0,5,1
"Switzerland",706,2,6,6,1,5,2
"Mexico",706,3,7,5,2,3,1
"Brazil",706,3,6,8,2,6,2
"Colombia",706,4,7,7,4,3,1
"England",706,4,4,6,3,3,2
"Germany",706,5,7,5,2,3,1
"Argentina",706,5,5,7,4,3,2
"Spain",706,6,9,9,3,6,1
"Italy",706,6,4,4,5,-1,2
"Chile",706,8,9,4,1,3,1
"France",706,8,6,6,3,3,2
"Germany",707,1,9,9,0,9,1
"Qatar",707,1,4,3,4,-1,2
"Algeria",707,2,9,4,1,3,1
"Brazil",707,2,6,4,1,3,2
"Spain",707,5,7,7,2,5,1
"Colombia",707,5,5,3,2,1,2
"England",707,7,7,8,4,4,1
"Netherlands",707,7,4,7,6,1,2
"France",707,8,7,7,2,5,1
"Korea Republic",707,8,5,5,2,3,2
"Italy",708,3,9,7,3,4,1
"Morocco",708,3,4,2,2,0,2
"Belgium",708,4,9,9,3,6,1
"Colombia",708,4,4,5,5,0,2
"Poland",708,5,7,9,4,5,1
"Brazil",708,5,6,6,6,0,2
"Germany",708,6,6,8,2,6,1
"Argentina",708,6,5,3,1,2,2
"France",708,7,7,2,0,2,1
"Netherlands",708,7,4,4,2,2,2
"Spain",708,8,7,6,2,4,1
"Uruguay",708,8,4,2,1,1,2
"Spain",709,2,7,4,0,4,1
"Germany",709,2,4,4,4,0,2
"Croatia",709,3,9,7,1,6,1
"Portugal",709,3,6,7,4,3,2
"Belgium",709,4,9,11,4,7,1
"Wales",709,4,4,5,7,-2,2
"Argentina",709,5,7,4,1,3,1
"Netherlands",709,5,4,2,1,1,2
"Brazil",709,6,9,11,0,11,1
"Tunisia",709,6,6,4,5,-1,2
"England",709,7,9,10,2,8,1
"Colombia",709,7,6,6,5,1,2
"France",709,8,7,5,1,4,1
"Chile",709,8,5,2,0,2,2
"Italy",710,1,7,9,1,8,1
"Qatar",710,1,4,1,3,-2,2
"Spain",710,2,7,5,1,4,1
"Germany",710,2,5,4,3,1,2
"England",710,3,9,7,4,3,1
"Australia",710,3,4,3,2,1,2
"Brazil",710,5,7,5,3,2,1
"Netherlands",710,5,5,5,3,2,2
"France",710,6,7,3,1,2,1
"Iran",710,6,6,4,3,1,2
"Belgium",710,7,9,9,1,8,1
"Colombia",710,7,6,7,7,0,2
"Poland",711,3,9,6,2,4,1
"Denmark",711,3,6,6,3,3,2
"Belgium",711,4,9,9,2,7,1
"Morocco",711,4,6,4,3,1,2
"Uruguay",712,1,9,8,1,7,1
"Qatar",712,1,6,6,1,5,2
"Germany",712,2,9,10,5,5,1
"Switzerland",712,2,6,6,4,2,2
"Netherlands",712,3,7,7,1,6,1
"England",712,3,5,7,6,1,2
"Australia",712,4,6,7,4,3,1
"Colombia",712,4,5,3,2,1,2
"France",712,5,9,8,2,6,1
"Chile",712,5,4,5,4,1,2
"Belgium",712,8,5,6,2,4,1
"Mexico",712,8,4,4,6,-2,2
"England",713,2,9,10,0,10,1
"Croatia",713,2,4,4,2,2,2
"France",713,3,9,7,3,4,1
"Colombia",713,3,6,7,3,4,2
"Korea Republic",713,4,9,7,1,6,1
"Brazil",713,4,6,3,3,0,2
"Spain",713,5,7,3,1,2,1
"Netherlands",713,5,6,3,2,1,2
"Uruguay",713,6,7,3,1,2,1
"Belgium",713,6,5,3,0,3,2
"Tunisia",713,7,7,4,2,2,1
"Argentina",713,7,6,7,3,4,2
"Portugal",713,8,9,7,0,7,1
"Nigeria",713,8,6,3,3,0,2
"Netherlands",714,1,9,8,2,6,1
"Tunisia",714,1,4,5,4,1,2
"Brazil",714,5,9,7,1,6,1
"Croatia",714,5,6,4,2,2,2
"Portugal",714,6,7,4,1,3,1
"Iran",714,6,4,3,4,-1,2
"Mexico",714,8,7,6,1,5,1
"Korea Republic",714,8,6,3,3,0,2
"Belgium",715,2,9,7,0,7,1
"Uruguay",715,2,4,3,3,0,2
"Croatia",715,6,7,4,2,2,1
"England",715,6,6,3,2,1,2
"Spain",715,7,9,5,1,4,1
"Japan",715,7,6,5,2,3,2
"Italy",715,8,7,4,1,3,1
"Argentina",715,8,5,6,1,5,2
"Italy",716,1,9,4,0,4,1
"Senegal",716,1,6,4,2,2,2
"Argentina",716,5,6,6,4,2,1
"Morocco",716,5,5,3,2,1,2
"England",716,6,9,6,2,4,1
"Colombia",716,6,6,4,1,3,2
"France",716,7,9,10,2,8,1
"Uruguay",716,7,4,3,3,0,2
"Netherlands",717,1,6,8,5,3,1
"Tunisia",717,1,5,4,3,1,2
"Portugal",717,2,9,4,1,3,1
"Japan",717,2,4,3,3,0,2
"Brazil",717,7,9,5,1,4,1
"Denmark",717,7,6,4,1,3,2
"Chile",717,8,7,4,2,2,1
"Belgium",717,8,6,7,2,5,2
"Poland",718,1,7,3,0,3,1
"Colombia",718,1,6,6,5,1,2
"Brazil",718,3,7,8,1,7,1
"Wales",718,3,5,3,1,2,2
"Portugal",718,5,5,4,3,1,1
"Nigeria",718,5,4,3,3,0,2
"Italy",718,6,6,6,2,4,1
"Argentina",718,6,5,3,2,1,2
"France",718,7,9,7,2,5,1
"Netherlands",718,7,4,8,4,4,2
"Belgium",718,8,9,7,3,4,1
"Tunisia",718,8,4,3,4,-1,2
"Qatar",719,1,7,5,1,4,1
"Denmark",719,1,5,4,3,1,2
"Netherlands",719,3,9,5,1,4,1
"Japan",719,3,6,3,2,1,2
"Chile",719,4,6,5,4,1,1
"England",719,4,5,4,3,1,2
"Argentina",719,5,9,7,0,7,1
"Mexico",719,5,6,6,3,3,2
"Spain",719,8,9,6,1,5,1
"Nigeria",719,8,4,5,4,1,2
"Germany",720,1,7,9,2,7,1
"Qatar",720,1,6,4,3,1,2
"Brazil",720,3,9,8,1,7,1
"Algeria",720,3,4,4,6,-2,2
"Netherlands",720,4,9,5,1,4,1
"Japan",720,4,4,5,5,0,2
"France",720,5,9,4,1,3,1
"Uruguay",720,5,6,5,2,3,2
"England",720,7,9,7,1,6,1
"Chile",720,7,6,5,3,2,2
"Italy",720,8,7,5,2,3,1
"Portugal",720,8,6,8,2,6,2
"Chile",721,1,7,14,3,11,1
"Italy",721,1,4,3,6,-3,2
"Argentina",721,2,7,5,1,4,1
"United States",721,2,4,4,4,0,2
"Wales",721,4,9,9,2,7,1
"Brazil",721,4,4,3,2,1,2
"Belgium",721,5,9,8,1,7,1
"Switzerland",721,5,6,2,3,-1,2
"Mexico",721,7,7,7,4,3,1
"Spain",721,7,5,5,2,3,2
"Germany",721,8,7,4,2,2,1
"France",721,8,6,7,2,5,2
"Spain",722,2,9,7,2,5,1
"Denmark",722,2,4,4,4,0,2
"Uruguay",722,3,7,3,1,2,1
"Belgium",722,3,6,5,2,3,2
"France",722,6,9,8,0,8,1
"Japan",722,6,4,2,2,0,2
"Brazil",722,8,7,11,1,10,1
"Netherlands",722,8,5,4,0,4,2
"France",723,3,7,5,0,5,1
"Colombia",723,3,5,2,0,2,2
"Portugal",723,4,7,3,1,2,1
"Poland",723,4,6,5,1,4,2
"Uruguay",723,6,7,3,1,2,1
"United States",723,6,5,4,2,2,2
"Croatia",723,8,7,4,1,3,1
"Spain",723,8,4,3,2,1,2
"Uruguay",724,1,7,4,0,4,1
"Switzerland",724,1,4,2,3,-1,2
"Belgium",724,4,9,9,0,9,1
"Chile",724,4,6,4,3,1,2
"Croatia",724,7,7,4,1,3,1
"France",724,7,6,9,2,7,2
"Germany",725,1,7,7,2,5,1
"Wales",725,1,6,5,7,-2,2
"France",725,2,7,6,2,4,1
"Korea Republic",725,2,6,3,2,1,2
"Mexico",725,4,9,4,1,3,1
"England",725,4,6,4,1,3,2
"Portugal",725,5,7,8,0,8,1
"Croatia",725,5,4,2,2,0,2
"Brazil",725,6,6,7,3,4,1
"Denmark",725,6,5,3,2,1,2
"Colombia",725,7,7,4,0,4,1
"Belgium",725,7,6,8,3,5,2
"Argentina",725,8,9,8,0,8,1
"Netherlands",725,8,4,4,4,0,2
"Poland",726,1,9,5,2,3,1
"Colombia",726,1,4,3,2,1,2
"France",726,2,7,3,1,2,1
"Wales",726,2,3,3,3,0,2
"Brazil",726,3,7,4,1,3,1
"Senegal",726,3,6,3,1,2,2
"Argentina",726,4,7,7,1,6,1
"Switzerland",726,4,6,4,6,-2,2
"Uruguay",726,5,7,7,3,4,1
"Portugal",726,5,5,3,2,1,2
"Spain",726,6,7,4,1,3,1
"Croatia",726,6,4,1,1,0,2
"Switzerland",727,1,5,4,1,3,1
"Qatar",727,1,4,4,6,-2,2
"Netherlands",727,4,9,10,3,7,1
"France",727,4,6,8,6,2,2
"Australia",727,5,7,4,2,2,1
"Brazil",727,5,5,2,1,1,2
"Spain",727,7,7,6,3,3,1
"Iran",727,7,4,2,2,0,2
"Belgium",727,8,7,5,1,4,1
"Denmark",727,8,5,4,3,1,2
"Germany",728,1,9,8,0,8,1
"Costa Rica",728,1,6,3,6,-3,2
"France",728,3,9,9,4,5,1
"Italy",728,3,6,8,4,4,2
"Spain",728,4,9,7,0,7,1
"Denmark",728,4,6,4,3,1,2
"Netherlands",728,6,7,6,3,3,1
"Argentina",728,6,5,4,3,1,2
"Poland",728,7,7,3,1,2,1
"Belgium",728,7,3,2,2,0,2
"Uruguay",728,8,5,1,0,1,1
"England",728,8,4,4,3,1,2
"Algeria",729,1,7,4,1,3,1
"Germany",729,1,5,5,2,3,2
"Argentina",729,2,9,8,4,4,1
"Denmark",729,2,6,7,6,1,2
"Belgium",729,3,9,8,2,6,1
"Uruguay",729,3,6,7,4,3,2
"Spain",729,4,5,4,3,1,1
"Croatia",729,4,4,4,3,1,2
"Senegal",729,5,7,6,1,5,1
"Brazil",729,5,6,4,3,1,2
"England",729,8,9,6,0,6,1
"Italy",729,8,4,4,2,2,2
"Senegal",730,1,6,4,1,3,1
"Italy",730,1,5,2,1,1,2
"England",730,2,7,4,2,2,1
"Colombia",730,2,6,2,1,1,2
"Mexico",730,3,7,5,2,3,1
"Brazil",730,3,6,7,2,5,2
"Spain",730,6,7,6,1,5,1
"Wales",730,6,6,5,2,3,2
"Belgium",730,8,7,7,1,6,1
"Netherlands",730,8,6,2,3,-1,2
"Denmark",731,1,7,3,1,2,1
"Switzerland",731,1,4,3,2,1,2
"Brazil",731,3,9,11,1,10,1
"Italy",731,3,4,3,4,-1,2
"Colombia",731,4,7,4,0,4,1
"Belgium",731,4,6,5,3,2,2
"Chile",731,6,6,5,2,3,1
"Croatia",731,6,5,3,2,1,2
"Uruguay",731,8,7,4,1,3,1
"Spain",731,8,5,3,2,1,2
"Brazil",732,3,9,9,1,8,1
"Morocco",732,3,4,3,5,-2,2
"Spain",732,4,6,3,1,2,1
"Korea Republic",732,4,5,2,1,1,2
"Argentina",732,5,9,5,1,4,1
"Netherlands",732,5,6,8,3,5,2
"Iran",732,6,7,7,2,5,1
"England",732,6,4,4,4,0,2
"Uruguay",732,8,7,3,1,2,1
"France",732,8,6,3,1,2,2
"Denmark",733,3,9,6,1,5,1
"Argentina",733,3,6,6,6,0,2
"Belgium",733,6,7,6,2,4,1
"Korea Republic",733,6,5,3,2,1,2
"France",733,8,9,7,2,5,1
"United States",733,8,4,3,2,1,2
"Croatia",734,2,7,9,4,5,1
"Australia",734,2,5,4,3,1,2
"Switzerland",734,6,7,4,2,2,1
"Spain",734,6,6,5,3,2,2
"Germany",734,7,9,4,0,4,1
"France",734,7,6,3,1,2,2
"Belgium",734,8,9,6,2,4,1
"Italy",734,8,6,6,2,4,2
"Germany",735,1,9,8,0,8,1
"Senegal",735,1,6,5,4,1,2
"Switzerland",735,3,7,6,3,3,1
"Croatia",735,3,5,6,2,4,2
"Netherlands",735,4,7,4,2,2,1
"Argentina",735,4,6,4,2,2,2
"Belgium",735,5,7,5,0,5,1
"Korea Republic",735,5,6,4,3,1,2
"Spain",735,7,9,7,0,7,1
"Australia",735,7,4,3,3,0,2
"Italy",735,8,7,7,2,5,1
"Portugal",735,8,3,3,3,0,2
"Qatar",736,1,6,4,3,1,1
"Jamaica",736,1,5,2,1,1,2
"United States",736,2,5,3,2,1,1
"Iran",736,2,4,2,2,0,2
"Spain",736,3,9,9,3,6,1
"Australia",736,3,6,5,4,1,2
"Brazil",736,5,7,6,2,4,1
"Wales",736,5,6,3,2,1,2
"Germany",736,6,7,5,3,2,1
"Portugal",736,6,4,7,6,1,2
"Algeria",736,8,6,5,3,2,1
"Argentina",736,8,5,3,2,1,2
"Qatar",737,1,7,7,4,3,1
"Denmark",737,1,5,5,4,1,2
"Mexico",737,2,7,5,2,3,1
"Spain",737,2,5,3,1,2,2
"England",737,3,9,9,2,7,1
"Switzerland",737,3,4,5,6,-1,2
"Uruguay",737,6,9,6,2,4,1
"France",737,6,4,6,5,1,2
"Belgium",737,7,9,5,1,4,1
"Netherlands",737,7,6,6,3,3,2
"Portugal",738,2,9,8,1,7,1
"Morocco",738,2,6,3,3,0,2
"Netherlands",738,3,7,3,0,3,1
"Spain",738,3,5,3,2,1,2
"Italy",738,4,9,7,4,3,1
"England",738,4,6,6,4,2,2
"Denmark",738,6,7,5,2,3,1
"Wales",738,6,4,4,4,0,2
"France",739,4,7,7,4,3,1
"Netherlands",739,4,6,5,4,1,2
"Brazil",739,5,7,5,1,4,1
"Australia",739,5,6,4,1,3,2
"Belgium",739,6,7,9,3,6,1
"Korea Republic",739,6,4,2,5,-3,2
"Germany",739,7,7,2,0,2,1
"Wales",739,7,4,6,4,2,2
"Switzerland",739,8,9,6,2,4,1
"Portugal",739,8,4,5,4,1,2
"Wales",740,1,7,4,0,4,1
"Germany",740,1,6,5,4,1,2
"France",740,5,7,6,1,5,1
"Mexico",740,5,5,2,0,2,2
"Brazil",740,6,9,5,1,4,1
"Netherlands",740,6,6,6,4,2,2
"Denmark",740,7,7,5,0,5,1
"Argentina",740,7,5,3,1,2,2
"Nigeria",741,1,6,3,4,-1,1
"Qatar",741,1,5,4,1,3,2
"Colombia",741,3,7,6,2,4,1
"Switzerland",741,3,5,7,4,3,2
"Denmark",741,5,7,5,2,3,1
"Spain",741,5,4,6,4,2,2
"Argentina",741,6,9,8,2,6,1
"Mexico",741,6,6,12,5,7,2
"Uruguay",741,8,9,7,1,6,1
"Poland",741,8,4,4,3,1,2
"Colombia",742,1,9,4,0,4,1
"Wales",742,1,6,4,4,0,2
"Portugal",742,6,9,7,2,5,1
"Mexico",742,6,6,6,2,4,2
"Brazil",743,2,9,4,0,4,1
"Italy",743,2,6,4,2,2,2
"Argentina",743,4,7,4,0,4,1
"Croatia",743,4,6,4,4,0,2
"Portugal",743,5,7,3,1,2,1
"Colombia",743,5,6,3,1,2,2
"Chile",743,7,7,4,1,3,1
"Netherlands",743,7,6,6,2,4,2
"France",743,8,9,6,0,6,1
"United States",743,8,4,1,2,-1,2
"Poland",744,4,7,6,2,4,1
"Colombia",744,4,4,4,6,-2,2
"Brazil",744,6,7,8,2,6,1
"Italy",744,6,6,9,3,6,2
"Argentina",744,8,5,4,2,2,1
"Algeria",744,8,4,3,4,-1,2
"Mexico",745,1,7,3,0,3,1
"Poland",745,1,4,4,5,-1,2
"Switzerland",745,2,9,9,2,7,1
"Portugal",745,2,6,4,3,1,2
"Croatia",745,7,6,4,3,1,1
"France",745,7,5,6,4,2,2
"England",745,8,9,3,0,3,1
"Germany",745,8,6,4,2,2,2
"United States",746,1,7,6,2,4,1
"Morocco",746,1,4,3,3,0,2
"Belgium",746,2,9,7,1,6,1
"Croatia",746,2,4,3,1,2,2
"Germany",746,4,7,7,3,4,1
"Switzerland",746,4,5,3,2,1,2
"Italy",747,1,9,10,1,9,1
"Wales",747,1,6,4,4,0,2
"England",747,2,7,4,0,4,1
"Colombia",747,2,4,2,1,1,2
"Netherlands",747,5,9,6,1,5,1
"Brazil",747,5,6,5,2,3,2
"France",747,6,7,7,3,4,1
"Germany",747,6,6,4,2,2,2
"Wales",748,1,7,7,0,7,1
"Mexico",748,1,5,3,0,3,2
"Brazil",748,2,7,7,2,5,1
"Denmark",748,2,6,6,6,0,2
"England",748,4,9,7,3,4,1
"Switzerland",748,4,6,4,4,0,2
"Germany",748,5,7,5,2,3,1
"Senegal",748,5,5,3,1,2,2
"France",748,6,9,6,1,5,1
"Jamaica",748,6,4,2,4,-2,2
"Netherlands",748,8,7,10,4,6,1
"Chile",748,8,5,4,3,1,2
"Qatar",749,1,9,11,4,7,1
"United States",749,1,6,4,5,-1,2
"Spain",749,4,7,4,0,4,1
"Wales",749,4,4,5,5,0,2
"Brazil",749,5,6,6,4,2,1
"Italy",749,5,5,5,3,2,2
"Belgium",750,5,7,10,4,6,1
"Japan",750,5,6,4,7,-3,2
"Brazil",750,7,9,7,1,6,1
"Germany",750,7,4,7,6,1,2
"Poland",750,8,9,8,2,6,1
"Spain",750,8,6,7,4,3,2
"United States",751,1,9,5,0,5,1
"Germany",751,1,6,3,2,1,2
"Denmark",751,2,9,9,1,8,1
"England",751,2,6,4,4,0,2
"France",751,3,9,8,1,7,1
"Tunisia",751,3,4,5,5,0,2
"Australia",751,4,7,5,3,2,1
"Belgium",751,4,5,6,5,1,2
"Spain",751,5,9,7,1,6,1
"Mexico",751,5,6,2,2,0,2
"Netherlands",751,6,7,5,0,5,1
"Wales",751,6,5,4,1,3,2
"United States",752,1,7,4,1,3,1
"Algeria",752,1,6,5,3,2,2
"Brazil",752,2,7,3,1,2,1
"Poland",752,2,4,2,1,1,2
"Uruguay",752,3,7,8,1,7,1
"Spain",752,3,5,7,3,4,2
"Belgium",752,4,7,5,0,5,1
"Jamaica",752,4,5,3,2,1,2
"France",752,5,7,7,0,7,1
"Japan",752,5,5,2,1,1,2
"Italy",752,6,7,4,1,3,1
"Argentina",752,6,6,7,3,4,2
"Germany",754,2,9,7,2,5,1
"Belgium",754,2,6,8,3,5,2
"Argentina",754,6,9,7,2,5,1
"Morocco",754,6,4,2,2,0,2
"Poland",754,7,7,4,0,4,1
"Iran",754,7,4,1,2,-1,2
"Denmark",755,1,6,4,2,2,1
"Qatar",755,1,5,3,2,1,2
"Australia",755,2,7,6,1,5,1
"Colombia",755,2,4,5,5,0,2
"Portugal",755,3,7,7,1,6,1
"Uruguay",755,3,4,2,2,0,2
"Belgium",755,5,7,4,1,3,1
"Korea Republic",755,5,4,4,4,0,2
"Italy",755,7,7,5,1,4,1
"Chile",755,7,6,5,5,0,2
"Brazil",755,8,9,5,0,5,1
"Germany",755,8,6,7,2,5,2
"Chile",756,1,7,7,1,6,1
"Mexico",756,1,6,4,4,0,2
"Brazil",756,4,9,11,1,10,1
"Italy",756,4,6,4,6,-2,2
"Croatia",756,6,7,7,1,6,1
"Portugal",756,6,6,4,4,0,2
"England",756,7,7,5,0,5,1
"Australia",756,7,6,3,1,2,2
"Argentina",756,8,9,8,2,6,1
"Germany",756,8,6,7,5,2,2
"Italy",757,1,9,10,0,10,1
"Costa Rica",757,1,6,5,9,-4,2
"Brazil",757,2,9,8,1,7,1
"Croatia",757,2,6,4,1,3,2
"Denmark",757,5,7,5,1,4,1
"Wales",757,5,4,3,3,0,2
"Netherlands",757,6,9,9,2,7,1
"Belgium",757,6,6,7,3,4,2
"Korea Republic",757,7,7,4,1,3,1
"England",757,7,5,3,2,1,2
"Germany",757,8,7,6,3,3,1
"Portugal",757,8,6,3,3,0,2
"Algeria",758,1,7,10,5,5,1
"United States",758,1,5,5,4,1,2
"Belgium",758,2,7,5,1,4,1
"Croatia",758,2,6,6,2,4,2
"Argentina",758,3,6,4,2,2,1
"Mexico",758,3,5,2,1,1,2
"Brazil",758,5,9,9,4,5,1
"Costa Rica",758,5,6,4,4,0,2
"Spain",758,6,7,8,1,7,1
"Germany",758,6,5,4,3,1,2
"Italy",758,7,9,7,2,5,1
"Nigeria",758,7,6,6,6,0,2
"Colombia",759,1,9,5,1,4,1
"United States",759,1,6,5,3,2,2
"Chile",759,2,7,4,2,2,1
"Portugal",759,2,6,7,2,5,2
"Brazil",759,3,9,5,1,4,1
"Croatia",759,3,6,5,2,3,2
"Spain",759,4,7,3,1,2,1
"Switzerland",759,4,6,4,1,3,2
"Italy",759,5,7,3,1,2,1
"Poland",759,5,6,4,3,1,2
"Uruguay",759,7,7,4,1,3,1
"Costa Rica",759,7,4,4,5,-1,2
"Denmark",759,8,7,6,3,3,1
"Korea Republic",759,8,6,3,3,0,2
"Qatar",760,1,7,6,3,3,1
"Poland",760,1,5,4,3,1,2
"Switzerland",760,3,7,5,3,2,1
"Belgium",760,3,6,5,3,2,2
"England",760,4,9,9,0,9,1
"Mexico",760,4,6,3,3,0,2
"Brazil",760,5,9,4,0,4,1
"Wales",760,5,4,2,2,0,2
"Uruguay",760,7,7,4,1,3,1
"United States",760,7,6,5,4,1,2
"Portugal",760,8,9,9,2,7,1
"Germany",760,8,6,6,5,1,2
"Qatar",761,1,7,6,3,3,1
"Chile",761,1,4,4,5,-1,2
"Korea Republic",761,2,7,7,3,4,1
"Spain",761,2,6,4,4,0,2
"Portugal",761,3,9,9,1,8,1
"Switzerland",761,3,6,5,3,2,2
"Brazil",761,5,9,8,2,6,1
"Croatia",761,5,4,4,5,-1,2
"Wales",761,6,7,5,2,3,1
"England",761,6,5,3,2,1,2
"Uruguay",762,2,9,6,3,3,1
"Spain",762,2,6,4,2,2,2
"Belgium",762,3,9,10,1,9,1
"Switzerland",762,3,4,3,7,-4,2
"Italy",762,5,9,7,2,5,1
"England",762,5,6,4,2,2,2
"Brazil",762,6,9,8,1,7,1
"Denmark",762,6,4,4,4,0,2
"Croatia",762,7,7,2,0,2,1
"Argentina",762,7,6,4,1,3,2
"Brazil",763,2,9,14,2,12,1
"Nigeria",763,2,4,2,5,-3,2
"Croatia",763,4,7,6,3,3,1
"Morocco",763,4,6,5,5,0,2
"Senegal",763,5,9,7,2,5,1
"Costa Rica",763,5,4,4,4,0,2
"England",763,6,9,6,0,6,1
"Italy",763,6,6,5,2,3,2
"Argentina",763,7,7,5,2,3,1
"Germany",763,7,5,2,1,1,2
"France",763,8,9,9,1,8,1
"Poland",763,8,4,4,7,-3,2
"Algeria",764,1,9,7,2,5,1
"United States",764,1,4,4,4,0,2
"Mexico",764,3,9,5,2,3,1
"Brazil",764,3,6,10,5,5,2
"Netherlands",764,4,9,8,2,6,1
"Portugal",764,4,4,3,4,-1,2
"Argentina",764,5,7,3,1,2,1
"Germany",764,5,6,2,1,1,2
"Spain",764,6,9,10,2,8,1
"Costa Rica",764,6,4,3,6,-3,2
"France",764,7,7,9,1,8,1
"Korea Republic",764,7,5,5,2,3,2
"Italy",764,8,7,3,0,3,1
"Belgium",764,8,5,4,3,1,2
"Netherlands",765,1,9,7,1,6,1
"Switzerland",765,1,4,4,2,2,2
"Colombia",765,2,7,3,0,3,1
"Spain",765,2,5,2,1,1,2
"Italy",765,5,7,6,2,4,1
"Brazil",765,5,4,5,5,0,2
"Portugal",765,6,9,5,1,4,1
"Germany",765,6,6,5,5,0,2
"Belgium",765,8,9,10,0,10,1
"Croatia",765,8,6,4,4,0,2
"Qatar",766,1,7,4,1,3,1
"Senegal",766,1,6,5,3,2,2
"Brazil",766,2,9,8,1,7,1
"Japan",766,2,6,2,4,-2,2
"Argentina",766,3,7,4,1,3,1
"United States",766,3,6,3,1,2,2
"England",766,4,6,7,3,4,1
"Costa Rica",766,4,5,4,2,2,2
"Mexico",766,5,7,4,1,3,1
"Switzerland",766,5,5,4,3,1,2
"Belgium",766,7,7,9,5,4,1
"Australia",766,7,5,8,7,1,2
"Spain",766,8,7,4,2,2,1
"Algeria",766,8,5,4,2,2,2
"Wales",767,1,9,3,0,3,1
"Denmark",767,1,6,4,2,2,2
"Portugal",767,2,6,6,3,3,1
"Japan",767,2,5,4,3,1,2
"Mexico",767,3,9,9,1,8,1
"France",767,3,4,4,7,-3,2
"Germany",767,5,9,8,2,6,1
"Argentina",767,5,6,5,2,3,2
"England",767,7,7,5,1,4,1
"Korea Republic",767,7,4,3,3,0,2
"Algeria",768,1,7,2,0,2,1
"Mexico",768,1,4,5,2,3,2
"Netherlands",768,3,7,6,1,5,1
"Nigeria",768,3,4,2,5,-3,2
"France",768,5,7,3,1,2,1
"Germany",768,5,6,12,4,8,2
"United States",768,6,7,6,3,3,1
"Iran",768,6,4,5,6,-1,2
"Colombia",768,8,9,8,3,5,1
"Tunisia",768,8,4,6,5,1,2
"Colombia",769,1,7,7,1,6,1
"Qatar",769,1,4,3,4,-1,2
"Germany",769,4,7,5,2,3,1
"Argentina",769,4,6,5,3,2,2
"France",769,6,7,7,1,6,1
"Algeria",769,6,4,3,6,-3,2
"Germany",770,2,6,2,3,-1,1
"Portugal",770,2,5,4,1,3,2
"Wales",770,3,9,6,0,6,1
"Denmark",770,3,6,4,5,-1,2
"Poland",770,4,7,7,2,5,1
"Croatia",770,4,4,4,6,-2,2
"Mexico",770,5,7,6,2,4,1
"Algeria",770,5,5,3,2,1,2
"Nigeria",770,7,6,2,3,-1,1
"England",770,7,5,5,2,3,2
"France",770,8,9,5,1,4,1
"Colombia",770,8,6,4,3,1,2
"Croatia",771,1,7,4,1,3,1
"Tunisia",771,1,4,5,3,2,2
"Netherlands",771,2,5,3,1,2,1
"Switzerland",771,2,4,4,5,-1,2
"Italy",771,4,9,5,1,4,1
"Portugal",771,4,6,4,1,3,2
"Korea Republic",772,4,9,7,2,5,1
"Belgium",772,4,4,4,5,-1,2
"Iran",772,5,7,6,3,3,1
"Spain",772,5,6,6,3,3,2
"Croatia",772,6,7,2,0,2,1
"England",772,6,4,4,2,2,2
"Mexico",772,8,7,5,3,2,1
"Chile",772,8,5,2,1,1,2
"Denmark",773,1,9,13,4,9,1
"Tunisia",773,1,6,6,8,-2,2
"Italy",773,3,7,5,2,3,1
"Nigeria",773,3,5,6,4,2,2
"Spain",773,4,7,8,0,8,1
"Wales",773,4,4,2,5,-3,2
"Brazil",773,6,9,6,2,4,1
"Korea Republic",773,6,4,5,5,0,2
"Belgium",773,8,9,7,1,6,1
"Switzerland",773,8,4,2,2,0,2
"Brazil",774,4,9,5,1,4,1
"Switzerland",774,4,6,4,3,1,2
"Netherlands",774,5,7,6,4,2,1
"Poland",774,5,6,6,3,3,2
"Denmark",774,6,7,4,2,2,1
"Belgium",774,6,6,5,2,3,2
"Portugal",774,7,7,6,1,5,1
"Italy",774,7,6,4,2,2,2
"Japan",774,8,7,3,1,2,1
"Germany",774,8,6,6,3,3,2
"Italy",775,1,7,6,1,5,1
"Qatar",775,1,5,2,0,2,2
"Belgium",775,2,7,5,1,4,1
"Wales",775,2,5,3,2,1,2
"Netherlands",775,3,9,8,1,7,1
"Australia",775,3,6,3,4,-1,2
"Portugal",775,4,7,6,1,5,1
"Uruguay",775,4,5,5,3,2,2
"France",775,5,9,5,0,5,1
"Chile",775,5,4,4,3,1,2
"Japan",775,6,9,7,1,6,1
"Mexico",775,6,6,4,2,2,2
"Denmark",775,8,7,4,1,3,1
"Spain",775,8,5,2,1,1,2
"Germany",776,1,7,6,0,6,1
"Costa Rica",776,1,6,2,2,0,2
"United States",776,4,7,4,0,4,1
"France",776,4,5,3,2,1,2
"Italy",776,6,9,5,1,4,1
"Nigeria",776,6,6,5,4,1,2
"Denmark",776,7,7,4,2,2,1
"Spain",776,7,5,4,3,1,2
"Chile",777,1,7,2,0,2,1
"Nigeria",777,1,6,4,2,2,2
"Italy",777,2,7,4,1,3,1
"Belgium",777,2,5,6,3,3,2
"Iran",777,3,9,7,3,4,1
"United States",777,3,6,5,3,2,2
"Korea Republic",777,4,9,8,1,7,1
"Tunisia",777,4,6,5,3,2,2
"Brazil",777,6,9,12,2,10,1
"Germany",777,6,4,7,7,0,2
"Colombia",777,7,7,8,3,5,1
"Spain",777,7,4,4,7,-3,2
"Netherlands",777,8,9,7,2,5,1
"France",777,8,4,6,5,1,2
"Denmark",778,2,9,6,1,5,1
"Chile",778,2,6,3,1,2,2
"Brazil",778,4,7,3,1,2,1
"Nigeria",778,4,6,2,1,1,2
"Belgium",778,5,9,7,1,6,1
"Colombia",778,5,6,5,2,3,2
"Argentina",778,8,9,6,1,5,1
"Netherlands",778,8,6,5,3,2,2
"Italy",779,1,7,7,2,5,1
"Jamaica",779,1,4,7,7,0,2
"Belgium",779,2,9,8,1,7,1
"Germany",779,2,6,6,7,-1,2
"France",779,3,7,8,4,4,1
"Poland",779,3,4,6,4,2,2
"Spain",779,4,7,5,0,5,1
"Mexico",779,4,6,5,3,2,2
"England",779,5,9,7,2,5,1
"Croatia",779,5,4,4,3,1,2
"Brazil",779,6,9,10,4,6,1
"Switzerland",779,6,6,4,4,0,2
"Uruguay",780,1,7,5,2,3,1
"United States",780,1,6,7,5,2,2
"Italy",780,2,7,8,3,5,1
"Morocco",780,2,5,4,3,1,2
"Argentina",780,3,9,6,2,4,1
"Australia",780,3,4,3,3,0,2
"Netherlands",780,4,7,3,1,2,1
"Brazil",780,4,4,5,5,0,2
"Spain",780,6,9,6,1,5,1
"Colombia",780,6,6,5,2,3,2
"Belgium",780,7,9,8,2,6,1
"Croatia",780,7,4,2,2,0,2
"Germany",780,8,7,6,4,2,1
"Portugal",780,8,4,9,5,4,2
"Chile",781,2,9,3,0,3,1
"Spain",781,2,6,4,3,1,2
"Portugal",781,4,7,4,1,3,1
"Mexico",781,4,5,2,1,1,2
"Argentina",781,5,9,7,3,4,1
"Germany",781,5,4,7,7,0,2
"Brazil",781,7,7,6,2,4,1
"Japan",781,7,5,3,2,1,2
"Australia",781,8,7,5,1,4,1
"Belgium",781,8,5,4,3,1,2
"Spain",782,8,9,10,2,8,1
"Costa Rica",782,8,4,3,4,-1,2
"Germany",783,2,9,9,0,9,1
"Portugal",783,2,6,4,1,3,2
"Belgium",783,3,7,7,3,4,1
"Italy",783,3,4,4,3,1,2
"Spain",783,5,7,3,0,3,1
"Uruguay",783,5,5,3,1,2,2
"Croatia",783,6,7,9,2,7,1
"Argentina",783,6,5,7,3,4,2
"Netherlands",784,2,7,8,3,5,1
"Korea Republic",784,2,6,4,5,-1,2
"Spain",784,3,9,8,0,8,1
"Uruguay",784,3,6,7,4,3,2
"Wales",784,5,7,5,2,3,1
"Brazil",784,5,4,4,4,0,2
"Argentina",784,6,7,3,1,2,1
"Australia",784,6,6,4,3,1,2
"Portugal",784,7,9,8,1,7,1
"Colombia",784,7,6,5,3,2,2
"Croatia",784,8,7,5,2,3,1
"Algeria",784,8,5,4,1,3,2
"Netherlands",785,1,9,4,0,4,1
"Algeria",785,1,4,1,1,0,2
"Argentina",785,2,9,8,1,7,1
"Nigeria",785,2,6,7,5,2,2
"Portugal",785,3,7,2,0,2,1
"Uruguay",785,3,6,3,2,1,2
"Iran",785,4,7,4,1,3,1
"France",785,4,4,3,4,-1,2
"Poland",785,6,7,5,1,4,1
"Germany",785,6,5,6,3,3,2
"Spain",785,7,7,6,2,4,1
"Colombia",785,7,6,4,3,1,2
"Brazil",785,8,9,6,1,5,1
"Denmark",785,8,6,6,3,3,2
"Colombia",786,1,7,5,3,2,1
"Algeria",786,1,4,5,5,0,2
"Argentina",786,2,7,5,2,3,1
"Croatia",786,2,4,3,4,-1,2
"Portugal",786,5,9,5,1,4,1
"Chile",786,5,4,3,2,1,2
"Belgium",786,6,9,6,2,4,1
"Denmark",786,6,4,4,4,0,2
"France",786,7,9,6,0,6,1
"Germany",786,7,6,7,4,3,2
"Spain",786,8,9,8,2,6,1
"Uruguay",786,8,4,2,2,0,2
"Colombia",787,1,7,6,2,4,1
"Qatar",787,1,4,5,5,0,2
"Belgium",787,4,9,11,4,7,1
"Australia",787,4,4,2,2,0,2
"Portugal",787,6,7,5,1,4,1
"Switzerland",787,6,5,6,3,3,2
"England",787,8,7,7,4,3,1
"Italy",787,8,5,5,3,2,2
"Germany",788,1,7,6,1,5,1
"Morocco",788,1,4,2,2,0,2
"Iran",788,2,7,5,1,4,1
"Argentina",788,2,6,3,2,1,2
"Italy",788,3,7,5,2,3,1
"France",788,3,5,6,2,4,2
"Colombia",788,5,7,7,3,4,1
"Portugal",788,5,5,3,0,3,2
"Spain",788,8,7,5,0,5,1
"Australia",788,8,5,2,0,2,2
"Netherlands",789,2,9,5,2,3,1
"Argentina",789,2,6,5,1,4,2
"Iran",789,3,7,5,2,3,1
"Uruguay",789,3,4,5,5,0,2
"Brazil",789,4,9,8,0,8,1
"Germany",789,4,4,5,4,1,2
"Belgium",789,6,7,7,2,5,1
"Mexico",789,6,6,6,5,1,2
"France",789,7,9,8,1,7,1
"Japan",789,7,6,2,1,1,2
"Portugal",789,8,9,5,1,4,1
"Italy",789,8,4,4,3,1,2
"Mexico",790,2,9,6,1,5,1
"Belgium",790,2,6,6,3,3,2
"Argentina",790,3,7,7,1,6,1
"Italy",790,3,4,8,3,5,2
"Brazil",790,4,7,7,1,6,1
"Croatia",790,4,6,5,5,0,2
"Spain",790,6,7,3,1,2,1
"Japan",790,6,4,5,5,0,2
"England",790,7,5,5,3,2,1
"Iran",790,7,4,7,7,0,2
"Portugal",790,8,9,5,2,3,1
"Uruguay",790,8,6,5,2,3,2
"Spain",791,2,9,5,1,4,1
"Germany",791,2,4,3,4,-1,2
"Japan",791,4,7,2,0,2,1
"Brazil",791,4,6,4,2,2,2
"Colombia",791,5,7,5,2,3,1
"Belgium",791,5,6,10,4,6,2
"Korea Republic",791,6,7,4,1,3,1
"Denmark",791,6,5,5,4,1,2
"Italy",791,7,9,9,2,7,1
"Argentina",791,7,6,7,2,5,2
"Portugal",792,2,9,9,2,7,1
"Colombia",792,2,6,3,4,-1,2
"Belgium",792,3,9,7,1,6,1
"Tunisia",792,3,6,3,3,0,2
"Brazil",792,4,7,4,2,2,1
"Italy",792,4,5,4,2,2,2
"Switzerland",792,6,7,4,0,4,1
"England",792,6,6,4,1,3,2
"Spain",792,8,9,8,1,7,1
"Germany",792,8,6,5,2,3,2
"Uruguay",793,1,7,4,0,4,1
"Qatar",793,1,5,5,2,3,2
"France",793,3,9,11,3,8,1
"Italy",793,3,4,5,5,0,2
"England",793,5,7,8,1,7,1
"Croatia",793,5,4,3,3,0,2
"Italy",794,1,9,6,0,6,1
"United States",794,1,4,4,4,0,2
"Spain",794,2,7,2,0,2,1
"Senegal",794,2,5,2,1,1,2
"Argentina",794,3,7,5,2,3,1
"Denmark",794,3,5,4,1,3,2
"Brazil",794,5,9,10,1,9,1
"Poland",794,5,4,2,4,-2,2
"Uruguay",794,6,9,8,3,5,1
"Portugal",794,6,6,4,3,1,2
"Japan",795,2,7,3,0,3,1
"England",795,2,6,5,5,0,2
"Brazil",795,3,7,5,2,3,1
"Tunisia",795,3,4,2,2,0,2
"Poland",795,4,9,6,1,5,1
"Argentina",795,4,6,2,1,1,2
"Spain",795,5,7,6,2,4,1
"Wales",795,5,6,6,3,3,2
"Australia",795,6,7,5,3,2,1
"France",795,6,5,7,4,3,2
"Portugal",795,7,7,6,1,5,1
"Costa Rica",795,7,5,3,2,1,2
"Brazil",796,4,9,7,0,7,1
"Korea Republic",796,4,4,4,6,-2,2
"England",796,5,7,7,3,4,1
"Wales",796,5,5,7,6,1,2
"France",796,6,7,9,2,7,1
"Poland",796,6,4,6,7,-1,2
"Netherlands",796,8,9,7,0,7,1
"Argentina",796,8,6,6,2,4,2
"France",797,3,9,8,1,7,1
"Chile",797,3,4,3,4,-1,2
"Germany",797,5,9,6,1,5,1
"Portugal",797,5,6,8,4,4,2
"Brazil",797,6,7,4,0,4,1
"Netherlands",797,6,5,3,1,2,2
"Spain",797,7,7,5,1,4,1
"Switzerland",797,7,5,3,2,1,2
"Netherlands",798,3,7,6,3,3,1
"Switzerland",798,3,6,7,4,3,2
"France",798,5,9,8,1,7,1
"Denmark",798,5,6,7,2,5,2
"Denmark",799,1,7,3,0,3,1
"Qatar",799,1,4,2,3,-1,2
"Belgium",799,2,9,6,1,5,1
"Uruguay",799,2,6,4,4,0,2
"Colombia",799,3,7,5,1,4,1
"Algeria",799,3,4,5,5,0,2
"Germany",799,4,7,9,0,9,1
"Argentina",799,4,6,4,4,0,2
"Nigeria",799,6,9,5,2,3,1
"Chile",799,6,6,6,3,3,2
"Mexico",800,1,7,4,1,3,1
"Algeria",800,1,6,4,2,2,2
"France",800,2,7,6,3,3,1
"Italy",800,2,6,5,4,1,2
"Portugal",800,4,7,4,0,4,1
"Nigeria",800,4,4,2,2,0,2
"Belgium",800,6,9,8,2,6,1
"Germany",800,6,6,9,5,4,2
"Korea Republic",800,8,7,2,0,2,1
"Croatia",800,8,3,0,0,0,2
"Netherlands",801,1,9,8,0,8,1
"Qatar",801,1,6,5,6,-1,2
"Brazil",801,2,7,6,3,3,1
"Japan",801,2,5,2,1,1,2
"Belgium",801,6,7,8,0,8,1
"Mexico",801,6,5,4,2,2,2
"Germany",802,2,7,4,1,3,1
"Spain",802,2,5,3,2,1,2
"Brazil",802,3,7,8,2,6,1
"Algeria",802,3,4,1,5,-4,2
"Australia",802,4,7,3,0,3,1
"Switzerland",802,4,4,5,4,1,2
"England",802,5,9,9,4,5,1
"United States",802,5,6,7,7,0,2
"Belgium",802,6,7,4,2,2,1
"Croatia",802,6,6,3,2,1,2
"Portugal",802,7,7,5,3,2,1
"Netherlands",802,7,4,3,2,1,2
"Senegal",803,2,7,4,2,2,1
"Korea Republic",803,2,5,3,1,2,2
"Brazil",803,3,9,5,1,4,1
"Jamaica",803,3,4,2,1,1,2
"Argentina",803,4,7,8,2,6,1
"Algeria",803,4,4,3,6,-3,2
"Uruguay",803,6,9,6,1,5,1
"Portugal",803,6,6,3,4,-1,2
"France",803,7,9,12,1,11,1
"Mexico",803,7,4,2,4,-2,2
"Belgium",803,8,9,9,3,6,1
"Japan",803,8,4,5,4,1,2
"Argentina",804,3,7,6,3,3,1
"Australia",804,3,4,4,3,1,2
"Poland",804,4,9,6,2,4,1
"Denmark",804,4,4,3,2,1,2
"Germany",804,6,9,4,1,3,1
"Spain",804,6,6,11,7,4,2
"Uruguay",804,7,6,5,3,2,1
"France",804,7,5,3,2,1,2
"Colombia",805,2,7,3,1,2,1
"Korea Republic",805,2,5,5,2,3,2
"Netherlands",805,3,9,6,1,5,1
"England",805,3,6,4,3,1,2
"Japan",805,5,9,5,1,4,1
"Portugal",805,5,6,5,3,2,2
"Germany",805,7,9,8,2,6,1
"Wales",805,7,6,2,1,1,2
"Brazil",805,8,7,2,0,2,1
"Croatia",805,8,4,5,3,2,2
"Portugal",806,2,7,3,1,2,1
"Netherlands",806,2,6,3,1,2,2
"Switzerland",806,3,7,4,1,3,1
"Uruguay",806,3,6,3,2,1,2
"Italy",806,4,7,4,1,3,1
"Belgium",806,4,6,10,2,8,2
"Uruguay",807,1,7,4,2,2,1
"Qatar",807,1,6,4,1,3,2
"Germany",807,2,7,4,2,2,1
"Portugal",807,2,5,6,3,3,2
"Brazil",807,5,7,8,3,5,1
"Netherlands",807,5,5,5,2,3,2
"Belgium",807,7,9,7,2,5,1
"Croatia",807,7,4,3,3,0,2
"Italy",807,8,7,8,3,5,1
"France",807,8,5,8,4,4,2
"Croatia",808,2,9,5,0,5,1
"France",808,2,6,5,2,3,2
"Colombia",808,3,6,6,5,1,1
"Wales",808,3,5,6,4,2,2
"Denmark",808,4,9,8,1,7,1
"England",808,4,4,5,6,-1,2
"Mexico",808,5,7,4,1,3,1
"Argentina",808,5,5,2,1,1,2
"Japan",808,6,7,4,1,3,1
"Spain",808,6,5,5,1,4,2
"Belgium",808,7,7,5,1,4,1
"Germany",808,7,6,7,3,4,2
"Brazil",808,8,9,13,4,9,1
"Switzerland",808,8,4,4,4,0,2
"Colombia",809,1,9,6,0,6,1
"Qatar",809,1,6,5,1,4,2
"Argentina",809,2,7,3,1,2,1
"Tunisia",809,2,3,1,1,0,2
"Brazil",809,5,9,8,3,5,1
"Nigeria",809,5,4,3,3,0,2
"England",809,7,7,3,0,3,1
"Senegal",809,7,5,5,1,4,2
"Italy",809,8,7,5,3,2,1
"Belgium",809,8,4,4,4,0,2
"Portugal",810,2,9,5,1,4,1
"Australia",810,2,6,3,1,2,2
"Brazil",810,3,9,8,0,8,1
"Denmark",810,3,4,2,1,1,2
"Argentina",810,6,9,9,1,8,1
"Croatia",810,6,4,4,4,0,2
"England",810,7,9,6,1,5,1
"Italy",810,7,6,8,1,7,2
"France",811,5,7,5,1,4,1
"Colombia",811,5,5,4,2,2,2
"Tunisia",811,6,7,3,1,2,1
"Netherlands",811,6,5,3,2,1,2
"Brazil",811,7,9,4,1,3,1
"Wales",811,7,6,6,3,3,2
"Iran",811,8,7,5,3,2,1
"England",811,8,5,6,3,3,2
"Colombia",812,3,9,6,2,4,1
"Spain",812,3,6,5,3,2,2
"England",812,4,7,6,1,5,1
"Croatia",812,4,5,4,3,1,2
"Nigeria",812,5,6,4,3,1,1
"Portugal",812,5,5,3,2,1,2
"Netherlands",812,8,7,7,2,5,1
"Belgium",812,8,4,2,3,-1,2
"Croatia",813,1,9,8,5,3,1
"United States",813,1,4,5,5,0,2
"Senegal",813,2,7,3,1,2,1
"Portugal",813,2,4,2,2,0,2
"Korea Republic",813,3,9,6,1,5,1
"England",813,3,4,3,3,0,2
"Uruguay",813,5,9,8,0,8,1
"Japan",813,5,4,2,5,-3,2
"Argentina",813,7,7,5,3,2,1
"Costa Rica",813,7,4,5,5,0,2
"France",813,8,9,10,3,7,1
"Switzerland",813,8,6,6,5,1,2
"Belgium",814,2,9,7,0,7,1
"Germany",814,2,6,7,1,6,2
"Italy",814,3,9,6,0,6,1
"Brazil",814,3,6,8,2,6,2
"Colombia",814,7,7,6,1,5,1
"Portugal",814,7,6,5,3,2,2
"Denmark",815,2,9,6,1,5,1
"Portugal",815,2,6,6,3,3,2
"Spain",815,3,9,10,2,8,1
"Iran",815,3,4,3,4,-1,2
"Korea Republic",815,5,9,6,1,5,1
"Argentina",815,5,4,6,5,1,2
"Belgium",815,7,9,7,1,6,1
"Italy",815,7,6,6,3,3,2
"Algeria",815,8,9,5,1,4,1
"Switzerland",815,8,4,2,2,0,2
"Netherlands",816,1,9,7,0,7,1
"Costa Rica",816,1,4,3,2,1,2
"Belgium",816,2,7,6,2,4,1
"Germany",816,2,6,5,3,2,2
"Iran",816,4,6,5,3,2,1
"Spain",816,4,5,3,2,1,2
"Italy",816,5,9,8,1,7,1
"Argentina",816,5,6,6,2,4,2
"Uruguay",816,7,7,6,1,5,1
"Switzerland",816,7,5,5,1,4,2
"Qatar",817,1,7,6,1,5,1
"Croatia",817,1,6,4,2,2,2
"Germany",817,2,6,5,4,1,1
"Belgium",817,2,5,2,1,1,2
"France",817,3,9,6,0,6,1
"Uruguay",817,3,6,7,3,4,2
"Iran",817,4,6,5,3,2,1
"Italy",817,4,5,5,3,2,2
"England",817,5,9,11,2,9,1
"Nigeria",817,5,4,3,5,-2,2
"Denmark",817,7,7,4,1,3,1
"Portugal",817,7,4,5,3,2,2
"Spain",817,8,7,5,1,4,1
"Mexico",817,8,5,3,2,1,2
"Uruguay",818,2,9,6,1,5,1
"France",818,2,6,8,1,7,2
"Spain",818,4,7,6,3,3,1
"Senegal",818,4,4,3,2,1,2
"Portugal",818,5,7,6,3,3,1
"Colombia",818,5,5,5,3,2,2
"Denmark",818,6,7,4,2,2,1
"Belgium",818,6,6,7,2,5,2
"Brazil",818,7,7,3,1,2,1
"Korea Republic",818,7,6,4,3,1,2
"Belgium",819,2,7,9,5,4,1
"Japan",819,2,4,5,5,0,2
"Mexico",819,4,9,7,3,4,1
"Argentina",819,4,4,3,4,-1,2
"Croatia",819,7,9,7,0,7,1
"England",819,7,6,4,1,3,2
"Spain",819,8,9,5,1,4,1
"Colombia",819,8,4,3,2,1,2
"Spain",820,2,7,3,1,2,1
"Colombia",820,2,6,2,1,1,2
"Mexico",820,3,9,5,1,4,1
"Argentina",820,3,6,5,2,3,2
"Brazil",820,6,7,3,0,3,1
"Germany",820,6,6,5,1,4,2
"England",820,7,7,3,0,3,1
"Uruguay",820,7,5,2,1,1,2
"Belgium",820,8,9,6,2,4,1
"Italy",820,8,4,2,2,0,2
"Jamaica",821,1,6,5,5,0,1
"Denmark",821,1,5,4,1,3,2
"Portugal",821,2,9,8,0,8,1
"Australia",821,2,6,4,3,1,2
"Italy",821,5,7,4,2,2,1
"Spain",821,5,5,5,4,1,2
"Uruguay",821,7,9,4,0,4,1
"Belgium",821,7,6,8,2,6,2
"France",821,8,7,6,3,3,1
"Chile",821,8,4,4,4,0,2
"Croatia",822,1,9,7,0,7,1
"Switzerland",822,1,6,8,5,3,2
"Brazil",822,3,7,8,6,2,1
"Senegal",822,3,4,4,4,0,2
"France",822,4,7,6,3,3,1
"Korea Republic",822,4,4,6,3,3,2
"Denmark",822,7,7,4,1,3,1
"Argentina",822,7,6,5,2,3,2
"Uruguay",822,8,9,8,0,8,1
"Belgium",822,8,4,3,5,-2,2
"Brazil",823,2,7,10,2,8,1
"Croatia",823,2,6,3,2,1,2
"Germany",823,3,7,3,1,2,1
"Argentina",823,3,5,3,2,1,2
"Portugal",823,4,9,4,0,4,1
"Wales",823,4,4,1,1,0,2
"Spain",823,5,6,6,3,3,1
"Mexico",823,5,5,3,2,1,2
"France",823,6,7,7,2,5,1
"Korea Republic",823,6,5,5,2,3,2
"Uruguay",823,7,9,9,1,8,1
"Belgium",823,7,6,6,3,3,2
"Iran",823,8,7,7,1,6,1
"England",823,8,4,2,4,-2,2
"Uruguay",824,1,7,7,2,5,1
"Costa Rica",824,1,5,5,3,2,2
"Argentina",824,2,9,8,3,5,1
"Germany",824,2,6,6,5,1,2
"England",824,3,9,5,1,4,1
"Australia",824,3,6,2,2,0,2
"France",824,7,9,4,0,4,1
"Italy",824,7,4,5,2,3,2
"Italy",825,1,7,6,1,5,1
"United States",825,1,4,1,4,-3,2
"Argentina",825,2,9,8,2,6,1
"Japan",825,2,6,7,6,1,2
"Australia",825,3,9,5,0,5,1
"England",825,3,6,5,2,3,2
"Germany",825,4,7,6,2,4,1
"Switzerland",825,4,4,2,2,0,2
"Uruguay",825,7,9,8,3,5,1
"Belgium",825,7,4,4,4,0,2
"Germany",826,1,9,7,1,6,1
"Senegal",826,1,6,7,3,4,2
"Netherlands",826,2,7,3,1,2,1
"Poland",826,2,6,5,4,1,2
"Colombia",826,5,9,9,2,7,1
"Belgium",826,5,6,10,4,6,2
"France",826,6,7,8,3,5,1
"Uruguay",826,6,5,5,3,2,2
"Mexico",826,7,7,6,4,2,1
"England",826,7,6,8,3,5,2
"Italy",826,8,7,6,4,2,1
"Wales",826,8,5,6,5,1,2
"Italy",827,1,7,5,3,2,1
"United States",827,1,4,3,2,1,2
"Spain",827,2,9,9,2,7,1
"Netherlands",827,2,6,6,5,1,2
"France",827,3,7,3,0,3,1
"Denmark",827,3,4,2,3,-1,2
"Germany",827,4,7,6,2,4,1
"Brazil",827,4,6,7,1,6,2
"Belgium",827,6,9,4,1,3,1
"Colombia",827,6,6,7,2,5,2
"England",827,7,7,6,2,4,1
"Uruguay",827,7,4,2,2,0,2
"Croatia",827,8,7,5,2,3,1
"Morocco",827,8,6,4,3,1,2
"Spain",828,3,6,7,1,6,1
"Chile",828,3,5,2,1,1,2
"France",828,8,7,5,2,3,1
"Senegal",828,8,5,2,1,1,2
"Wales",829,1,7,4,2,2,1
"Costa Rica",829,1,6,2,1,1,2
"Australia",829,2,7,7,4,3,1
"Portugal",829,2,6,7,4,3,2
"Argentina",829,4,7,7,3,4,1
"Nigeria",829,4,4,4,4,0,2
"Brazil",829,5,7,7,2,5,1
"Korea Republic",829,5,3,3,3,0,2
"France",829,6,9,6,2,4,1
"Iran",829,6,4,4,3,1,2
"Belgium",829,7,9,5,0,5,1
"United States",829,7,6,3,3,0,2
"Spain",829,8,7,6,2,4,1
"Netherlands",829,8,6,9,3,6,2
"Germany",830,1,6,4,2,2,1
"Costa Rica",830,1,5,2,1,1,2
"Poland",830,2,7,5,1,4,1
"France",830,2,5,1,0,1,2
"Portugal",830,3,7,3,1,2,1
"Morocco",830,3,4,1,2,-1,2
"Belgium",830,5,7,4,0,4,1
"United States",830,5,4,1,2,-1,2
"Uruguay",830,6,9,6,1,5,1
"Spain",830,6,4,3,4,-1,2
"Netherlands",830,7,7,6,2,4,1
"Argentina",830,7,4,4,2,2,2
"Spain",831,5,9,5,2,3,1
"Germany",831,5,6,5,1,4,2
"Brazil",831,6,7,6,2,4,1
"Denmark",831,6,5,5,3,2,2
"Italy",831,8,7,6,1,5,1
"Portugal",831,8,4,4,4,0,2
"Italy",832,1,9,10,1,9,1
"Chile",832,1,4,3,6,-3,2
"Argentina",832,2,9,5,2,3,1
"Mexico",832,2,6,6,3,3,2
"Switzerland",832,5,9,7,3,4,1
"Portugal",832,5,6,9,4,5,2
"Brazil",832,7,9,5,0,5,1
"United States",832,7,6,4,3,1,2
"Germany",832,8,9,10,3,7,1
"England",832,8,6,6,5,1,2
"Wales",833,1,9,6,1,5,1
"Colombia",833,1,6,5,2,3,2
"Argentina",833,2,9,5,1,4,1
"Japan",833,2,6,7,3,4,2
"Belgium",833,5,9,6,1,5,1
"Denmark",833,5,6,4,2,2,2
"Spain",833,6,9,8,2,6,1
"Italy",833,6,6,5,3,2,2
"Croatia",833,8,7,4,0,4,1
"France",833,8,6,6,3,3,2
"Wales",834,1,7,6,3,3,1
"Qatar",834,1,6,4,2,2,2
"Senegal",834,2,9,3,0,3,1
"Korea Republic",834,2,4,4,3,1,2
"France",834,4,7,5,0,5,1
"Uruguay",834,4,6,3,3,0,2
"Chile",834,5,9,6,2,4,1
"Germany",834,5,4,4,4,0,2
"Spain",834,6,6,4,3,1,1
"Switzerland",834,6,5,6,5,1,2
"Portugal",834,7,7,8,2,6,1
"Netherlands",834,7,5,3,2,1,2
"Belgium",834,8,7,9,2,7,1
"Colombia",834,8,4,2,2,0,2
"Denmark",835,1,7,4,1,3,1
"Qatar",835,1,5,3,1,2,2
"Switzerland",835,2,9,6,2,4,1
"Australia",835,2,6,3,2,1,2
"Spain",835,3,7,3,1,2,1
"Korea Republic",835,3,6,4,2,2,2
"Germany",835,6,9,7,2,5,1
"Belgium",835,6,6,6,3,3,2
"Netherlands",835,7,9,5,0,5,1
"Argentina",835,7,6,6,6,0,2
"Italy",835,8,7,6,1,5,1
"Wales",835,8,6,4,2,2,2
"Portugal",836,2,7,6,1,5,1
"Japan",836,2,5,2,1,1,2
"Brazil",836,3,9,6,1,5,1
"Iran",836,3,6,4,2,2,2
"Spain",836,4,9,5,0,5,1
"Australia",836,4,4,2,1,1,2
"Chile",836,6,9,6,0,6,1
"England",836,6,6,8,4,4,2
"Switzerland",836,8,7,4,1,3,1
"Colombia",836,8,5,3,2,1,2
"Poland",837,1,9,4,0,4,1
"Italy",837,1,6,4,1,3,2
"Netherlands",837,2,7,5,0,5,1
"Japan",837,2,4,4,4,0,2
"Uruguay",837,4,7,8,1,7,1
"Switzerland",837,4,4,2,2,0,2
"Netherlands",838,1,9,6,0,6,1
"Jamaica",838,1,6,7,1,6,2
"England",838,2,7,5,0,5,1
"Mexico",838,2,5,2,1,1,2
"Argentina",838,3,7,4,2,2,1
"Wales",838,3,4,4,4,0,2
"France",838,4,7,9,1,8,1
"Morocco",838,4,6,3,4,-1,2
"Brazil",838,6,7,8,3,5,1
"Germany",838,6,5,4,3,1,2
"Portugal",838,8,9,8,3,5,1
"Italy",838,8,4,6,6,0,2
"Denmark",839,2,9,9,1,8,1
"Switzerland",839,2,6,5,2,3,2
"Brazil",839,3,9,7,2,5,1
"Germany",839,3,6,4,4,0,2
"Colombia",839,5,7,6,2,4,1
"Portugal",839,5,5,5,1,4,2
"Algeria",839,6,5,5,1,4,1
"Croatia",839,6,4,3,5,-2,2
"Italy",839,7,9,6,0,6,1
"England",839,7,6,8,7,1,2
"Belgium",840,3,7,7,0,7,1
"Morocco",840,3,4,4,8,-4,2
"Japan",840,4,7,6,3,3,1
"Brazil",840,4,6,11,4,7,2
"Argentina",840,5,6,7,3,4,1
"Mexico",840,5,5,4,2,2,2
"Italy",841,1,7,3,1,2,1
"Qatar",841,1,6,3,2,1,2
"Brazil",841,3,9,8,2,6,1
"Croatia",841,3,4,4,5,-1,2
"Netherlands",841,4,7,6,2,4,1
"Spain",841,4,6,5,3,2,2
"Belgium",841,5,9,7,1,6,1
"Colombia",841,5,6,6,5,1,2
"Wales",841,6,7,6,1,5,1
"Germany",841,6,5,5,2,3,2
"Senegal",842,2,9,8,4,4,1
"Uruguay",842,2,6,5,3,2,2
"Germany",842,3,7,4,1,3,1
"Japan",842,3,5,4,2,2,2
"Spain",842,4,7,9,3,6,1
"Morocco",842,4,6,3,3,0,2
"Argentina",842,7,6,3,3,0,1
"Switzerland",842,7,5,3,1,2,2
"Italy",842,8,7,6,2,4,1
"Korea Republic",842,8,4,3,2,1,2
"Italy",843,2,9,6,3,3,1
"Brazil",843,2,6,5,3,2,2
"Wales",843,3,7,6,1,5,1
"Argentina",843,3,5,5,3,2,2
"France",843,5,7,7,1,6,1
"Chile",843,5,5,3,2,1,2
"Belgium",843,6,9,10,1,9,1
"Tunisia",843,6,6,4,6,-2,2
"Chile",844,1,7,9,2,7,1
"Denmark",844,1,4,6,7,-1,2
"Uruguay",844,2,7,5,2,3,1
"Spain",844,2,5,3,1,2,2
"Poland",844,8,9,6,1,5,1
"Belgium",844,8,6,5,1,4,2
"Denmark",845,1,9,7,2,5,1
"Jamaica",845,1,4,5,5,0,2
"England",845,3,7,5,2,3,1
"Switzerland",845,3,4,3,3,0,2
"Italy",845,4,7,7,1,6,1
"Portugal",845,4,6,6,3,3,2
"Belgium",845,6,9,5,2,3,1
"Iran",845,6,4,2,2,0,2
"Uruguay",845,8,7,4,1,3,1
"France",845,8,6,7,2,5,2
"Mexico",846,1,7,8,3,5,1
"Qatar",846,1,6,3,4,-1,2
"Senegal",846,2,9,5,2,3,1
"Australia",846,2,4,2,1,1,2
"Belgium",846,3,7,8,2,6,1
"Japan",846,3,6,3,2,1,2
"Wales",846,7,6,3,5,-2,1
"Brazil",846,7,5,6,2,4,2
"United States",846,8,7,4,2,2,1
"Colombia",846,8,4,5,2,3,2
"Tunisia",847,1,9,3,0,3,1
"Italy",847,1,4,5,3,2,2
"Mexico",847,2,6,8,4,4,1
"Wales",847,2,5,4,3,1,2
"Spain",847,3,7,11,3,8,1
"Chile",847,3,6,5,5,0,2
"Colombia",847,4,7,4,2,2,1
"Portugal",847,4,4,4,3,1,2
"Italy",848,2,6,5,2,3,1
"Tunisia",848,2,5,4,3,1,2
"Germany",848,3,7,3,1,2,1
"Argentina",848,3,4,1,1,0,2
"Senegal",848,5,7,5,3,2,1
"Colombia",848,5,5,5,4,1,2
"Netherlands",848,7,7,4,1,3,1
"Spain",848,7,6,5,1,4,2
"Spain",849,2,9,9,5,4,1
"Italy",849,2,6,7,5,2,2
"Brazil",849,5,9,5,1,4,1
"Germany",849,5,6,10,3,7,2
"Belgium",849,7,7,9,1,8,1
"Mexico",849,7,4,2,3,-1,2
"Portugal",850,2,7,5,2,3,1
"Italy",850,2,5,4,1,3,2
"Croatia",850,3,9,4,1,3,1
"Belgium",850,3,6,5,4,1,2
"England",850,5,7,5,3,2,1
"Japan",850,5,6,6,4,2,2
"France",850,6,7,6,3,3,1
"Wales",850,6,6,6,5,1,2
"Spain",850,7,9,11,3,8,1
"Netherlands",850,7,6,6,3,3,2
"Poland",851,1,9,6,2,4,1
"Qatar",851,1,6,5,5,0,2
"Netherlands",851,4,9,10,3,7,1
"Portugal",851,4,6,6,4,2,2
"Belgium",851,5,7,6,2,4,1
"Korea Republic",851,5,6,4,5,-1,2
"Spain",851,6,7,7,3,4,1
"Denmark",851,6,5,6,4,2,2
"France",851,8,9,5,0,5,1
"Mexico",851,8,6,3,4,-1,2
"Uruguay",852,1,7,5,1,4,1
"United States",852,1,5,3,2,1,2
"Croatia",852,2,7,6,3,3,1
"Spain",852,2,6,8,3,5,2
"Denmark",852,3,9,7,2,5,1
"England",852,3,6,10,2,8,2
"Brazil",852,4,7,6,2,4,1
"Switzerland",852,4,4,3,3,0,2
"Argentina",852,5,9,10,0,10,1
"Italy",852,5,6,3,1,2,2
"Belgium",852,6,7,2,0,2,1
"Colombia",852,6,4,1,1,0,2
"Poland",852,8,5,5,4,1,1
"Mexico",852,8,4,7,4,3,2
"Netherlands",853,1,7,3,0,3,1
"Switzerland",853,1,6,4,1,3,2
"Denmark",853,3,6,6,3,3,1
"Algeria",853,3,5,3,2,1,2
"Belgium",853,6,7,4,1,3,1
"Chile",853,6,4,1,2,-1,2
"Italy",853,7,9,7,2,5,1
"Japan",853,7,6,5,3,2,2
"Mexico",854,4,9,10,1,9,1
"Korea Republic",854,4,6,6,3,3,2
"Belgium",854,7,7,4,0,4,1
"Switzerland",854,7,5,4,2,2,2
"Colombia",855,1,7,9,2,7,1
"Qatar",855,1,4,1,2,-1,2
"Italy",855,3,7,4,1,3,1
"Argentina",855,3,4,2,2,0,2
"Belgium",855,4,7,3,0,3,1
"United States",855,4,5,1,0,1,2
"Mexico",855,6,7,4,1,3,1
"Chile",855,6,5,6,4,2,2
"Japan",855,8,9,3,0,3,1
"England",855,8,4,5,3,2,2
"Netherlands",856,2,7,3,1,2,1
"Australia",856,2,4,2,3,-1,2
"Spain",856,3,7,11,4,7,1
"Japan",856,3,6,5,4,1,2
"Belgium",856,4,9,7,1,6,1
"Colombia",856,4,6,5,3,2,2
"Wales",856,6,9,8,2,6,1
"Korea Republic",856,6,4,3,3,0,2
"France",856,8,9,10,2,8,1
"Switzerland",856,8,4,1,4,-3,2
"Spain",857,3,7,10,2,8,1
"Australia",857,3,5,7,6,1,2
"Portugal",857,6,7,8,2,6,1
"Colombia",857,6,4,3,3,0,2
"Belgium",857,7,9,7,0,7,1
"Wales",857,7,4,1,3,-2,2
"Brazil",858,2,9,6,2,4,1
"Japan",858,2,6,5,2,3,2
"Germany",858,3,9,7,0,7,1
"Tunisia",858,3,4,3,6,-3,2
"Croatia",858,6,9,6,2,4,1
"Chile",858,6,6,2,2,0,2
"Italy",858,7,7,8,0,8,1
"England",858,7,5,2,0,2,2
"Poland",858,8,9,6,3,3,1
"France",858,8,6,6,2,4,2
"Colombia",859,1,7,4,0,4,1
"Nigeria",859,1,4,2,3,-1,2
"England",859,2,9,9,2,7,1
"Jamaica",859,2,6,4,5,-1,2
"Switzerland",859,3,7,5,2,3,1
"Germany",859,3,4,4,7,-3,2
"Belgium",859,4,9,12,1,11,1
"Mexico",859,4,4,3,5,-2,2
"Senegal",859,5,7,6,4,2,1
"Argentina",859,5,5,4,3,1,2
"Italy",859,6,9,10,0,10,1
"Brazil",859,6,6,6,1,5,2
"Morocco",859,8,9,4,1,3,1
"Portugal",859,8,4,2,2,0,2
"Senegal",860,1,7,8,3,5,1
"Qatar",860,1,5,9,3,6,2
"Netherlands",860,2,9,6,3,3,1
"United States",860,2,4,4,2,2,2
"Mexico",860,3,9,6,1,5,1
"Nigeria",860,3,4,2,4,-2,2
"Belgium",860,6,9,13,4,9,1
"Australia",860,6,6,6,8,-2,2
"Argentina",860,7,9,12,3,9,1
"Wales",860,7,4,3,6,-3,2
"Croatia",860,8,7,3,1,2,1
"France",860,8,6,4,2,2,2
"Chile",861,3,7,3,0,3,1
"Belgium",861,3,6,4,1,3,2
"Portugal",861,4,9,4,1,3,1
"Colombia",861,4,4,6,4,2,2
"Japan",861,5,7,5,2,3,1
"Argentina",861,5,4,2,2,0,2
"Germany",862,1,7,5,2,3,1
"Qatar",862,1,4,3,3,0,2
"Colombia",863,1,9,10,0,10,1
"Jamaica",863,1,4,1,4,-3,2
"Argentina",863,3,7,4,1,3,1
"Netherlands",863,3,4,5,4,1,2
"France",863,5,7,5,3,2,1
"Denmark",863,5,6,3,2,1,2
"Belgium",863,6,7,6,3,3,1
"Switzerland",863,6,5,1,0,1,2
"England",863,7,7,6,2,4,1
"Costa Rica",863,7,4,4,4,0,2
"Colombia",864,1,7,4,0,4,1
"Switzerland",864,1,6,5,3,2,2
"Argentina",864,2,7,6,1,5,1
"Australia",864,2,4,1,1,0,2
"Belgium",864,4,7,5,2,3,1
"Uruguay",864,4,6,3,2,1,2
"Mexico",864,6,7,4,2,2,1
"Spain",864,6,5,4,1,3,2
"Japan",864,8,5,5,3,2,1
"England",864,8,4,2,2,0,2
"Qatar",865,1,7,5,3,2,1
"Germany",865,1,6,6,4,2,2
"Switzerland",865,4,7,6,2,4,1
"Uruguay",865,4,5,5,3,2,2
"England",865,5,7,7,0,7,1
"Colombia",865,5,4,2,3,-1,2
"United States",865,6,7,4,1,3,1
"Italy",865,6,5,5,3,2,2
"Belgium",865,8,9,8,1,7,1
"Croatia",865,8,6,3,4,-1,2
"United States",866,1,7,4,0,4,1
"Colombia",866,1,5,3,2,1,2
"Croatia",866,2,7,3,1,2,1
"England",866,2,6,3,1,2,2
"Mexico",866,4,7,6,2,4,1
"Portugal",866,4,5,3,1,2,2
"France",866,5,9,6,1,5,1
"Uruguay",866,5,6,6,2,4,2
"Germany",866,7,9,8,1,7,1
"Belgium",866,7,6,13,3,10,2
"Netherlands",866,8,9,11,0,11,1
"Argentina",866,8,4,3,6,-3,2
"Belgium",867,2,9,5,0,5,1
"Denmark",867,2,4,3,2,1,2
"Chile",867,3,9,3,0,3,1
"Spain",867,3,6,5,1,4,2
"Argentina",867,4,9,6,2,4,1
"Iran",867,4,6,5,2,3,2
"England",867,6,9,7,1,6,1
"Colombia",867,6,4,2,4,-2,2
"France",867,7,7,6,1,5,1
"Croatia",867,7,5,3,2,1,2
"Uruguay",867,8,9,6,1,5,1
"Portugal",867,8,6,5,2,3,2
"Portugal",868,5,7,4,0,4,1
"Colombia",868,5,6,3,2,1,2
"Spain",868,6,7,6,1,5,1
"Mexico",868,6,5,2,1,1,2
"Korea Republic",869,2,7,4,0,4,1
"Belgium",869,2,5,4,2,2,2
"Denmark",869,5,9,7,1,6,1
"France",869,5,6,5,5,0,2
"Morocco",869,6,7,6,4,2,1
"Switzerland",869,6,6,6,3,3,2
"England",869,8,7,7,4,3,1
"Wales",869,8,5,6,3,3,2
"Netherlands",870,2,9,6,2,4,1
"France",870,2,6,5,3,2,2
"Iran",870,3,7,4,1,3,1
"Argentina",870,3,6,5,2,3,2
"Brazil",870,4,9,6,1,5,1
"Korea Republic",870,4,6,5,4,1,2
"Switzerland",870,5,7,6,2,4,1
"Spain",870,5,5,7,3,4,2
"Uruguay",870,6,7,4,2,2,1
"Morocco",870,6,4,2,3,-1,2
"Denmark",870,8,6,3,3,0,1
"Belgium",870,8,5,3,0,3,2
"Wales",871,1,6,7,3,4,1
"Qatar",871,1,5,2,1,1,2
"Denmark",871,2,9,10,1,9,1
"Switzerland",871,2,6,6,6,0,2
"Belgium",871,3,9,13,2,11,1
"Croatia",871,3,4,3,7,-4,2
"Brazil",871,5,9,10,2,8,1
"Germany",871,5,4,3,4,-1,2
"Italy",871,7,7,6,0,6,1
"England",871,7,4,4,1,3,2
"Portugal",871,8,7,5,2,3,1
"Iran",871,8,5,3,2,1,2
"Italy",872,1,7,5,0,5,1
"Chile",872,1,5,5,1,4,2
"France",872,2,9,8,2,6,1
"Netherlands",872,2,6,5,4,1,2
"Belgium",872,3,7,8,1,7,1
"Iran",872,3,6,5,6,-1,2
"Denmark",872,6,7,6,1,5,1
"Portugal",872,6,6,4,4,0,2
"Argentina",872,7,5,4,3,1,1
"Morocco",872,7,4,2,2,0,2
"Qatar",873,1,7,4,2,2,1
"Wales",873,1,5,5,1,4,2
"Brazil",873,3,9,6,3,3,1
"Japan",873,3,6,4,3,1,2
"Argentina",873,4,7,6,4,2,1
"Poland",873,4,5,3,2,1,2
"Spain",873,5,7,6,2,4,1
"Tunisia",873,5,4,3,3,0,2
"England",873,6,7,5,2,3,1
"Uruguay",873,6,5,3,2,1,2
"Portugal",873,7,9,8,0,8,1
"Korea Republic",873,7,4,3,5,-2,2
"Denmark",874,1,9,8,1,7,1
"Qatar",874,1,6,5,4,1,2
"Belgium",874,4,9,5,1,4,1
"Croatia",874,4,6,5,2,3,2
"Mexico",874,5,7,6,0,6,1
"Algeria",874,5,4,1,2,-1,2
"Italy",874,8,9,8,1,7,1
"Japan",874,8,4,2,3,-1,2
"Qatar",875,1,7,9,5,4,1
"Italy",875,1,6,6,4,2,2
"Croatia",875,4,9,6,0,6,1
"Brazil",875,4,4,7,4,3,2
"France",875,6,9,10,4,6,1
"Colombia",875,6,4,4,4,0,2
"Jamaica",876,1,9,7,0,7,1
"Poland",876,1,6,4,3,1,2
"Italy",876,6,7,4,1,3,1
"Spain",876,6,5,3,1,2,2
"Colombia",876,8,7,4,1,3,1
"England",876,8,6,4,1,3,2
"Portugal",877,4,5,5,2,3,1
"Mexico",877,4,4,2,4,-2,2
"Brazil",877,5,9,5,1,4,1
"Croatia",877,5,4,3,2,1,2
"Australia",877,7,7,4,2,2,1
"England",877,7,6,4,2,2,2
"Brazil",878,4,6,6,3,3,1
"Italy",878,4,5,3,2,1,2
"Belgium",878,6,9,10,1,9,1
"Germany",878,6,4,4,5,-1,2
"Argentina",878,7,7,4,1,3,1
"Switzerland",878,7,5,3,2,1,2
"Germany",879,1,5,1,0,1,1
"Algeria",879,1,4,3,3,0,2
"Italy",879,2,9,4,0,4,1
"Switzerland",879,2,6,3,2,1,2
"France",879,3,9,10,1,9,1
"Morocco",879,3,6,4,5,-1,2
"Brazil",879,7,9,10,5,5,1
"Iran",879,7,6,6,4,2,2
"Costa Rica",880,1,7,3,1,2,1
"Poland",880,1,4,4,3,1,2
"Germany",880,3,5,5,2,3,1
"Morocco",880,3,4,3,5,-2,2
"Spain",880,7,5,3,2,1,1
"Algeria",880,7,4,3,2,1,2
"Belgium",880,8,9,7,2,5,1
"Colombia",880,8,6,6,5,1,2
"Germany",881,1,9,8,2,6,1
"Qatar",881,1,6,4,4,0,2
"Japan",881,2,7,5,3,2,1
"Uruguay",881,2,4,4,4,0,2
"Colombia",881,5,7,6,1,5,1
"Belgium",881,5,5,5,3,2,2
"United States",881,7,7,5,2,3,1
"Argentina",881,7,4,3,4,-1,2
"Denmark",882,2,7,6,2,4,1
"Argentina",882,2,4,4,3,1,2
"Spain",882,3,9,8,1,7,1
"Italy",882,3,4,2,1,1,2
"England",882,4,7,5,3,2,1
"Germany",882,4,4,5,3,2,2
"Brazil",882,7,9,7,1,6,1
"Croatia",882,7,6,4,3,1,2
"Spain",883,2,9,5,0,5,1
"Denmark",883,2,6,6,2,4,2
"Brazil",883,4,7,10,1,9,1
"Wales",883,4,4,6,4,2,2
"Portugal",883,5,9,11,0,11,1
"Colombia",883,5,6,6,3,3,2
"England",883,7,7,4,1,3,1
"Italy",883,7,6,4,3,1,2
"Belgium",883,8,7,6,2,4,1
"Poland",883,8,4,1,2,-1,2
"Uruguay",884,2,7,7,2,5,1
"Portugal",884,2,4,4,3,1,2
"France",884,4,9,9,2,7,1
"Chile",884,4,6,7,5,2,2
"Wales",884,5,9,5,1,4,1
"Australia",884,5,4,2,2,0,2
"Belgium",884,7,9,9,1,8,1
"Germany",884,7,6,8,6,2,2
"Qatar",885,1,9,7,3,4,1
"Uruguay",885,1,6,5,1,4,2
"France",885,2,9,6,2,4,1
"Japan",885,2,6,4,3,1,2
"Argentina",885,4,6,3,3,0,1
"Croatia",885,4,5,4,2,2,2
"Portugal",885,6,9,8,1,7,1
"Italy",885,6,6,8,5,3,2
"Colombia",886,1,7,3,1,2,1
"Algeria",886,1,5,2,0,2,2
"France",886,2,7,2,0,2,1
"Italy",886,2,6,5,2,3,2
"Belgium",886,3,7,5,2,3,1
"Uruguay",886,3,5,3,2,1,2
"Croatia",886,5,9,8,0,8,1
"Portugal",886,5,6,8,3,5,2
"Denmark",886,6,7,4,2,2,1
"Brazil",886,6,5,6,2,4,2
"Poland",887,1,9,8,2,6,1
"Croatia",887,1,6,5,4,1,2
"Uruguay",887,2,7,5,2,3,1
"Spain",887,2,4,4,5,-1,2
"Korea Republic",887,5,7,3,1,2,1
"Brazil",887,5,5,2,1,1,2
"Argentina",887,6,9,7,3,4,1
"Netherlands",887,6,6,8,5,3,2
"Senegal",888,1,7,3,0,3,1
"Uruguay",888,1,6,3,2,1,2
"Belgium",888,2,7,4,1,3,1
"Algeria",888,2,4,2,2,0,2
"Spain",888,3,9,5,0,5,1
"Iran",888,3,4,3,3,0,2
"Australia",888,4,7,5,3,2,1
"Mexico",888,4,3,4,4,0,2
"Denmark",888,5,9,5,1,4,1
"Argentina",888,5,6,4,1,3,2
"Brazil",888,6,9,7,2,5,1
"Switzerland",888,6,4,4,3,1,2
"Netherlands",889,2,7,7,3,4,1
"Belgium",889,2,6,6,4,2,2
"France",889,4,9,10,2,8,1
"Senegal",889,4,4,3,2,1,2
"Argentina",889,6,9,12,1,11,1
"Denmark",889,6,4,2,6,-4,2
"Mexico",889,7,7,6,1,5,1
"Brazil",889,7,6,6,2,4,2
"Netherlands",890,2,9,8,1,7,1
"Chile",890,2,4,3,3,0,2
"Italy",890,3,7,7,3,4,1
"Spain",890,3,3,3,3,0,2
"Argentina",890,4,7,4,1,3,1
"Mexico",890,4,4,1,2,-1,2
"Denmark",891,1,7,3,0,3,1
"Qatar",891,1,6,3,1,2,2
"Portugal",891,2,7,3,1,2,1
"Algeria",891,2,3,1,1,0,2
"Argentina",891,5,9,11,2,9,1
"Croatia",891,5,4,4,4,0,2
"Belgium",891,6,9,6,0,6,1
"Australia",891,6,4,1,3,-2,2
"Brazil",891,7,7,5,2,3,1
"Mexico",891,7,6,3,1,2,2
"France",891,8,9,8,1,7,1
"Colombia",891,8,6,2,3,-1,2
"Germany",892,1,9,6,2,4,1
"Qatar",892,1,6,6,3,3,2
"Netherlands",892,2,9,8,1,7,1
"Australia",892,2,6,5,4,1,2
"France",892,3,9,7,1,6,1
"Denmark",892,3,6,6,4,2,2
"Croatia",892,4,7,3,0,3,1
"England",892,4,4,5,2,3,2
"Argentina",892,5,6,8,5,3,1
"Switzerland",892,5,5,7,5,2,2
"Wales",892,8,7,5,2,3,1
"Spain",892,8,5,4,2,2,2
"Netherlands",893,2,9,9,4,5,1
"Senegal",893,2,4,3,4,-1,2
"Brazil",893,3,9,7,3,4,1
"Croatia",893,3,4,6,6,0,2
"Germany",893,4,9,5,0,5,1
"France",893,4,6,9,2,7,2
"Wales",893,5,6,2,2,0,1
"Portugal",893,5,5,5,3,2,2
"Belgium",893,6,7,9,4,5,1
"Colombia",893,6,6,4,3,1,2
"Italy",893,8,7,5,0,5,1
"England",893,8,6,3,3,0,2
"Qatar",894,1,7,2,0,2,1
"Uruguay",894,1,6,4,2,2,2
"Germany",894,2,7,6,2,4,1
"England",894,2,5,4,3,1,2
"Brazil",894,4,9,4,0,4,1
"Denmark",894,4,6,5,2,3,2
"France",894,5,7,4,1,3,1
"Netherlands",894,5,4,1,1,0,2
"Argentina",894,6,9,8,2,6,1
"Senegal",894,6,6,4,5,-1,2
"Italy",894,7,9,5,1,4,1
"Spain",894,7,6,8,3,5,2
"Denmark",895,1,9,4,1,3,1
"Qatar",895,1,6,7,4,3,2
"France",895,2,7,5,2,3,1
"Iran",895,2,5,4,3,1,2
"England",895,4,7,6,0,6,1
"Senegal",895,4,6,5,4,1,2
"Portugal",895,5,7,3,0,3,1
"Chile",895,5,6,4,3,1,2
"Korea Republic",895,8,9,7,2,5,1
"Belgium",895,8,6,8,2,6,2
"Italy",896,2,7,3,1,2,1
"Spain",896,2,6,7,3,4,2
"Germany",896,3,9,8,0,8,1
"Argentina",896,3,6,3,2,1,2
"France",896,5,9,3,0,3,1
"Iran",896,5,4,1,1,0,2
"Belgium",896,6,7,4,1,3,1
"Croatia",896,6,4,3,2,1,2
"England",896,7,7,4,1,3,1
"Denmark",896,7,4,3,3,0,2
"Uruguay",897,1,7,6,1,5,1
"Qatar",897,1,4,3,2,1,2
"England",897,3,9,6,0,6,1
"Denmark",897,3,6,2,2,0,2
"Spain",897,4,9,7,2,5,1
"Germany",897,4,6,9,6,3,2
"Argentina",897,5,7,8,2,6,1
"Mexico",897,5,4,4,3,1,2
"Brazil",897,7,9,6,0,6,1
"Algeria",897,7,4,2,4,-2,2
"Poland",897,8,6,4,3,1,1
"France",897,8,5,4,2,2,2
"Germany",898,1,9,7,2,5,1
"United States",898,1,6,5,2,3,2
"Uruguay",898,6,7,2,0,2,1
"Belgium",898,6,6,7,4,3,2
"Spain",898,7,9,7,1,6,1
"Japan",898,7,6,4,5,-1,2
"France",899,2,9,10,1,9,1
"Nigeria",899,2,6,4,3,1,2
"Spain",899,3,7,6,4,2,1
"Japan",899,3,4,3,3,0,2
"Brazil",899,4,9,6,1,5,1
"Germany",899,4,6,5,4,1,2
"Wales",899,5,7,3,0,3,1
"Argentina",899,5,6,3,2,1,2
"Belgium",899,6,7,7,2,5,1
"United States",899,6,4,2,4,-2,2
"Switzerland",899,7,7,5,2,3,1
"Uruguay",899,7,6,3,2,1,2
"Germany",900,3,9,7,3,4,1
"Spain",900,3,4,8,5,3,2
"Senegal",900,4,6,4,2,2,1
"Argentina",900,4,5,2,1,1,2
"Portugal",900,5,9,7,0,7,1
"Japan",900,5,4,3,5,-2,2
"France",900,6,7,6,2,4,1
"Switzerland",900,6,6,5,2,3,2
"Netherlands",900,7,7,3,1,2,1
"Brazil",900,7,6,6,2,4,2
"Italy",901,1,7,6,3,3,1
"United States",901,1,3,1,1,0,2
"Uruguay",901,2,7,5,2,3,1
"Portugal",901,2,6,3,1,2,2
"Belgium",901,3,9,9,1,8,1
"Japan",901,3,6,3,4,-1,2
"France",901,5,7,5,0,5,1
"Mexico",901,5,4,4,5,-1,2
"England",901,6,7,6,1,5,1
"Senegal",901,6,6,3,4,-1,2
"Brazil",901,7,9,9,0,9,1
"Poland",901,7,4,2,4,-2,2
"Spain",901,8,9,6,1,5,1
"Morocco",901,8,4,2,3,-1,2
"Uruguay",902,1,9,7,2,5,1
"Qatar",902,1,6,4,2,2,2
"Portugal",902,3,7,3,1,2,1
"Poland",902,3,6,3,2,1,2
"Nigeria",902,8,7,2,0,2,1
"Croatia",902,8,6,6,3,3,2
"England",903,2,9,8,2,6,1
"Denmark",903,2,6,4,4,0,2
"Wales",903,5,7,3,0,3,1
"France",903,5,4,3,3,0,2
"Poland",903,6,7,5,1,4,1
"Argentina",903,6,4,2,2,0,2
"Germany",903,7,7,5,0,5,1
"Chile",903,7,4,3,4,-1,2
"Italy",903,8,7,6,4,2,1
"Belgium",903,8,4,7,2,5,2
"Qatar",904,1,9,8,3,5,1
"Uruguay",904,1,6,6,5,1,2
"France",904,4,9,6,1,5,1
"Germany",904,4,6,4,1,3,2
"Korea Republic",904,5,7,4,1,3,1
"England",904,5,4,2,3,-1,2
"Belgium",904,6,7,5,1,4,1
"Nigeria",904,6,4,4,5,-1,2
"Morocco",905,1,7,7,3,4,1
"Denmark",905,1,5,4,2,2,2
"France",905,2,7,3,1,2,1
"Croatia",905,2,6,2,1,1,2
"Netherlands",905,4,7,7,3,4,1
"Spain",905,4,5,3,2,1,2
"Brazil",905,5,9,8,0,8,1
"Germany",905,5,4,3,4,-1,2
"Switzerland",906,1,7,2,0,2,1
"Germany",906,1,6,3,2,1,2
"Poland",906,2,9,7,2,5,1
"Brazil",906,2,6,5,3,2,2
"Argentina",906,4,9,9,0,9,1
"Denmark",906,4,6,5,3,2,2
"Spain",906,6,7,7,2,5,1
"Chile",906,6,4,1,3,-2,2
"Tunisia",906,8,9,7,4,3,1
"France",906,8,4,3,3,0,2
"Colombia",907,1,7,7,1,6,1
"Qatar",907,1,4,4,4,0,2
"Spain",907,2,7,6,4,2,1
"Chile",907,2,4,2,3,-1,2
"France",907,3,7,7,5,2,1
"Italy",907,3,6,5,2,3,2
"Argentina",907,4,9,9,0,9,1
"Poland",907,4,6,6,5,1,2
"Belgium",907,5,7,3,0,3,1
"Korea Republic",907,5,6,6,4,2,2
"Brazil",907,6,7,7,4,3,1
"Netherlands",907,6,5,5,4,1,2
"Portugal",907,7,9,10,2,8,1
"Uruguay",907,7,4,6,4,2,2
"England",907,8,9,6,1,5,1
"Iran",907,8,6,3,2,1,2
"Italy",908,1,7,8,4,4,1
"Poland",908,1,4,5,5,0,2
"Australia",908,3,6,7,4,3,1
"Spain",908,3,5,3,2,1,2
"Argentina",908,4,7,3,0,3,1
"Mexico",908,4,5,4,1,3,2
"Portugal",908,5,9,7,0,7,1
"Uruguay",908,5,6,5,3,2,2
"Belgium",908,6,7,7,1,6,1
"Japan",908,6,4,7,6,1,2
"Switzerland",908,7,7,5,2,3,1
"England",908,7,5,4,2,2,2
"France",908,8,9,8,2,6,1
"Chile",908,8,4,3,4,-1,2
"Netherlands",909,1,7,8,2,6,1
"Chile",909,1,5,4,3,1,2
"Mexico",909,3,7,3,1,2,1
"Belgium",909,3,6,9,4,5,2
"Germany",909,4,9,12,3,9,1
"Morocco",909,4,6,2,6,-4,2
"Croatia",909,5,7,3,1,2,1
"Poland",909,5,6,5,1,4,2
"Brazil",909,6,7,7,1,6,1
"Senegal",909,6,6,5,4,1,2
"Spain",909,7,7,6,3,3,1
"Colombia",909,7,6,7,3,4,2
"Italy",910,1,9,11,1,10,1
"United States",910,1,6,5,6,-1,2
"Japan",910,2,9,6,1,5,1
"Spain",910,2,6,6,3,3,2
"Korea Republic",910,4,6,5,3,2,1
"Wales",910,4,5,4,3,1,2
"Brazil",910,5,9,7,0,7,1
"Netherlands",910,5,4,4,2,2,2
"Colombia",910,6,7,4,2,2,1
"Belgium",910,6,6,5,1,4,2
"Chile",910,7,7,6,2,4,1
"England",910,7,6,4,3,1,2
"Uruguay",911,1,9,8,1,7,1
"Qatar",911,1,4,3,1,2,2
"Wales",911,2,7,6,0,6,1
"Italy",911,2,5,3,2,1,2
"Argentina",911,4,7,5,2,3,1
"Croatia",911,4,6,7,5,2,2
"France",911,5,9,9,4,5,1
"Poland",911,5,4,5,6,-1,2
"Denmark",911,6,7,6,3,3,1
"Belgium",911,6,5,3,2,1,2
"Colombia",911,7,7,6,2,4,1
"Portugal",911,7,5,4,1,3,2
"Switzerland",911,8,9,7,3,4,1
"Brazil",911,8,4,5,5,0,2
"Brazil",912,2,9,11,4,7,1
"Italy",912,2,4,3,3,0,2
"Australia",912,3,9,8,1,7,1
"Senegal",912,3,4,3,4,-1,2
"England",912,4,7,3,1,2,1
"Iran",912,4,4,2,2,0,2
"Switzerland",912,6,7,4,1,3,1
"Netherlands",912,6,4,1,2,-1,2
"Spain",912,7,7,4,0,4,1
"Germany",912,7,5,1,0,1,2
"Wales",913,1,7,7,3,4,1
"Qatar",913,1,6,4,4,0,2
"Brazil",913,2,7,6,1,5,1
"United States",913,2,5,3,2,1,2
"Iran",913,4,9,4,1,3,1
"Argentina",913,4,4,2,2,0,2
"Portugal",913,5,9,11,3,8,1
"Germany",913,5,6,5,2,3,2
"Korea Republic",913,6,7,3,1,2,1
"Denmark",913,6,6,7,3,4,2
"England",913,8,9,7,2,5,1
"Australia",913,8,4,5,5,0,2
"Denmark",914,1,9,6,0,6,1
"Qatar",914,1,6,4,4,0,2
"Croatia",914,3,9,5,0,5,1
"Portugal",914,3,4,4,4,0,2
"Argentina",914,7,7,10,4,6,1
"Japan",914,7,6,8,7,1,2
"England",914,8,9,10,2,8,1
"Colombia",914,8,6,5,2,3,2
"Denmark",915,1,9,9,1,8,1
"Qatar",915,1,4,4,4,0,2
"Belgium",915,2,7,5,0,5,1
"Korea Republic",915,2,4,4,7,-3,2
"Brazil",915,3,5,7,2,5,1
"Mexico",915,3,4,1,5,-4,2
"Portugal",915,4,7,5,1,4,1
"Uruguay",915,4,6,2,1,1,2
"Spain",915,5,9,6,3,3,1
"Chile",915,5,6,4,3,1,2
"Italy",915,7,9,4,0,4,1
"England",915,7,6,4,1,3,2
"Germany",915,8,9,7,3,4,1
"Switzerland",915,8,6,6,3,3,2
"Senegal",916,2,9,6,1,5,1
"Jamaica",916,2,4,2,3,-1,2
"Belgium",916,3,9,8,2,6,1
"Croatia",916,3,6,5,3,2,2
"Netherlands",916,5,9,11,3,8,1
"Portugal",916,5,4,4,4,0,2
"Germany",916,7,7,6,2,4,1
"Brazil",916,7,5,3,1,2,2
"Wales",916,8,7,3,1,2,1
"Uruguay",916,8,6,3,1,2,2
"Colombia",917,1,9,7,2,5,1
"Qatar",917,1,6,6,5,1,2
"Mexico",917,3,7,2,0,2,1
"Australia",917,3,5,2,1,1,2
"Portugal",917,4,6,6,4,2,1
"Netherlands",917,4,5,3,0,3,2
"Wales",917,7,7,3,1,2,1
"Belgium",917,7,5,7,2,5,2
"Argentina",917,8,7,3,0,3,1
"Croatia",917,8,5,2,1,1,2
"Argentina",918,2,9,10,2,8,1
"Mexico",918,2,4,5,3,2,2
"England",918,4,7,3,0,3,1
"Colombia",918,4,6,4,4,0,2
"Germany",918,5,9,6,3,3,1
"Belgium",918,5,4,3,2,1,2
"Australia",918,6,7,4,0,4,1
"Spain",918,6,6,5,1,4,2
"France",918,7,7,6,2,4,1
"Iran",918,7,6,3,3,0,2
"Portugal",918,8,9,4,0,4,1
"Italy",918,8,6,7,4,3,2
"Spain",919,2,7,3,0,3,1
"Australia",919,2,6,4,2,2,2
"Colombia",919,4,6,6,2,4,1
"England",919,4,5,7,5,2,2
"Italy",919,5,9,7,1,6,1
"Brazil",919,5,6,5,3,2,2
"Portugal",919,6,7,7,0,7,1
"Mexico",919,6,6,4,2,2,2
"Japan",919,8,6,3,3,0,1
"Netherlands",919,8,5,5,3,2,2
"Colombia",920,2,7,3,0,3,1
"Poland",920,2,4,2,2,0,2
"Belgium",920,3,9,7,1,6,1
"Netherlands",920,3,6,6,2,4,2
"Denmark",920,4,9,4,1,3,1
"France",920,4,6,3,1,2,2
"Spain",920,5,9,8,2,6,1
"Tunisia",920,5,4,1,4,-3,2
"Uruguay",920,6,7,5,3,2,1
"United States",920,6,6,3,2,1,2
"Argentina",920,8,9,6,0,6,1
"Mexico",920,8,4,4,4,0,2
"Croatia",921,1,9,7,1,6,1
"Switzerland",921,1,4,2,4,-2,2
"Netherlands",921,2,9,6,0,6,1
"France",921,2,4,2,3,-1,2
"Belgium",921,3,9,9,3,6,1
"Australia",921,3,6,3,4,-1,2
"England",921,4,9,7,2,5,1
"United States",921,4,6,2,1,1,2
"Spain",921,5,6,3,1,2,1
"Iran",921,5,5,3,2,1,2
"Italy",921,6,9,7,0,7,1
"Brazil",921,6,6,3,1,2,2
"Denmark",921,8,7,8,2,6,1
"Poland",921,8,6,4,2,2,2
"Spain",922,2,7,6,1,5,1
"Australia",922,2,5,3,2,1,2
"Portugal",922,3,7,6,3,3,1
"Chile",922,3,5,2,1,1,2
"Nigeria",922,4,7,7,3,4,1
"United States",922,4,5,8,6,2,2
"Wales",922,5,7,4,2,2,1
"Korea Republic",922,5,4,5,2,3,2
"France",922,6,7,6,1,5,1
"Switzerland",922,6,6,2,2,0,2
"Qatar",923,1,7,6,0,6,1
"Netherlands",923,1,5,4,0,4,2
"France",923,2,9,6,1,5,1
"Korea Republic",923,2,6,3,3,0,2
"Brazil",923,4,9,7,1,6,1
"Mexico",923,4,6,5,4,1,2
"Belgium",923,5,7,5,1,4,1
"Iran",923,5,5,4,2,2,2
"Italy",923,6,9,10,2,8,1
"Chile",923,6,4,2,5,-3,2
"Wales",923,7,6,8,5,3,1
"England",923,7,5,5,4,1,2
"Argentina",923,8,9,7,4,3,1
"Poland",923,8,4,3,3,0,2
"United States",924,1,9,7,3,4,1
"Germany",924,1,6,7,2,5,2
"Argentina",924,2,9,4,1,3,1
"Denmark",924,2,6,4,2,2,2
"France",924,3,9,6,3,3,1
"Chile",924,3,4,4,2,2,2
"England",924,4,7,7,1,6,1
"Wales",924,4,4,2,5,-3,2
"Netherlands",924,5,9,6,0,6,1
"Brazil",924,5,6,5,4,1,2
"Portugal",924,6,9,5,0,5,1
"Mexico",924,6,6,3,3,0,2
"Uruguay",924,7,9,8,1,7,1
"Spain",924,7,6,6,3,3,2
"Algeria",924,8,7,3,1,2,1
"Belgium",924,8,5,7,3,4,2
"Colombia",925,1,7,2,0,2,1
"Tunisia",925,1,4,1,1,0,2
"Brazil",925,2,9,9,1,8,1
"Croatia",925,2,4,4,4,0,2
"Switzerland",925,4,5,4,1,3,1
"Germany",925,4,4,2,3,-1,2
"Argentina",925,5,7,4,1,3,1
"Denmark",925,5,6,4,3,1,2
"Netherlands",925,6,9,7,1,6,1
"Spain",925,6,6,4,1,3,2
"England",925,8,7,4,0,4,1
"Australia",925,8,4,1,3,-2,2
"Netherlands",926,3,7,4,1,3,1
"Brazil",926,3,4,2,3,-1,2
"Spain",926,7,9,9,3,6,1
"Italy",926,7,6,8,4,4,2
"Qatar",927,1,7,4,1,3,1
"Germany",927,1,4,2,1,1,2
"Argentina",927,4,9,4,0,4,1
"Wales",927,4,6,3,3,0,2
"Spain",927,5,9,6,0,6,1
"Japan",927,5,6,5,4,1,2
"Portugal",927,7,7,8,3,5,1
"Iran",927,7,6,3,4,-1,2
"England",927,8,7,5,3,2,1
"Uruguay",927,8,4,2,1,1,2
"Mexico",928,1,6,6,6,0,1
"Switzerland",928,1,5,5,3,2,2
"Uruguay",928,2,7,4,1,3,1
"Wales",928,2,4,4,4,0,2
"Portugal",928,3,9,6,3,3,1
"Italy",928,3,6,4,2,2,2
"Netherlands",928,4,7,8,4,4,1
"Brazil",928,4,4,4,4,0,2
"Iran",928,5,6,3,4,-1,1
"Spain",928,5,5,5,2,3,2
"Argentina",928,8,9,9,1,8,1
"Denmark",928,8,6,5,2,3,2
"Italy",929,2,7,5,3,2,1
"Belgium",929,2,4,3,3,0,2
"Argentina",929,5,7,3,0,3,1
"United States",929,5,4,2,2,0,2
"Brazil",929,6,7,5,1,4,1
"Senegal",929,6,6,5,3,2,2
"Australia",929,8,6,3,1,2,1
"Spain",929,8,5,1,0,1,2
"Germany",930,1,7,4,0,4,1
"Qatar",930,1,6,7,4,3,2
"Wales",930,2,7,6,2,4,1
"Brazil",930,2,5,7,4,3,2
"Colombia",930,3,9,6,1,5,1
"England",930,3,6,4,3,1,2
"Belgium",931,3,7,6,2,4,1
"Colombia",931,3,5,5,4,1,2
"Denmark",931,4,9,6,0,6,1
"England",931,4,6,4,2,2,2
"Brazil",931,5,9,11,1,10,1
"Wales",931,5,6,5,5,0,2
"Italy",931,7,9,8,1,7,1
"Senegal",931,7,6,4,4,0,2
"Korea Republic",931,8,7,3,1,2,1
"Tunisia",931,8,6,2,1,1,2
"Poland",932,1,9,10,4,6,1
"Germany",932,1,6,5,5,0,2
"Italy",932,2,7,6,2,4,1
"England",932,2,4,7,2,5,2
"France",932,4,7,4,2,2,1
"Iran",932,4,4,3,3,0,2
"Chile",932,6,7,5,2,3,1
"Belgium",932,6,6,4,3,1,2
"Portugal",932,7,7,5,1,4,1
"Switzerland",932,7,6,7,3,4,2
"Argentina",932,8,7,4,2,2,1
"United States",932,8,6,7,4,3,2
"Senegal",933,1,9,8,3,5,1
"Italy",933,1,6,4,2,2,2
"Mexico",933,2,7,5,2,3,1
"England",933,2,4,4,3,1,2
"Belgium",933,4,9,8,1,7,1
"Uruguay",933,4,6,4,2,2,2
"Germany",933,6,9,6,2,4,1
"Brazil",933,6,6,5,3,2,2
"Spain",933,7,9,8,1,7,1
"Switzerland",933,7,4,6,9,-3,2
"Mexico",934,2,6,4,2,2,1
"Argentina",934,2,5,1,0,1,2
"France",934,3,7,9,0,9,1
"Colombia",934,3,4,3,7,-4,2
"Italy",934,6,7,5,1,4,1
"Brazil",934,6,6,5,1,4,2
"Mexico",935,2,9,4,1,3,1
"Brazil",935,2,6,4,1,3,2
"Poland",935,4,9,5,2,3,1
"Croatia",935,4,6,10,2,8,2
"Spain",935,5,9,7,3,4,1
"Australia",935,5,4,6,4,2,2
"Netherlands",935,6,7,5,1,4,1
"France",935,6,6,9,2,7,2
"Denmark",935,7,7,4,2,2,1
"Portugal",935,7,5,3,2,1,2
"England",935,8,9,7,2,5,1
"Germany",935,8,6,4,2,2,2
"Uruguay",936,2,6,5,4,1,1
"Spain",936,2,5,2,1,1,2
"Chile",936,4,7,3,1,2,1
"England",936,4,6,3,2,1,2
"Portugal",936,5,7,7,4,3,1
"Mexico",936,5,5,2,1,1,2
"Brazil",936,6,7,4,1,3,1
"Iran",936,6,6,7,5,2,2
"Belgium",936,8,9,9,0,9,1
"Jamaica",936,8,4,1,6,-5,2
"Uruguay",937,1,9,9,1,8,1
"Wales",937,1,6,4,4,0,2
"Portugal",937,3,9,6,1,5,1
"Mexico",937,3,6,7,5,2,2
"Brazil",937,4,9,6,1,5,1
"Jamaica",937,4,4,3,5,-2,2
"Belgium",937,5,9,11,0,11,1
"Colombia",937,5,6,4,4,0,2
"France",937,6,9,7,1,6,1
"Croatia",937,6,4,4,2,2,2
"Netherlands",937,8,7,9,3,6,1
"Spain",937,8,6,5,6,-1,2
"Croatia",938,1,9,7,2,5,1
"Qatar",938,1,6,5,4,1,2
"Netherlands",938,2,9,5,1,4,1
"England",938,2,6,5,2,3,2
"Switzerland",938,3,7,4,1,3,1
"Belgium",938,3,5,5,1,4,2
"Argentina",938,5,7,7,2,5,1
"Italy",938,5,5,5,3,2,2
"Uruguay",938,8,7,5,2,3,1
"France",938,8,5,5,4,1,2
"Brazil",939,2,9,8,0,8,1
"Japan",939,2,6,2,5,-3,2
"Spain",939,3,7,7,0,7,1
"Germany",939,3,5,3,2,1,2
"Portugal",939,4,9,7,1,6,1
"Korea Republic",939,4,6,2,3,-1,2
"Netherlands",939,5,7,6,1,5,1
"Argentina",939,5,6,3,3,0,2
"Italy",939,7,9,8,2,6,1
"Nigeria",939,7,4,3,5,-2,2
"Belgium",939,8,7,5,0,5,1
"Mexico",939,8,3,1,1,0,2
"Qatar",940,1,7,3,1,2,1
"Algeria",940,1,6,3,2,1,2
"Argentina",940,2,7,7,2,5,1
"Croatia",940,2,5,6,4,2,2
"Belgium",940,3,9,6,1,5,1
"United States",940,3,6,4,3,1,2
"Colombia",940,5,9,5,0,5,1
"Iran",940,5,6,3,3,0,2
"Korea Republic",940,6,7,4,1,3,1
"Brazil",940,6,4,5,5,0,2
"Spain",940,7,9,6,1,5,1
"Chile",940,7,6,6,2,4,2
"Switzerland",940,8,9,4,0,4,1
"France",940,8,6,8,2,6,2
"Denmark",941,1,9,6,1,5,1
"Algeria",941,1,4,2,3,-1,2
"Portugal",941,2,7,5,1,4,1
"Switzerland",941,2,4,3,4,-1,2
"Belgium",941,4,9,3,0,3,1
"United States",941,4,4,2,1,1,2
"Italy",941,5,7,7,0,7,1
"Spain",941,5,5,1,0,1,2
"Croatia",941,6,7,4,1,3,1
"Brazil",941,6,5,6,5,1,2
"Japan",941,7,6,4,3,1,1
"Argentina",941,7,5,3,1,2,2
"France",941,8,9,6,2,4,1
"Netherlands",941,8,6,7,3,4,2
"Switzerland",942,1,9,5,0,5,1
"Uruguay",942,1,6,3,1,2,2
"France",942,2,9,11,0,11,1
"Netherlands",942,2,6,6,3,3,2
"Korea Republic",942,3,7,6,3,3,1
"Spain",942,3,6,4,2,2,2
"Germany",942,4,7,3,1,2,1
"Argentina",942,4,4,2,1,1,2
"Belgium",942,6,9,9,2,7,1
"Denmark",942,6,6,5,3,2,2
"Portugal",942,7,7,7,1,6,1
"Colombia",942,7,5,3,2,1,2
"Italy",942,8,7,6,0,6,1
"Chile",942,8,5,4,2,2,2
"Jamaica",943,1,6,3,1,2,1
"Senegal",943,1,5,3,2,1,2
"Uruguay",943,2,7,8,3,5,1
"Portugal",943,2,6,5,1,4,2
"Italy",943,3,9,8,1,7,1
"Argentina",943,3,6,7,1,6,2
"France",943,7,9,5,1,4,1
"Poland",943,7,4,1,2,-1,2
"Belgium",943,8,9,7,0,7,1
"Netherlands",943,8,6,3,1,2,2
"Spain",944,4,7,7,4,3,1
"Italy",944,4,6,6,3,3,2
"Argentina",944,6,9,8,3,5,1
"Denmark",944,6,4,3,2,1,2
"Croatia",944,7,7,7,3,4,1
"Belgium",944,7,4,7,6,1,2
"Germany",944,8,7,9,3,6,1
"Switzerland",944,8,6,5,6,-1,2
"Poland",945,1,9,9,2,7,1
"Mexico",945,1,4,3,2,1,2
"England",945,2,9,9,1,8,1
"Colombia",945,2,6,5,3,2,2
"Denmark",945,3,7,5,0,5,1
"Switzerland",945,3,3,1,1,0,2
"Uruguay",945,5,7,6,4,2,1
"United States",945,5,5,4,2,2,2
"Portugal",945,8,7,5,1,4,1
"Chile",945,8,5,6,4,2,2
"Switzerland",946,1,9,4,0,4,1
"Denmark",946,1,6,7,4,3,2
"Spain",946,3,9,10,0,10,1
"Uruguay",946,3,6,4,3,1,2
"Colombia",946,6,7,7,2,5,1
"Portugal",946,6,5,4,0,4,2
"France",946,8,7,4,2,2,1
"Mexico",946,8,5,5,3,2,2
"Germany",947,3,9,5,1,4,1
"Spain",947,3,6,4,3,1,2
"Netherlands",947,4,9,8,3,5,1
"Brazil",947,4,4,3,4,-1,2
"England",947,5,6,6,2,4,1
"Mexico",947,5,5,3,1,2,2
"Argentina",947,6,9,9,3,6,1
"Italy",947,6,6,12,3,9,2
"Tunisia",948,1,9,7,3,4,1
"Denmark",948,1,4,7,7,0,2
"Wales",948,2,7,4,1,3,1
"Spain",948,2,5,1,0,1,2
"England",948,3,9,13,6,7,1
"Mexico",948,3,6,5,3,2,2
"Belgium",948,4,7,5,3,2,1
"Switzerland",948,4,6,5,3,2,2
"Netherlands",948,6,7,4,2,2,1
"France",948,6,4,5,4,1,2
"Portugal",948,7,9,8,2,6,1
"Croatia",948,7,6,6,3,3,2
"Qatar",949,1,7,6,4,2,1
"Netherlands",949,1,6,8,4,4,2
"Iran",949,2,7,4,2,2,1
"France",949,2,6,4,3,1,2
"England",949,3,7,4,0,4,1
"Colombia",949,3,5,3,2,1,2
"Portugal",949,4,7,11,2,9,1
"Algeria",949,4,4,3,7,-4,2
"Italy",949,7,7,4,0,4,1
"Spain",949,7,4,1,1,0,2
"Belgium",949,8,7,3,1,2,1
"Poland",949,8,6,5,1,4,2
"Wales",950,1,7,4,2,2,1
"Uruguay",950,1,5,3,1,2,2
"Australia",950,4,7,5,3,2,1
"Spain",950,4,5,5,4,1,2
"England",950,7,9,5,2,3,1
"Nigeria",950,7,6,6,5,1,2
"Australia",951,2,5,4,3,1,1
"Croatia",951,2,4,6,6,0,2
"Korea Republic",951,3,7,5,2,3,1
"England",951,3,5,5,2,3,2
"France",951,5,7,5,1,4,1
"Uruguay",951,5,4,4,4,0,2
"Algeria",951,6,7,2,0,2,1
"Mexico",951,6,4,2,2,0,2
"Germany",951,7,7,7,3,4,1
"Japan",951,7,6,4,5,-1,2
"Spain",951,8,7,5,1,4,1
"Colombia",951,8,6,6,4,2,2
"Uruguay",952,1,7,4,1,3,1
"Poland",952,1,5,6,1,5,2
"Brazil",952,2,9,8,2,6,1
"Netherlands",952,2,6,8,2,6,2
"Portugal",952,3,9,8,3,5,1
"Chile",952,3,6,4,4,0,2
"France",952,6,9,8,1,7,1
"Italy",952,6,6,4,3,1,2
"Mexico",953,1,7,5,1,4,1
"Poland",953,1,5,3,1,2,2
"France",953,3,9,6,3,3,1
"Colombia",953,3,6,3,2,1,2
"Uruguay",953,4,9,7,0,7,1
"England",953,4,4,3,5,-2,2
"Netherlands",953,6,9,7,1,6,1
"Nigeria",953,6,4,2,4,-2,2
"Switzerland",954,2,7,6,2,4,1
"Denmark",954,2,4,4,6,-2,2
"Italy",954,3,9,8,2,6,1
"Argentina",954,3,6,7,2,5,2
"Portugal",954,7,9,8,0,8,1
"Germany",954,7,6,4,2,2,2
"France",954,8,7,3,0,3,1
"Wales",954,8,4,3,2,1,2
"Spain",955,5,6,4,2,2,1
"Chile",955,5,5,5,4,1,2
"Germany",955,6,7,7,1,6,1
"Belgium",955,6,4,2,3,-1,2
"France",955,7,7,6,2,4,1
"Mexico",955,7,5,2,1,1,2
"Portugal",955,8,9,7,2,5,1
"Switzerland",955,8,4,4,4,0,2
"Italy",956,1,7,8,0,8,1
"Algeria",956,1,4,2,6,-4,2
"Spain",956,2,9,9,4,5,1
"Australia",956,2,6,5,2,3,2
"Brazil",956,3,6,4,2,2,1
"Germany",956,3,5,4,2,2,2
"Poland",956,4,7,7,3,4,1
"England",956,4,4,7,2,5,2
"France",956,6,9,6,0,6,1
"Netherlands",956,6,6,6,2,4,2
"Japan",956,7,9,4,0,4,1
"Mexico",956,7,6,9,2,7,2
"Colombia",957,1,9,7,2,5,1
"Senegal",957,1,4,2,2,0,2
"Netherlands",957,6,9,9,1,8,1
"England",957,6,6,4,4,0,2
"Croatia",957,8,7,5,1,4,1
"Portugal",957,8,6,3,3,0,2
"Portugal",958,3,7,7,0,7,1
"Croatia",958,3,6,3,5,-2,2
"Spain",958,6,7,2,0,2,1
"United States",958,6,6,3,2,1,2
"Argentina",958,7,7,4,0,4,1
"Costa Rica",958,7,4,4,6,-2,2
"Uruguay",958,8,7,6,1,5,1
"England",958,8,6,7,4,3,2
"Brazil",959,2,9,11,2,9,1
"Netherlands",959,2,4,5,2,3,2
"Portugal",959,3,7,5,3,2,1
"Colombia",959,3,6,4,2,2,2
"France",959,4,9,5,2,3,1
"Uruguay",959,4,6,4,2,2,2
"Argentina",959,5,9,7,1,6,1
"Croatia",959,5,4,4,5,-1,2
"Denmark",959,6,7,4,2,2,1
"Chile",959,6,5,5,3,2,2
"Spain",959,7,7,4,2,2,1
"Australia",959,7,6,5,2,3,2
"Italy",959,8,7,4,2,2,1
"Belgium",959,8,6,4,3,1,2
"Poland",960,1,7,5,2,3,1
"Colombia",960,1,4,4,4,0,2
"England",960,5,6,7,2,5,1
"Wales",960,5,5,4,3,1,2
"Portugal",960,6,7,3,1,2,1
"Uruguay",960,6,5,1,0,1,2
"Belgium",960,8,9,7,1,6,1
"Germany",960,8,6,6,4,2,2
"Mexico",961,1,9,7,2,5,1
"Morocco",961,1,4,5,3,2,2
"Colombia",961,2,9,5,0,5,1
"United States",961,2,4,2,3,-1,2
"Argentina",961,5,7,7,2,5,1
"Japan",961,5,6,5,3,2,2
"Netherlands",962,1,7,10,2,8,1
"Senegal",962,1,5,3,1,2,2
"Italy",962,2,7,6,3,3,1
"Chile",962,2,5,4,2,2,2
"Colombia",962,3,7,6,3,3,1
"Spain",962,3,4,6,6,0,2
"Portugal",962,4,7,3,0,3,1
"Denmark",962,4,6,4,3,1,2
"Belgium",962,6,7,7,2,5,1
"Croatia",962,6,5,7,1,6,2
"Brazil",962,8,9,7,0,7,1
"Korea Republic",962,8,6,3,3,0,2
"Wales",963,1,7,3,1,2,1
"Croatia",963,1,4,3,3,0,2
"Argentina",963,2,9,5,1,4,1
"Denmark",963,2,6,3,3,0,2
"Uruguay",963,6,9,8,3,5,1
"France",963,6,6,5,3,2,2
"Mexico",963,7,7,6,2,4,1
"Australia",963,7,4,2,4,-2,2
"Italy",963,8,9,4,1,3,1
"Belgium",963,8,6,6,2,4,2
"Netherlands",964,3,9,9,3,6,1
"Portugal",964,3,6,9,5,4,2
"Australia",964,4,6,7,7,0,1
"Mexico",964,4,5,5,3,2,2
"Brazil",964,6,9,5,0,5,1
"Germany",964,6,4,4,3,1,2
"France",964,8,9,7,1,6,1
"Switzerland",964,8,4,2,2,0,2
"Italy",965,1,9,13,2,11,1
"Qatar",965,1,6,5,6,-1,2
"Portugal",965,3,9,9,0,9,1
"Wales",965,3,6,3,6,-3,2
"Brazil",965,4,9,9,1,8,1
"Netherlands",965,4,4,4,5,-1,2
"Spain",965,5,9,8,2,6,1
"Poland",965,5,6,4,2,2,2
"Argentina",965,6,9,9,1,8,1
"Germany",965,6,4,3,3,0,2
"England",965,7,9,7,4,3,1
"Chile",965,7,6,6,3,3,2
"Belgium",965,8,9,16,2,14,1
"Iran",965,8,4,4,8,-4,2
"Italy",966,4,9,8,4,4,1
"Morocco",966,4,6,4,3,1,2
"Spain",966,6,6,8,4,4,1
"Wales",966,6,5,5,4,1,2
"France",967,3,7,4,2,2,1
"Colombia",967,3,4,2,2,0,2
"Brazil",967,4,7,7,2,5,1
"Costa Rica",967,4,4,3,6,-3,2
"Wales",967,6,7,4,1,3,1
"Uruguay",967,6,4,4,4,0,2
"Spain",967,7,9,10,1,9,1
"Korea Republic",967,7,4,3,6,-3,2
"Mexico",968,1,9,5,0,5,1
"Algeria",968,1,6,4,1,3,2
"France",968,3,9,6,1,5,1
"Uruguay",968,3,6,9,3,6,2
"Germany",968,4,7,6,2,4,1
"Portugal",968,4,6,7,3,4,2
"Croatia",968,8,7,4,1,3,1
"Chile",968,8,6,4,3,1,2
"Chile",969,1,7,6,3,3,1
"Germany",969,1,5,3,2,1,2
"Spain",969,2,7,4,1,3,1
"Denmark",969,2,6,6,1,5,2
"Brazil",969,3,7,7,3,4,1
"Mexico",969,3,6,4,5,-1,2
"France",969,4,9,8,2,6,1
"Colombia",969,4,6,5,3,2,2
"Uruguay",969,7,7,5,3,2,1
"Belgium",969,7,5,4,1,3,2
"Iran",969,8,7,2,0,2,1
"Portugal",969,8,6,3,1,2,2
"France",970,2,7,5,3,2,1
"Colombia",970,2,4,4,4,0,2
"Denmark",970,3,7,6,3,3,1
"Brazil",970,3,6,10,2,8,2
"Portugal",970,5,9,6,2,4,1
"Korea Republic",970,5,4,5,3,2,2
"Croatia",970,6,9,10,6,4,1
"Argentina",970,6,6,7,4,3,2
"Italy",970,7,9,8,3,5,1
"England",970,7,6,4,2,2,2
"Belgium",970,8,7,12,3,9,1
"Uruguay",970,8,5,4,3,1,2
"Italy",971,3,5,3,2,1,1
"Australia",971,3,4,5,5,0,2
"Morocco",971,6,9,7,3,4,1
"Wales",971,6,6,5,4,1,2
"Croatia",971,8,9,5,1,4,1
"Belgium",971,8,6,5,2,3,2
"Italy",972,1,9,7,2,5,1
"Nigeria",972,1,4,3,3,0,2
"Germany",972,4,7,7,3,4,1
"Portugal",972,4,5,3,2,1,2
"Denmark",972,5,9,8,1,7,1
"Wales",972,5,6,4,5,-1,2
"Belgium",972,7,9,6,1,5,1
"Poland",972,7,6,2,2,0,2
"Colombia",972,8,7,3,1,2,1
"France",972,8,5,3,1,2,2
"Belgium",973,3,7,7,0,7,1
"Poland",973,3,6,3,4,-1,2
"Portugal",973,5,9,7,2,5,1
"Netherlands",973,5,6,4,1,3,2
"France",973,7,7,4,1,3,1
"Uruguay",973,7,6,2,1,1,2
"Brazil",973,8,7,5,3,2,1
"Switzerland",973,8,6,5,2,3,2
"Uruguay",974,3,7,4,2,2,1
"Australia",974,3,6,4,3,1,2
"France",974,5,9,5,1,4,1
"Poland",974,5,6,6,5,1,2
"Argentina",974,8,9,5,1,4,1
"Wales",974,8,4,5,3,2,2
"England",975,5,7,10,5,5,1
"Colombia",975,5,4,6,5,1,2
"France",976,3,9,6,1,5,1
"Denmark",976,3,6,6,3,3,2
"Brazil",976,5,9,11,1,10,1
"Mexico",976,5,6,4,5,-1,2
"Germany",976,6,9,9,0,9,1
"Nigeria",976,6,4,3,6,-3,2
"Spain",976,7,7,6,2,4,1
"Japan",976,7,4,5,5,0,2
"Croatia",976,8,6,4,4,0,1
"Belgium",976,8,5,4,1,3,2
"Netherlands",977,1,7,3,1,2,1
"Qatar",977,1,4,2,2,0,2
"Denmark",977,4,7,5,2,3,1
"Iran",977,4,5,5,4,1,2
"France",977,8,9,6,0,6,1
"Croatia",977,8,4,2,2,0,2
"Algeria",978,1,7,4,1,3,1
"Italy",978,1,6,4,2,2,2
"Denmark",978,2,7,10,4,6,1
"Portugal",978,2,5,8,6,2,2
"Chile",978,6,7,3,0,3,1
"England",978,6,3,0,0,0,2
"Belgium",978,7,7,4,1,3,1
"Poland",978,7,4,2,3,-1,2
"Netherlands",978,8,7,8,1,7,1
"France",978,8,5,6,5,1,2
"Italy",979,1,7,4,2,2,1
"Qatar",979,1,6,7,5,2,2
"Colombia",979,3,9,4,1,3,1
"France",979,3,6,9,2,7,2
"Portugal",979,4,9,10,1,9,1
"Netherlands",979,4,4,4,7,-3,2
"Wales",980,1,5,8,4,4,1
"Croatia",980,1,4,3,6,-3,2
"Italy",980,2,9,5,0,5,1
"Belgium",980,2,6,4,3,1,2
"Chile",980,5,7,6,2,4,1
"Portugal",980,5,5,7,3,4,2
"Brazil",980,6,9,7,2,5,1
"Netherlands",980,6,6,10,3,7,2
"Korea Republic",980,7,7,3,1,2,1
"England",980,7,4,4,2,2,2
"France",980,8,9,9,3,6,1
"Germany",980,8,4,4,5,-1,2
"Italy",981,1,9,7,1,6,1
"Qatar",981,1,4,5,5,0,2
"Germany",981,2,9,5,0,5,1
"Iran",981,2,4,1,2,-1,2
"Belgium",981,4,9,7,3,4,1
"Chile",981,4,6,6,3,3,2
"Spain",981,7,7,6,3,3,1
"Mexico",981,7,5,3,1,2,2
"Italy",982,2,7,7,0,7,1
"England",982,2,6,5,2,3,2
"France",982,4,7,4,2,2,1
"Uruguay",982,4,5,3,2,1,2
"Belgium",982,5,7,6,0,6,1
"Netherlands",982,5,5,1,0,1,2
"Portugal",982,6,7,5,2,3,1
"Chile",982,6,5,3,0,3,2
"Denmark",982,7,9,6,2,4,1
"Japan",982,7,4,3,4,-1,2
"Italy",983,1,9,9,1,8,1
"Qatar",983,1,4,2,5,-3,2
"Switzerland",983,2,5,4,3,1,1
"Croatia",983,2,4,5,3,2,2
"Spain",983,3,7,6,2,4,1
"Algeria",983,3,5,3,2,1,2
"Germany",983,8,7,8,5,3,1
"Wales",983,8,4,3,4,-1,2
"Qatar",984,1,7,7,1,6,1
"Denmark",984,1,4,3,3,0,2
"Brazil",984,4,7,5,1,4,1
"Netherlands",984,4,5,5,2,3,2
"France",985,4,7,6,0,6,1
"Uruguay",985,4,4,1,1,0,2
"Argentina",985,6,9,9,2,7,1
"Jamaica",985,6,4,3,6,-3,2
"Japan",985,7,6,3,2,1,1
"Portugal",985,7,5,5,4,1,2
"Denmark",985,8,7,4,1,3,1
"Chile",985,8,5,5,2,3,2
"Spain",986,2,7,5,3,2,1
"Netherlands",986,2,4,2,2,0,2
"Italy",986,3,9,9,0,9,1
"Portugal",986,3,4,6,4,2,2
"Denmark",986,5,7,5,3,2,1
"France",986,5,5,4,2,2,2
"Argentina",986,6,9,7,3,4,1
"Croatia",986,6,4,4,3,1,2
"Belgium",986,8,7,6,1,5,1
"Iran",986,8,4,2,3,-1,2
"Portugal",987,2,9,9,2,7,1
"Denmark",987,2,6,5,1,4,2
"Korea Republic",987,3,7,5,1,4,1
"France",987,3,6,5,2,3,2
"England",987,5,7,7,2,5,1
"Netherlands",987,5,6,7,2,5,2
"Belgium",987,6,7,4,0,4,1
"Uruguay",987,6,4,3,2,1,2
"Spain",987,8,7,4,1,3,1
"Chile",987,8,5,6,4,2,2
"Spain",988,4,9,9,0,9,1
"Croatia",988,4,6,5,4,1,2
"Belgium",988,5,9,6,1,5,1
"Uruguay",988,5,4,3,2,1,2
"Netherlands",988,6,7,5,2,3,1
"Chile",988,6,4,1,2,-1,2
"Brazil",988,7,9,6,1,5,1
"Germany",988,7,6,11,5,6,2
"Uruguay",989,1,9,6,1,5,1
"Qatar",989,1,6,5,1,4,2
"Spain",989,2,7,6,3,3,1
"Italy",989,2,6,4,2,2,2
"Brazil",989,4,9,5,1,4,1
"Japan",989,4,6,4,3,1,2
"Belgium",989,6,9,7,1,6,1
"Senegal",989,6,4,4,6,-2,2
"Australia",989,7,7,4,2,2,1
"Croatia",989,7,6,4,2,2,2
"Germany",990,1,9,5,0,5,1
"Qatar",990,1,6,2,2,0,2
"Belgium",990,2,9,6,2,4,1
"Australia",990,2,6,4,3,1,2
"Portugal",990,3,9,6,2,4,1
"Japan",990,3,6,7,3,4,2
"Switzerland",990,4,7,5,2,3,1
"Uruguay",990,4,5,3,2,1,2
"Denmark",990,5,9,7,2,5,1
"Brazil",990,5,4,2,2,0,2
"Algeria",990,6,7,5,3,2,1
"Italy",990,6,4,9,7,2,2
"France",990,7,7,3,0,3,1
"Colombia",990,7,4,1,1,0,2
"Chile",990,8,9,6,2,4,1
"Spain",990,8,6,5,3,2,2
"Italy",991,2,7,6,2,4,1
"France",991,2,6,7,2,5,2
"Germany",991,7,7,6,3,3,1
"Brazil",991,7,6,4,3,1,2
"Japan",992,2,7,4,2,2,1
"Mexico",992,2,5,4,3,1,2
"Italy",992,3,9,8,1,7,1
"Argentina",992,3,6,3,1,2,2
"Uruguay",992,5,7,3,1,2,1
"England",992,5,6,5,1,4,2
"Portugal",992,7,7,5,2,3,1
"Senegal",992,7,4,4,4,0,2
"France",992,8,7,5,0,5,1
"Switzerland",992,8,4,2,2,0,2
"Croatia",993,1,9,10,3,7,1
"Qatar",993,1,6,7,3,4,2
"England",993,2,9,4,0,4,1
"Netherlands",993,2,6,6,4,2,2
"Uruguay",993,3,7,6,4,2,1
"France",993,3,5,6,4,2,2
"Denmark",993,4,9,6,0,6,1
"Belgium",993,4,6,10,4,6,2
"Brazil",993,5,9,8,1,7,1
"Australia",993,5,4,2,4,-2,2
"Argentina",993,6,9,8,1,7,1
"Algeria",993,6,4,3,4,-1,2
"Colombia",993,7,6,4,1,3,1
"Spain",993,7,5,4,3,1,2
"Portugal",993,8,9,7,1,6,1
"Germany",993,8,6,6,4,2,2
"Brazil",994,2,9,10,3,7,1
"Germany",994,2,4,8,7,1,2
"England",994,3,7,5,2,3,1
"Poland",994,3,5,2,1,1,2
"France",994,4,7,6,2,4,1
"Colombia",994,4,6,5,6,-1,2
"Japan",994,6,7,4,2,2,1
"Uruguay",994,6,6,9,5,4,2
"Netherlands",995,1,7,6,1,5,1
"Qatar",995,1,4,2,2,0,2
"Spain",995,2,7,6,3,3,1
"Germany",995,2,5,5,4,1,2
"Poland",995,3,7,5,2,3,1
"France",995,3,6,3,2,1,2
"Portugal",995,4,7,8,1,7,1
"Denmark",995,4,5,3,2,1,2
"Belgium",995,7,9,7,2,5,1
"Colombia",995,7,6,6,2,4,2
"Netherlands",996,1,9,5,0,5,1
"United States",996,1,6,3,2,1,2
"Belgium",996,3,7,6,1,5,1
"Australia",996,3,6,6,6,0,2
"Argentina",996,5,9,8,3,5,1
"Mexico",996,5,4,4,5,-1,2
"England",996,7,9,9,1,8,1
"Wales",996,7,6,5,4,1,2
"Qatar",997,1,7,5,2,3,1
"Algeria",997,1,6,6,5,1,2
"France",997,2,7,5,0,5,1
"Korea Republic",997,2,4,2,1,1,2
"Spain",997,3,9,7,0,7,1
"Netherlands",997,3,6,4,1,3,2
"Brazil",997,4,9,5,1,4,1
"Morocco",997,4,4,1,2,-1,2
"England",997,5,9,9,3,6,1
"Colombia",997,5,4,4,4,0,2
"Belgium",997,6,9,8,2,6,1
"Poland",997,6,4,2,4,-2,2
"Argentina",997,7,9,11,7,4,1
"Switzerland",997,7,6,7,4,3,2
"Portugal",997,8,5,3,0,3,1
"Germany",997,8,4,4,4,0,2
"Spain",998,2,9,5,2,3,1
"Japan",998,2,6,6,2,4,2
"Italy",998,3,7,10,3,7,1
"Belgium",998,3,5,3,1,2,2
"Brazil",998,4,9,5,0,5,1
"Korea Republic",998,4,6,6,3,3,2
"England",998,6,9,12,1,11,1
"Netherlands",998,6,6,4,6,-2,2
"Argentina",998,7,7,8,4,4,1
"Croatia",998,7,5,5,3,2,2
"Croatia",999,1,7,6,0,6,1
"Costa Rica",999,1,5,1,0,1,2
"Brazil",999,3,7,3,0,3,1
"Nigeria",999,3,6,3,2,1,2
"Netherlands",999,4,7,8,4,4,1
"Portugal",999,4,6,6,1,5,2
"France",999,5,9,9,1,8,1
"Germany",999,5,4,3,3,0,2
"England",999,6,7,5,3,2,1
"Morocco",999,6,4,4,1,3,2
"Belgium",999,8,7,7,2,5,1
"Mexico",999,8,4,4,2,2,2
"Italy",1000,4,9,7,2,5,1
"Belgium",1000,4,6,8,4,4,2
"Denmark",1000,5,9,7,3,4,1
"France",1000,5,6,5,3,2,2
"Portugal",1000,6,9,10,1,9,1
"United States",1000,6,4,4,3,1,2
"Germany",1,1,6,5,2,3,1
"Chile",1,1,6,5,4,1,2
"Belgium",1,3,6,8,3,5,1
"Uruguay",1,3,6,4,3,1,2
"France",1,4,7,7,1,6,1
"Korea Republic",1,4,7,3,1,2,2
"Argentina",1,5,6,6,4,2,2
"Nigeria",1,5,6,6,3,3,1
"Portugal",1,7,9,13,2,11,1
"United States",1,7,4,3,3,0,2
"England",2,5,6,4,3,1,1
"Germany",2,5,6,4,6,-2,2
"Spain",2,7,9,6,0,6,1
"Croatia",2,7,4,4,3,1,2
"Brazil",3,2,7,4,1,3,1
"Iran",3,2,4,3,2,1,2
"France",3,3,6,3,3,0,2
"Chile",3,3,6,6,3,3,1
"England",3,4,7,4,1,3,1
"Germany",3,4,7,3,1,2,2
"Argentina",4,3,7,7,3,4,1
"Denmark",4,3,7,5,2,3,2
"Brazil",4,6,6,8,4,4,1
"Mexico",4,6,6,3,1,2,2
"Japan",4,7,6,4,3,1,1
"Colombia",4,7,4,5,4,1,2
"Italy",5,2,5,7,4,3,1
"Senegal",5,2,4,6,5,1,2
"Germany",5,5,9,4,0,4,1
"Portugal",5,5,4,4,2,2,2
"Qatar",6,1,6,4,2,2,1
"Senegal",6,1,6,4,3,1,2
"Spain",7,4,6,3,1,2,1
"Wales",7,4,6,3,4,-1,2
"Brazil",7,6,6,7,3,4,1
"Korea Republic",7,6,6,3,3,0,2
"Portugal",8,5,5,4,2,2,1
"Algeria",8,5,5,3,2,1,2
"Argentina",8,6,9,5,1,4,1
"Switzerland",8,6,4,3,2,1,2
"France",9,2,7,6,3,3,1
"Mexico",9,2,4,5,3,2,2
"Belgium",9,6,5,4,3,1,1
"Uruguay",9,6,4,3,2,1,2
"Portugal",9,7,7,7,1,6,1
"Chile",9,7,7,8,4,4,2
"Netherlands",9,8,6,2,2,0,1
"Spain",9,8,4,3,1,2,2
"France",10,2,7,4,1,3,1
"Algeria",10,2,4,4,2,2,2
"Spain",10,4,6,4,1,3,1
"Morocco",10,4,6,3,3,0,2
"Belgium",11,3,7,7,3,4,1
"Uruguay",11,3,4,4,2,2,2
"Chile",11,6,5,4,2,2,1
"Spain",11,6,4,3,3,0,2
"Belgium",12,4,7,7,2,5,1
"Switzerland",12,4,7,5,2,3,2
"Tunisia",12,6,5,4,2,2,1
"Jamaica",12,6,5,3,2,1,2
"Chile",12,7,9,6,3,3,1
"Italy",12,7,4,6,4,2,2
"Netherlands",12,8,7,10,6,4,1
"Iran",12,8,4,5,5,0,2
"Portugal",13,2,6,7,3,4,1
"Denmark",13,2,6,5,2,3,2
"Poland",13,4,6,4,3,1,1
"Netherlands",13,4,4,3,2,1,2
"Argentina",13,5,9,8,2,6,1
"Korea Republic",13,5,3,4,4,0,2
"Belgium",14,3,9,7,2,5,1
"Mexico",14,3,4,5,5,0,2
"Portugal",14,5,6,6,3,3,1
"Chile",14,5,6,6,4,2,2
"Mexico",15,2,7,5,2,3,1
"France",15,2,4,7,4,3,2
"Spain",15,6,9,5,0,5,1
"Switzerland",15,6,4,2,1,1,2
"Uruguay",15,7,9,3,0,3,1
"Belgium",15,7,4,4,2,2,2
"Iran",16,3,7,4,1,3,1
"France",16,3,4,6,3,3,2
"Belgium",17,2,7,10,2,8,1
"Netherlands",17,2,4,4,3,1,2
"England",17,4,7,3,0,3,1
"Denmark",17,4,4,3,3,0,2
"Switzerland",17,8,5,6,4,2,1
"Uruguay",17,8,4,3,3,0,2
"United States",18,2,6,4,4,0,1
"Italy",18,2,4,2,1,1,2
"England",19,2,5,5,3,2,1
"Japan",19,2,5,3,2,1,2
"Uruguay",20,1,6,5,3,2,1
"United States",20,1,6,2,2,0,2
"England",20,3,6,3,4,-1,2
"Germany",20,3,6,6,1,5,1
"Spain",21,3,6,9,4,5,1
"Colombia",21,3,6,4,2,2,2
"Japan",21,4,7,4,2,2,1
"Brazil",21,4,4,10,6,4,2
"England",21,5,7,8,3,5,1
"Mexico",21,5,7,4,2,2,2
"Costa Rica",21,8,7,6,2,4,1
"Belgium",21,8,4,10,5,5,2
"Denmark",24,1,6,4,3,1,2
"Switzerland",24,1,6,7,4,3,1
"France",24,3,5,5,1,4,1
"Germany",24,3,5,2,1,1,2
"Spain",24,6,9,5,2,3,1
"Colombia",24,6,3,4,4,0,2
"Mexico",25,1,7,7,1,6,1
"Chile",25,1,7,4,2,2,2
"Brazil",25,8,6,7,2,5,1
"Nigeria",25,8,4,2,2,0,2
"Brazil",26,4,7,7,4,3,2
"Netherlands",26,4,7,7,3,4,1
"Korea Republic",27,5,9,7,2,5,1
"Brazil",27,5,2,2,3,-1,2
"Wales",28,1,6,4,2,2,1
"Croatia",28,1,4,4,2,2,2
"France",28,6,5,4,2,2,1
"Australia",28,6,4,4,3,1,2
"England",28,7,7,4,1,3,2
"Switzerland",28,7,7,5,1,4,1
"Brazil",29,6,7,7,2,5,1
"Mexico",29,6,4,4,4,0,2
"Portugal",30,7,6,5,2,3,1
"Croatia",30,7,6,3,4,-1,2
"England",30,8,9,7,3,4,1
"Colombia",30,8,3,6,6,0,2
"Qatar",31,1,7,3,1,2,2
"Italy",31,1,7,8,1,7,1
"Germany",31,5,5,5,4,1,2
"Australia",31,5,5,4,2,2,1
"Belgium",33,2,7,4,1,3,2
"Netherlands",33,2,7,4,0,4,1
"France",33,4,7,9,5,4,1
"Italy",33,4,7,5,2,3,2
"England",33,5,9,7,2,5,1
"Colombia",33,5,4,7,4,3,2
"Brazil",33,6,9,6,0,6,1
"Japan",33,6,4,2,2,0,2
"Brazil",34,2,6,5,2,3,1
"Japan",34,2,6,5,3,2,2
"Iran",34,3,6,3,3,0,1
"Croatia",34,3,4,3,2,1,2
"Argentina",34,5,6,4,3,1,1
"Mexico",34,5,4,4,3,1,2
"Denmark",35,1,5,4,2,2,1
"Qatar",35,1,4,2,1,1,2
"Belgium",35,2,9,7,1,6,1
"Uruguay",35,2,3,6,5,1,2
"Brazil",35,4,6,7,5,2,1
"Jamaica",35,4,4,4,3,1,2
"Germany",37,1,9,6,1,5,1
"Poland",37,1,3,4,3,1,2
"Spain",37,2,7,4,2,2,2
"Korea Republic",37,2,7,7,4,3,1
"Argentina",37,4,5,5,4,1,2
"Denmark",37,4,5,4,2,2,1
"Portugal",37,7,9,7,3,4,1
"Colombia",37,7,3,5,5,0,2
"Uruguay",38,1,6,7,2,5,1
"Wales",38,1,6,4,6,-2,2
"Korea Republic",38,2,7,6,2,4,1
"Argentina",38,2,4,4,4,0,2
"Spain",38,3,6,5,3,2,2
"Chile",38,3,6,6,2,4,1
"Belgium",38,6,9,8,1,7,1
"Algeria",38,6,4,5,5,0,2
"Netherlands",40,1,6,4,1,3,1
"Tunisia",40,1,6,4,3,1,2
"Argentina",40,2,9,7,1,6,1
"Italy",40,2,4,3,3,0,2
"Portugal",40,4,6,8,3,5,1
"Uruguay",40,4,6,7,6,1,2
"Mexico",40,5,6,3,2,1,1
"Brazil",40,5,4,7,4,3,2
"France",40,6,9,7,1,6,1
"Colombia",40,6,4,2,1,1,2
"Croatia",40,7,6,6,4,2,1
"Belgium",40,7,4,5,4,1,2
"Colombia",41,1,5,3,1,2,1
"Tunisia",41,1,5,1,0,1,2
"Argentina",41,4,7,6,3,3,1
"Poland",41,4,7,7,5,2,2
"Poland",42,1,7,2,0,2,1
"Uruguay",42,1,4,8,3,5,2
"Spain",42,3,5,3,1,2,1
"Croatia",42,3,4,3,1,2,2
"Italy",43,3,6,6,4,2,1
"England",43,3,4,5,3,2,2
"Spain",43,6,7,4,1,3,1
"Australia",43,6,4,4,3,1,2
"Wales",43,7,5,4,3,1,1
"Portugal",43,7,4,3,4,-1,2
"England",44,2,6,4,1,3,1
"Iran",44,2,6,6,4,2,2
"Argentina",44,5,5,8,5,3,2
"Croatia",44,5,5,8,4,4,1
"France",44,6,7,9,2,7,1
"Germany",44,6,7,4,2,2,2
"Portugal",44,7,6,8,6,2,2
"Denmark",44,7,6,7,3,4,1
"Mexico",45,3,5,4,3,1,1
"Korea Republic",45,3,4,4,3,1,2
"England",45,8,6,4,2,2,1
"Senegal",45,8,6,5,5,0,2
"Spain",46,6,7,4,0,4,1
"Iran",46,6,4,5,5,0,2
"Italy",47,1,7,7,0,7,1
"United States",47,1,4,3,4,-1,2
"England",47,3,6,5,3,2,2
"Uruguay",47,3,6,4,1,3,1
"Spain",47,5,9,11,2,9,1
"Japan",47,5,4,3,2,1,2
"Belgium",47,7,7,6,4,2,2
"Switzerland",47,7,7,7,3,4,1
"Netherlands",47,8,9,4,0,4,1
"Portugal",47,8,4,2,1,1,2
"Croatia",48,2,7,4,1,3,1
"Belgium",48,2,4,4,3,1,2
"Argentina",48,4,7,5,2,3,1
"Australia",48,4,4,5,5,0,2
"Spain",48,5,6,4,2,2,1
"Korea Republic",48,5,6,3,2,1,2
"Netherlands",48,6,6,7,2,5,1
"Japan",48,6,6,3,1,2,2
"Netherlands",49,2,6,6,2,4,1
"Jamaica",49,2,6,2,4,-2,2
"Belgium",50,2,6,5,2,3,1
"Chile",50,2,4,2,2,0,2
"Qatar",51,1,7,5,3,2,2
"Morocco",51,1,7,6,2,4,1
"Denmark",51,3,5,6,3,3,1
"Japan",51,3,5,5,3,2,2
"France",51,5,6,7,2,5,1
"Italy",51,5,4,1,2,-1,2
"Uruguay",51,7,6,5,3,2,1
"Wales",51,7,4,2,1,1,2
"Argentina",52,2,7,7,2,5,1
"Mexico",52,2,4,4,4,0,2
"Italy",52,3,6,4,1,3,1
"Chile",52,3,4,5,3,2,2
"Brazil",52,4,6,9,3,6,1
"Senegal",52,4,6,6,2,4,2
"Belgium",52,8,9,14,1,13,1
"Switzerland",52,8,4,4,5,-1,2
"Colombia",53,1,4,2,1,1,1
"Poland",53,1,4,2,2,0,2
"Brazil",53,2,5,5,2,3,1
"Denmark",53,2,5,4,3,1,2
"Germany",53,5,5,5,2,3,1
"Australia",53,5,5,2,0,2,2
"Portugal",53,8,6,6,3,3,1
"Chile",53,8,6,5,3,2,2
"Argentina",54,3,7,3,1,2,2
"Denmark",54,3,7,6,2,4,1
"Belgium",54,6,9,3,0,3,1
"Iran",54,6,3,4,4,0,2
"Qatar",55,1,6,3,2,1,2
"Chile",55,1,6,5,2,3,1
"England",55,4,9,7,0,7,1
"Switzerland",55,4,4,3,2,1,2
"Colombia",55,6,6,4,2,2,1
"Portugal",55,6,4,3,1,2,2
"France",55,8,5,4,3,1,1
"Italy",55,8,4,4,2,2,2
"France",56,4,5,3,2,1,1
"Italy",56,4,4,4,3,1,2
"Wales",57,4,6,4,3,1,1
"Spain",57,4,4,5,4,1,2
"Brazil",57,6,7,7,3,4,1
"Croatia",57,6,7,3,1,2,2
"France",57,8,9,5,1,4,1
"Iran",57,8,4,2,2,0,2
"Brazil",58,3,7,4,0,4,1
"Croatia",58,3,7,4,1,3,2
"Algeria",58,6,5,3,2,1,1
"Spain",58,6,4,5,3,2,2
"Denmark",58,8,9,5,2,3,1
"Portugal",58,8,4,5,3,2,2
"Spain",59,2,7,6,2,4,1
"Italy",59,2,7,4,1,3,2
"Belgium",59,8,6,5,2,3,1
"Germany",59,8,6,5,4,1,2
"Italy",60,3,7,4,1,3,1
"Argentina",60,3,4,5,2,3,2
"Spain",60,6,5,6,4,2,1
"Poland",60,6,4,3,3,0,2
"Uruguay",60,8,7,8,4,4,1
"England",60,8,4,3,3,0,2
"Costa Rica",61,1,6,6,6,0,1
"Senegal",61,1,4,6,3,3,2
"Poland",61,2,9,5,1,4,1
"Italy",61,2,4,7,3,4,2
"Mexico",61,5,6,2,1,1,1
"Argentina",61,5,4,4,1,3,2
"France",62,2,5,3,1,2,1
"Algeria",62,2,4,3,3,0,2
"Denmark",62,3,6,3,3,0,2
"Switzerland",62,3,6,5,3,2,1
"Spain",62,7,7,8,3,5,1
"Italy",62,7,7,6,2,4,2
"England",62,8,5,3,2,1,1
"Iran",62,8,4,3,2,1,2
"France",63,2,7,5,1,4,1
"Iran",63,2,7,5,2,3,2
"Korea Republic",63,3,5,6,5,1,1
"Wales",63,3,4,5,4,1,2
"Portugal",63,5,7,5,2,3,1
"Japan",63,5,4,5,1,4,2
"Uruguay",63,8,9,8,0,8,1
"United States",63,8,4,4,4,0,2
"Croatia",64,1,5,1,0,1,1
"Poland",64,1,4,2,2,0,2
"Brazil",64,2,7,5,2,3,1
"Senegal",64,2,7,4,2,2,2
"Germany",65,3,7,3,1,2,2
"Wales",65,3,7,5,1,4,1
"Algeria",65,5,5,2,1,1,1
"Netherlands",65,5,4,4,3,1,2
"Denmark",65,6,7,9,2,7,1
"Poland",65,6,7,6,0,6,2
"Mexico",66,1,6,7,2,5,1
"Wales",66,1,6,6,2,4,2
"Japan",67,2,7,7,2,5,1
"Belgium",67,2,4,6,3,3,2
"Chile",67,8,5,3,1,2,1
"France",67,8,4,3,2,1,2
"Qatar",68,1,5,2,1,1,1
"Colombia",68,1,4,4,1,3,2
"Nigeria",68,5,5,2,1,1,1
"Netherlands",68,5,4,5,4,1,2
"Costa Rica",69,1,5,3,1,2,1
"Qatar",69,1,4,3,3,0,2
"France",69,6,9,9,1,8,1
"Japan",69,6,4,3,3,0,2
"Argentina",69,7,6,3,1,2,1
"Denmark",69,7,4,3,3,0,2
"Italy",70,2,4,3,1,2,1
"Iran",70,2,4,4,4,0,2
"England",70,7,6,4,3,1,2
"Senegal",70,7,6,5,3,2,1
"Portugal",71,3,5,8,7,1,2
"Uruguay",71,3,5,6,4,2,1
"Qatar",72,1,6,3,2,1,1
"Costa Rica",72,1,4,1,1,0,2
"France",72,3,6,9,2,7,1
"Germany",72,3,4,7,7,0,2
"Argentina",72,4,6,5,3,2,1
"Iran",72,4,6,4,3,1,2
"Germany",73,1,6,6,5,1,1
"Qatar",73,1,4,4,3,1,2
"France",73,2,9,5,0,5,1
"Poland",73,2,4,2,2,0,2
"Portugal",73,5,7,5,1,4,1
"Colombia",73,5,7,3,0,3,2
"Spain",73,7,6,6,2,4,1
"Uruguay",73,7,6,4,4,0,2
"Argentina",73,8,7,9,1,8,1
"Australia",73,8,4,3,3,0,2
"Germany",74,2,7,8,5,3,1
"Iran",74,2,7,5,3,2,2
"Spain",76,4,6,2,1,1,2
"Mexico",76,4,6,4,1,3,1
"Germany",77,2,6,4,3,1,1
"United States",77,2,6,6,6,0,2
"Brazil",77,3,6,9,3,6,1
"Costa Rica",77,3,6,2,1,1,2
"France",77,5,7,6,2,4,2
"Netherlands",77,5,7,7,2,5,1
"Colombia",77,7,6,8,5,3,1
"Morocco",77,7,6,5,3,2,2
"Belgium",78,3,7,4,1,3,1
"Senegal",78,3,4,3,2,1,2
"Japan",78,4,7,6,2,4,1
"Netherlands",78,4,4,4,4,0,2
"United States",79,1,7,8,2,6,1
"Netherlands",79,1,4,2,2,0,2
"Brazil",79,3,7,14,3,11,1
"Poland",79,3,7,9,4,5,2
"England",79,8,5,3,1,2,1
"Denmark",79,8,5,2,1,1,2
"France",80,4,9,6,1,5,1
"Chile",80,4,2,3,4,-1,2
"Argentina",80,5,9,8,2,6,1
"Mexico",80,5,4,4,2,2,2
"Uruguay",80,6,6,5,5,0,2
"Switzerland",80,6,6,4,3,1,1
"Netherlands",81,6,6,5,2,3,1
"Wales",81,6,4,2,1,1,2
"Iran",81,7,9,6,1,5,1
"Denmark",81,7,4,5,2,3,2
"Portugal",82,4,7,5,1,4,2
"Netherlands",82,4,7,6,1,5,1
"Denmark",82,6,5,4,2,2,1
"Tunisia",82,6,4,5,3,2,2
"Croatia",83,4,6,5,4,1,2
"Chile",83,4,6,5,3,2,1
"France",83,5,5,3,1,2,2
"Italy",83,5,5,6,1,5,1
"Uruguay",84,2,6,5,2,3,1
"Wales",84,2,6,5,4,1,2
"Portugal",84,8,6,9,3,6,1
"Denmark",84,8,4,2,3,-1,2
"Netherlands",86,3,5,4,2,2,2
"Chile",86,3,5,8,5,3,1
"Brazil",86,6,7,4,1,3,1
"Mexico",86,6,7,4,2,2,2
"Uruguay",87,2,6,5,3,2,2
"Japan",87,2,6,7,3,4,1
"France",88,8,7,5,0,5,1
"Italy",88,8,4,2,1,1,2
"Brazil",89,7,6,6,3,3,1
"Japan",89,7,6,2,2,0,2
"Netherlands",91,2,7,5,1,4,1
"Argentina",91,2,4,3,1,2,2
"Brazil",91,6,6,5,1,4,1
"Wales",91,6,6,6,3,3,2
"Mexico",92,1,7,11,4,7,1
"Poland",92,1,4,5,6,-1,2
"Korea Republic",92,2,6,5,6,-1,1
"Chile",92,2,4,4,3,1,2
"France",92,5,6,3,2,1,1
"Netherlands",92,5,4,4,2,2,2
"Portugal",92,6,7,3,0,3,2
"Colombia",92,6,7,6,1,5,1
"Wales",93,1,9,9,1,8,1
"Nigeria",93,1,3,1,2,-1,2
"France",93,5,6,10,5,5,1
"Germany",93,5,4,5,5,0,2
"Colombia",94,4,6,5,3,2,1
"Iran",94,4,4,3,2,1,2
"Spain",94,5,7,4,2,2,1
"Morocco",94,5,4,5,3,2,2
"Senegal",94,7,5,5,4,1,1
"Denmark",94,7,4,4,2,2,2
"France",95,2,5,3,2,1,1
"Uruguay",95,2,4,5,4,1,2
"Netherlands",95,3,5,5,3,2,1
"Iran",95,3,5,4,3,1,2
"Netherlands",96,5,9,5,2,3,1
"Argentina",96,5,3,4,3,1,2
"Mexico",96,6,7,5,2,3,2
"Korea Republic",96,6,7,7,2,5,1
"Belgium",97,8,6,6,1,5,1
"Chile",97,8,6,5,2,3,2
"Japan",98,2,6,4,2,2,1
"Algeria",98,2,6,6,6,0,2
"Uruguay",98,7,6,5,5,0,2
"Switzerland",98,7,6,6,5,1,1
"Netherlands",99,6,6,4,2,2,1
"Algeria",99,6,6,2,2,0,2
"Germany",100,1,9,4,0,4,1
"Qatar",100,1,4,5,5,0,2
"Spain",100,4,9,7,0,7,1
"Uruguay",100,4,3,5,4,1,2
"Denmark",100,5,9,8,1,7,1
"Australia",100,5,3,5,5,0,2
"Portugal",101,3,4,3,3,0,2
"Croatia",101,3,4,2,1,1,1
"Mexico",101,6,9,7,1,6,1
"Senegal",101,6,3,4,4,0,2
"Spain",101,8,7,4,1,3,2
"Uruguay",101,8,7,9,0,9,1
"Argentina",102,4,6,5,2,3,1
"Croatia",102,4,6,4,2,2,2
"Portugal",102,8,6,9,5,4,1
"Netherlands",102,8,6,5,3,2,2
"Qatar",103,1,7,8,2,6,1
"Colombia",103,1,7,6,2,4,2
"France",103,2,6,4,1,3,1
"Poland",103,2,6,2,1,1,2
"Brazil",103,7,4,5,2,3,2
"Croatia",103,7,4,5,1,4,1
"Spain",103,8,9,9,1,8,1
"Italy",103,8,4,6,5,1,2
"Portugal",104,5,6,4,2,2,1
"Colombia",104,5,6,4,3,1,2
"Argentina",104,7,5,2,1,1,2
"Denmark",104,7,5,3,0,3,1
"Uruguay",105,2,6,6,2,4,1
"Wales",105,2,4,4,3,1,2
"Mexico",105,6,5,4,2,2,2
"Poland",105,6,5,6,2,4,1
"France",106,6,5,1,0,1,2
"Colombia",106,6,5,6,3,3,1
"Portugal",106,8,7,6,3,3,1
"Uruguay",106,8,7,6,4,2,2
"Mexico",107,1,9,6,1,5,1
"Qatar",107,1,3,6,6,0,2
"Spain",107,8,6,7,1,6,1
"Japan",107,8,6,6,4,2,2
"Uruguay",109,1,7,8,2,6,1
"United States",109,1,7,5,1,4,2
"Brazil",109,8,7,7,2,5,1
"Switzerland",109,8,4,3,3,0,2
"Portugal",110,2,6,5,4,1,2
"Denmark",110,2,6,5,3,2,1
"Mexico",110,3,7,4,1,3,1
"Argentina",110,3,4,2,2,0,2
"Denmark",111,3,7,5,2,3,1
"Senegal",111,3,4,6,5,1,2
"France",111,5,5,5,3,2,2
"Italy",111,5,5,5,2,3,1
"Belgium",111,6,7,5,0,5,1
"Colombia",111,6,4,3,1,2,2
"France",113,3,6,3,2,1,2
"Uruguay",113,3,6,5,2,3,1
"Spain",113,6,6,8,3,5,1
"Senegal",113,6,6,4,6,-2,2
"Belgium",114,3,7,7,3,4,2
"Uruguay",114,3,7,6,1,5,1
"England",115,3,5,5,4,1,1
"Japan",115,3,4,5,4,1,2
"Portugal",115,5,5,5,0,5,1
"Netherlands",115,5,5,4,2,2,2
"Spain",115,7,9,9,1,8,1
"Croatia",115,7,3,2,3,-1,2
"Netherlands",116,4,6,4,2,2,1
"Australia",116,4,6,3,2,1,2
"Denmark",116,5,6,8,3,5,1
"Switzerland",116,5,6,4,2,2,2
"Germany",116,6,6,5,2,3,1
"Korea Republic",116,6,6,3,2,1,2
"Spain",116,8,6,5,2,3,1
"Chile",116,8,6,5,4,1,2
"Italy",117,1,6,9,4,5,1
"Senegal",117,1,6,8,4,4,2
"Croatia",117,5,5,4,2,2,1
"Japan",117,5,5,2,1,1,2
"Iran",118,3,9,8,2,6,1
"Croatia",118,3,3,4,4,0,2
"Brazil",118,4,7,4,0,4,1
"Netherlands",118,4,4,7,2,5,2
"France",118,5,6,4,5,-1,2
"Uruguay",118,5,6,7,3,4,1
"Belgium",118,7,7,10,3,7,1
"Colombia",118,7,7,7,3,4,2
"Denmark",119,1,9,8,0,8,1
"Qatar",119,1,3,2,3,-1,2
"Brazil",119,4,5,6,3,3,1
"Netherlands",119,4,5,4,3,1,2
"Germany",121,2,9,9,2,7,1
"Portugal",121,2,4,3,3,0,2
"Spain",121,3,6,4,2,2,2
"Netherlands",121,3,6,7,2,5,1
"Australia",121,5,6,6,5,1,1
"England",121,5,4,7,5,2,2
"Uruguay",122,1,6,8,3,5,1
"Costa Rica",122,1,6,6,4,2,2
"Switzerland",122,3,7,7,3,4,1
"England",122,3,4,5,5,0,2
"Netherlands",123,8,5,5,2,3,1
"Chile",123,8,5,3,1,2,2
"Mexico",124,2,6,4,2,2,1
"Argentina",124,2,4,2,2,0,2
"Spain",124,6,6,2,2,0,2
"Chile",124,6,6,6,5,1,1
"England",124,7,7,5,3,2,1
"Italy",124,7,4,3,2,1,2
"Argentina",125,5,6,7,2,5,1
"Korea Republic",125,5,4,1,2,-1,2
"England",125,6,9,6,1,5,1
"Wales",125,6,3,4,5,-1,2
"Uruguay",126,1,9,8,1,7,1
"Switzerland",126,1,4,5,2,3,2
"Portugal",127,3,6,2,1,1,2
"Mexico",127,3,6,6,1,5,1
"Spain",127,4,5,6,2,4,1
"Netherlands",127,4,4,5,2,3,2
"Uruguay",127,5,6,6,4,2,1
"England",127,5,4,3,3,0,2
"Italy",128,2,6,5,2,3,2
"Korea Republic",128,2,6,5,1,4,1
"Uruguay",128,3,7,8,1,7,1
"Senegal",128,3,7,6,4,2,2
"Argentina",128,6,6,7,4,3,1
"Netherlands",128,6,4,5,5,0,2
"Spain",128,8,6,3,2,1,1
"Nigeria",128,8,4,3,2,1,2
"Germany",129,1,5,3,1,2,1
"Tunisia",129,1,4,3,2,1,2
"Portugal",129,5,7,6,2,4,1
"Morocco",129,5,7,6,3,3,2
"Brazil",129,6,6,5,2,3,1
"Denmark",129,6,4,3,3,0,2
"France",129,8,7,4,1,3,2
"Uruguay",129,8,7,5,1,4,1
"Netherlands",131,8,5,4,0,4,1
"Tunisia",131,8,4,2,2,0,2
"Uruguay",132,4,6,6,4,2,1
"Switzerland",132,4,4,3,3,0,2
"Brazil",132,6,7,7,1,6,2
"Netherlands",132,6,7,9,2,7,1
"Uruguay",133,1,6,2,1,1,2
"Senegal",133,1,6,3,1,2,1
"France",133,4,7,6,1,5,1
"Netherlands",133,4,4,3,2,1,2
"Argentina",133,5,6,6,4,2,2
"Japan",133,5,6,5,2,3,1
"England",133,6,6,7,5,2,2
"Iran",133,6,6,9,4,5,1
"Spain",133,8,9,8,0,8,1
"Switzerland",133,8,4,2,2,0,2
"Belgium",134,4,7,8,2,6,1
"Australia",134,4,7,6,4,2,2
"Morocco",135,2,5,1,0,1,1
"Mexico",135,2,4,6,5,1,2
"France",135,6,6,3,2,1,2
"Italy",135,6,6,8,1,7,1
"Iran",135,7,5,5,1,4,1
"Portugal",135,7,4,4,2,2,2
"Poland",136,1,7,7,2,5,1
"Nigeria",136,1,4,4,3,1,2
"Argentina",136,4,6,7,6,1,1
"Germany",136,4,4,8,6,2,2
"Netherlands",136,8,6,4,3,1,2
"Switzerland",136,8,6,8,3,5,1
"Mexico",137,2,5,4,2,2,1
"Brazil",137,2,4,6,4,2,2
"France",137,4,5,9,4,5,1
"United States",137,4,5,4,3,1,2
"Morocco",137,6,5,2,1,1,1
"Poland",137,6,4,3,2,1,2
"France",138,2,9,7,0,7,1
"Senegal",138,2,4,1,1,0,2
"Argentina",138,5,6,4,2,2,1
"Iran",138,5,4,4,3,1,2
"Argentina",139,4,6,4,1,3,1
"Italy",139,4,6,3,1,2,2
"Spain",139,5,9,10,1,9,1
"Colombia",139,5,3,5,7,-2,2
"Denmark",140,4,7,7,1,6,1
"France",140,4,4,2,2,0,2
"England",140,7,7,5,2,3,2
"Wales",140,7,7,6,2,4,1
"Spain",140,8,6,5,2,3,1
"Uruguay",140,8,6,4,2,2,2
"Denmark",141,1,9,5,0,5,1
"Qatar",141,1,4,5,3,2,2
"Japan",141,2,7,6,2,4,1
"Germany",141,2,4,3,2,1,2
"France",141,4,9,6,1,5,1
"Korea Republic",141,4,4,4,3,1,2
"Colombia",141,5,5,4,3,1,1
"Portugal",141,5,4,3,3,0,2
"Croatia",141,6,9,7,2,5,1
"Chile",141,6,4,4,4,0,2
"Argentina",141,7,7,7,2,5,1
"Switzerland",141,7,7,7,3,4,2
"Spain",141,8,9,5,1,4,1
"Netherlands",141,8,4,5,2,3,2
"Colombia",142,1,9,8,3,5,1
"Nigeria",142,1,3,4,4,0,2
"Portugal",142,7,6,3,4,-1,1
"Mexico",142,7,4,4,2,2,2
"Brazil",142,8,9,9,2,7,1
"Germany",142,8,3,3,4,-1,2
"Italy",143,1,6,3,3,0,2
"Morocco",143,1,6,5,4,1,1
"France",143,3,6,6,2,4,1
"Switzerland",143,3,6,2,2,0,2
"Morocco",144,1,6,6,2,4,1
"Denmark",144,1,4,3,2,1,2
"Mexico",144,6,6,6,4,2,1
"Switzerland",144,6,4,4,4,0,2
"Italy",145,1,9,6,1,5,1
"Poland",145,1,4,4,2,2,2
"Netherlands",145,4,9,10,0,10,1
"Argentina",145,4,4,4,2,2,2
"England",146,2,7,6,2,4,2
"Senegal",146,2,7,9,1,8,1
"Portugal",147,4,9,7,1,6,1
"Senegal",147,4,4,2,2,0,2
"Algeria",148,6,5,4,3,1,1
"Wales",148,6,4,3,2,1,2
"Brazil",148,8,9,4,0,4,1
"Germany",148,8,4,5,3,2,2
"Belgium",149,5,9,9,1,8,1
"Iran",149,5,3,3,4,-1,2
"Argentina",149,7,9,9,1,8,1
"Senegal",149,7,3,4,5,-1,2
"Germany",149,8,6,5,6,-1,2
"Wales",149,8,6,6,3,3,1
"Netherlands",150,1,5,4,1,3,1
"Jamaica",150,1,4,5,4,1,2
"England",151,7,9,7,2,5,1
"Uruguay",151,7,3,4,3,1,2
"Spain",151,8,7,4,2,2,2
"Mexico",151,8,7,7,1,6,1
"Japan",152,5,9,5,1,4,1
"Portugal",152,5,4,3,2,1,2
"Spain",152,6,6,7,5,2,1
"Chile",152,6,4,5,3,2,2
"France",152,8,9,8,2,6,1
"Wales",152,8,4,4,4,0,2
"Uruguay",153,1,9,8,0,8,1
"Poland",153,1,3,3,3,0,2
"Belgium",153,4,6,5,3,2,2
"Netherlands",153,4,6,6,2,4,1
"Brazil",153,8,6,6,2,4,1
"Wales",153,8,6,4,2,2,2
"Tunisia",154,3,5,2,1,1,1
"Denmark",154,3,4,5,3,2,2
"Colombia",154,7,6,2,1,1,1
"Portugal",154,7,4,5,1,4,2
"Denmark",155,1,7,8,4,4,1
"Qatar",155,1,4,5,5,0,2
"Iran",155,8,5,3,1,2,1
"Portugal",155,8,4,2,1,1,2
"Belgium",156,2,6,7,3,4,1
"Germany",156,2,6,2,3,-1,2
"Spain",156,4,6,9,2,7,1
"Uruguay",156,4,6,5,3,2,2
"Portugal",156,7,6,7,4,3,2
"Netherlands",156,7,6,7,3,4,1
"Uruguay",157,1,6,8,4,4,1
"Poland",157,1,6,6,5,1,2
"Brazil",157,6,6,7,1,6,1
"Germany",157,6,6,6,3,3,2
"Argentina",158,5,7,4,2,2,2
"Mexico",158,5,7,6,0,6,1
"Uruguay",158,6,7,6,1,5,1
"Spain",158,6,4,4,4,0,2
"Switzerland",158,7,5,5,3,2,1
"Croatia",158,7,4,5,3,2,2
"Morocco",159,5,6,5,4,1,1
"Colombia",159,5,4,4,3,1,2
"Germany",159,8,6,6,3,3,1
"Belgium",159,8,4,2,2,0,2
"Netherlands",160,3,7,3,0,3,1
"Belgium",160,3,4,5,4,1,2
"Brazil",161,6,6,8,3,5,1
"Costa Rica",161,6,4,3,3,0,2
"Portugal",161,8,7,3,0,3,1
"Italy",161,8,4,2,2,0,2
"Portugal",162,4,5,6,2,4,1
"Poland",162,4,5,3,1,2,2
"Iran",162,6,9,5,1,4,1
"Croatia",162,6,3,6,4,2,2
"Argentina",163,2,6,6,2,4,1
"Italy",163,2,6,6,3,3,2
"France",163,5,7,7,1,6,1
"Australia",163,5,7,5,1,4,2
"Portugal",163,7,5,3,1,2,1
"Uruguay",163,7,5,3,2,1,2
"Brazil",164,2,6,6,2,4,1
"Poland",164,2,4,4,4,0,2
"Portugal",164,3,5,5,1,4,1
"Netherlands",164,3,5,3,0,3,2
"Spain",164,5,6,4,3,1,1
"Algeria",164,5,4,6,5,1,2
"Colombia",165,1,9,7,2,5,1
"Qatar",165,1,3,7,8,-1,2
"Netherlands",165,2,5,6,2,4,1
"Japan",165,2,5,2,0,2,2
"Spain",165,3,7,6,1,5,1
"Wales",165,3,4,5,4,1,2
"United States",165,7,6,5,3,2,1
"Denmark",165,7,4,4,4,0,2
"Belgium",166,2,9,6,1,5,1
"Uruguay",166,2,4,6,2,4,2
"Spain",166,5,6,8,4,4,1
"Morocco",166,5,4,6,3,3,2
"Iran",167,2,6,3,1,2,1
"Netherlands",167,2,4,4,4,0,2
"Croatia",167,3,7,5,3,2,1
"Argentina",167,3,4,4,2,2,2
"Denmark",167,6,6,4,2,2,1
"Belgium",167,6,4,4,2,2,2
"Mexico",168,2,6,5,1,4,1
"England",168,2,4,5,4,1,2
"France",168,6,9,7,2,5,1
"Switzerland",168,6,3,4,5,-1,2
"Netherlands",169,6,7,4,2,2,1
"Iran",169,6,4,3,2,1,2
"Germany",169,7,9,6,2,4,1
"Korea Republic",169,7,4,2,2,0,2
"Netherlands",170,2,4,4,4,0,2
"Japan",170,2,4,7,6,1,1
"Germany",170,4,6,5,2,3,1
"Spain",170,4,4,3,2,1,2
"Argentina",170,5,7,6,3,3,1
"Wales",170,5,4,2,2,0,2
"England",170,8,6,7,6,1,2
"Mexico",170,8,6,7,5,2,1
"Germany",171,1,6,7,4,3,1
"Jamaica",171,1,6,5,3,2,2
"Argentina",171,7,6,3,1,2,1
"Netherlands",171,7,6,4,3,1,2
"England",172,5,6,5,2,3,1
"Uruguay",172,5,6,4,2,2,2
"Colombia",173,1,7,7,2,5,1
"Morocco",173,1,4,5,4,1,2
"Portugal",173,4,7,3,1,2,2
"Korea Republic",173,4,7,4,1,3,1
"France",173,6,7,5,2,3,1
"Uruguay",173,6,4,4,2,2,2
"Belgium",173,7,7,13,2,11,1
"Germany",173,7,7,7,3,4,2
"Argentina",173,8,6,7,3,4,1
"Italy",173,8,6,4,5,-1,2
"Brazil",174,2,6,6,5,1,2
"Netherlands",174,2,6,9,4,5,1
"Germany",174,3,9,5,0,5,1
"France",174,3,3,4,3,1,2
"Argentina",174,5,7,5,1,4,2
"Denmark",174,5,7,8,1,7,1
"Denmark",175,1,6,5,2,3,1
"Chile",175,1,6,2,2,0,2
"Brazil",175,3,9,6,1,5,1
"Croatia",175,3,4,4,4,0,2
"Italy",175,4,7,4,0,4,1
"Korea Republic",175,4,4,2,2,0,2
"Mexico",175,7,6,5,6,-1,2
"Australia",175,7,6,7,4,3,1
"Belgium",175,8,6,4,3,1,1
"Netherlands",175,8,4,5,3,2,2
"Portugal",176,5,6,2,1,1,1
"Chile",176,5,6,2,2,0,2
"England",177,3,7,6,1,5,1
"Netherlands",177,3,7,3,1,2,2
"England",178,6,5,7,3,4,1
"Denmark",178,6,4,5,4,1,2
"Netherlands",178,8,7,3,1,2,1
"Switzerland",178,8,4,6,2,4,2
"Uruguay",179,4,7,7,1,6,1
"Belgium",179,4,4,5,3,2,2
"Brazil",180,3,6,5,1,4,1
"Germany",180,3,4,6,5,1,2
"Spain",180,5,9,5,1,4,1
"Japan",180,5,3,4,4,0,2
"Qatar",181,1,6,3,5,-2,2
"Netherlands",181,1,6,8,2,6,1
"France",181,6,7,6,3,3,1
"United States",181,6,4,6,4,2,2
"Uruguay",182,4,6,5,4,1,1
"Australia",182,4,6,3,4,-1,2
"Spain",182,6,6,6,3,3,1
"Colombia",182,6,4,4,3,1,2
"England",183,8,7,7,4,3,2
"Italy",183,8,7,6,2,4,1
"Croatia",184,1,6,5,4,1,1
"Jamaica",184,1,4,4,4,0,2
"France",185,5,7,9,2,7,1
"Wales",185,5,7,4,2,2,2
"Belgium",185,7,9,6,0,6,1
"Korea Republic",185,7,4,2,2,0,2
"Spain",186,5,9,10,2,8,1
"Colombia",186,5,4,4,4,0,2
"Spain",187,6,9,3,0,3,1
"Italy",187,6,3,4,3,1,2
"France",187,8,7,8,3,5,1
"United States",187,8,4,5,4,1,2
"Brazil",188,2,7,6,2,4,1
"Italy",188,2,4,4,3,1,2
"Spain",188,5,7,7,1,6,1
"Denmark",188,5,4,3,3,0,2
"Senegal",188,8,9,5,1,4,1
"Belgium",188,8,4,3,2,1,2
"Wales",189,4,6,4,2,2,1
"Belgium",189,4,4,3,1,2,2
"Portugal",189,5,6,9,2,7,1
"Morocco",189,5,6,2,5,-3,2
"Poland",189,6,7,4,2,2,1
"Argentina",189,6,4,4,3,1,2
"Spain",189,8,6,7,5,2,2
"Netherlands",189,8,6,8,3,5,1
"Croatia",190,1,6,6,2,4,1
"Senegal",190,1,4,2,2,0,2
"England",190,8,7,6,2,4,1
"Iran",190,8,4,3,2,1,2
"Qatar",191,1,5,6,3,3,1
"Netherlands",191,1,5,3,1,2,2
"Mexico",191,2,6,5,3,2,2
"Korea Republic",191,2,6,6,3,3,1
"Denmark",191,3,6,7,4,3,1
"Australia",191,3,6,4,3,1,2
"France",191,4,9,7,1,6,1
"Germany",191,4,3,5,4,1,2
"Belgium",191,7,6,7,5,2,1
"Wales",191,7,6,3,3,0,2
"Brazil",192,5,9,8,4,4,1
"Mexico",192,5,4,1,1,0,2
"Croatia",192,6,5,4,3,1,1
"Switzerland",192,6,4,5,4,1,2
"Colombia",193,1,9,8,3,5,1
"Jamaica",193,1,3,4,4,0,2
"Portugal",193,2,5,4,2,2,1
"Chile",193,2,5,4,3,1,2
"Italy",194,1,9,10,2,8,1
"Qatar",194,1,4,3,4,-1,2
"United States",194,4,6,4,3,1,1
"Argentina",194,4,4,3,1,2,2
"Japan",194,5,9,5,1,4,1
"France",194,5,4,4,3,1,2
"England",194,8,6,2,1,1,2
"Netherlands",194,8,6,6,2,4,1
"Qatar",195,1,6,5,2,3,1
"Croatia",195,1,6,5,3,2,2
"Portugal",195,2,9,5,2,3,1
"Iran",195,2,4,6,4,2,2
"Spain",195,6,9,6,0,6,1
"Italy",195,6,4,3,3,0,2
"England",195,8,5,2,1,1,1
"United States",195,8,4,4,3,1,2
"Portugal",196,2,4,4,3,1,1
"Croatia",196,2,4,3,3,0,2
"Belgium",196,6,7,5,1,4,1
"Denmark",196,6,7,2,0,2,2
"Mexico",197,1,6,5,3,2,1
"Wales",197,1,6,7,6,1,2
"France",197,3,7,6,2,4,1
"Uruguay",197,3,4,3,2,1,2
"Netherlands",197,6,9,8,2,6,1
"Spain",197,6,4,6,3,3,2
"Australia",199,2,5,6,4,2,1
"England",199,2,4,4,4,0,2
"Brazil",199,3,7,8,3,5,1
"Germany",199,3,4,6,4,2,2
"Argentina",199,6,6,7,2,5,1
"Croatia",199,6,6,8,4,4,2
"Mexico",200,1,6,5,4,1,1
"Chile",200,1,4,4,3,1,2
"Spain",200,2,5,1,0,1,1
"Australia",200,2,4,5,4,1,2
"Brazil",200,4,9,9,2,7,1
"Wales",200,4,4,4,4,0,2
"Portugal",200,5,6,4,2,2,1
"Colombia",200,5,6,4,3,1,2
"France",200,6,7,4,1,3,2
"Denmark",200,6,7,6,1,5,1
"Switzerland",201,4,6,3,3,0,1
"Iran",201,4,4,4,3,1,2
"Uruguay",201,5,5,3,1,2,1
"Wales",201,5,4,8,5,3,2
"Spain",202,2,6,4,2,2,2
"Germany",202,2,6,6,3,3,1
"Portugal",202,3,5,6,3,3,1
"Iran",202,3,5,5,3,2,2
"England",204,2,6,6,3,3,2
"Croatia",204,2,6,9,4,5,1
"Qatar",205,1,6,5,2,3,1
"Germany",205,1,6,5,3,2,2
"England",205,4,7,3,1,2,2
"Japan",205,4,7,5,2,3,1
"Argentina",205,5,7,5,1,4,1
"Netherlands",205,5,7,7,4,3,2
"Spain",205,6,5,5,1,4,1
"Uruguay",205,6,4,2,2,0,2
"Brazil",206,2,6,7,1,6,1
"Korea Republic",206,2,6,5,6,-1,2
"Australia",206,3,6,4,2,2,1
"Senegal",206,3,4,1,1,0,2
"Mexico",207,3,9,8,1,7,1
"Australia",207,3,4,5,3,2,2
"France",207,7,6,6,3,3,1
"Uruguay",207,7,6,5,3,2,2
"Spain",207,8,9,8,3,5,1
"Netherlands",207,8,4,5,3,2,2
"Italy",208,5,6,5,2,3,1
"Spain",208,5,4,3,3,0,2
"Belgium",208,6,6,8,2,6,1
"Germany",208,6,6,6,3,3,2
"Portugal",208,7,6,7,3,4,1
"Colombia",208,7,6,5,2,3,2
"Netherlands",209,8,9,7,2,5,1
"Spain",209,8,4,3,3,0,2
"Portugal",210,3,6,6,3,3,1
"Italy",210,3,4,2,2,0,2
"Spain",210,6,7,6,4,2,2
"Netherlands",210,6,7,9,3,6,1
"Iran",210,8,9,5,0,5,1
"Argentina",210,8,4,3,2,1,2
"Chile",211,1,6,2,2,0,2
"Costa Rica",211,1,6,4,3,1,1
"France",212,4,7,4,1,3,1
"Denmark",212,4,7,3,1,2,2
"Mexico",212,5,6,6,4,2,2
"Algeria",212,5,6,7,4,3,1
"Wales",213,2,6,3,2,1,1
"Algeria",213,2,6,4,4,0,2
"Uruguay",214,5,5,3,1,2,1
"Korea Republic",214,5,4,3,1,2,2
"France",214,8,6,5,1,4,1
"Chile",214,8,4,2,2,0,2
"Senegal",215,3,7,7,4,3,1
"Argentina",215,3,4,4,4,0,2
"Brazil",215,7,9,8,1,7,1
"Mexico",215,7,3,3,3,0,2
"Portugal",216,5,9,6,0,6,1
"Colombia",216,5,3,3,2,1,2
"France",216,6,6,9,5,4,1
"Italy",216,6,6,5,3,2,2
"England",216,7,9,5,0,5,1
"Switzerland",216,7,3,5,5,0,2
"Croatia",217,2,6,4,3,1,1
"Argentina",217,2,4,2,1,1,2
"England",218,2,6,5,2,3,1
"United States",218,2,6,2,4,-2,2
"Argentina",218,7,7,3,0,3,1
"Germany",218,7,7,5,3,2,2
"Mexico",219,1,6,5,2,3,1
"Algeria",219,1,6,3,4,-1,2
"Portugal",219,4,9,4,1,3,1
"Italy",219,4,4,6,3,3,2
"Germany",219,7,6,3,4,-1,2
"Switzerland",219,7,6,7,3,4,1
"Poland",220,1,5,4,3,1,1
"Italy",220,1,4,5,4,1,2
"Germany",220,2,5,4,3,1,2
"Korea Republic",220,2,5,7,3,4,1
"Spain",220,3,6,6,3,3,1
"Colombia",220,3,4,4,3,1,2
"Senegal",220,5,6,5,2,3,1
"Portugal",220,5,4,3,2,1,2
"Brazil",222,2,6,3,2,1,2
"Korea Republic",222,2,6,7,5,2,1
"England",222,4,7,6,1,5,1
"Colombia",222,4,4,4,2,2,2
"Portugal",222,7,7,8,2,6,1
"Japan",222,7,7,5,2,3,2
"Korea Republic",223,3,7,4,1,3,1
"Argentina",223,3,4,3,2,1,2
"Portugal",223,7,7,4,2,2,2
"Mexico",223,7,7,9,4,5,1
"Italy",224,2,5,4,3,1,1
"Belgium",224,2,4,3,3,0,2
"France",224,5,7,8,2,6,1
"Uruguay",224,5,7,4,0,4,2
"Brazil",224,7,7,9,2,7,1
"Mexico",224,7,7,5,2,3,2
"England",224,8,7,4,1,3,1
"Switzerland",224,8,7,5,3,2,2
"Chile",225,3,6,2,1,1,1
"France",225,3,4,4,2,2,2
"Uruguay",225,4,9,5,2,3,1
"Australia",225,4,3,3,3,0,2
"Qatar",226,1,5,3,2,1,1
"Jamaica",226,1,4,6,4,2,2
"Colombia",226,2,6,4,1,3,1
"United States",226,2,6,3,1,2,2
"Spain",226,7,6,9,4,5,1
"Switzerland",226,7,6,5,4,1,2
"Netherlands",227,1,9,8,0,8,1
"Qatar",227,1,2,1,3,-2,2
"Portugal",227,5,7,4,2,2,2
"Uruguay",227,5,7,4,1,3,1
"Germany",228,1,9,8,2,6,1
"Wales",228,1,3,3,3,0,2
"Portugal",228,2,6,4,2,2,1
"Australia",228,2,6,4,3,1,2
"England",228,6,6,4,2,2,1
"Uruguay",228,6,6,5,4,1,2
"Brazil",228,7,7,6,0,6,1
"Italy",228,7,7,3,0,3,2
"France",229,2,6,9,1,8,1
"Colombia",229,2,6,7,5,2,2
"Brazil",229,4,6,7,4,3,1
"Algeria",229,4,6,4,5,-1,2
"Australia",231,2,9,6,1,5,1
"Germany",231,2,4,5,3,2,2
"Spain",231,7,7,13,4,9,1
"Japan",231,7,4,6,6,0,2
"France",231,8,7,7,2,5,1
"Mexico",231,8,4,6,3,3,2
"Spain",232,4,7,5,2,3,1
"Uruguay",232,4,4,6,4,2,2
"Qatar",233,1,6,4,4,0,2
"Switzerland",233,1,6,3,2,1,1
"Iran",233,3,6,4,2,2,1
"Senegal",233,3,4,3,4,-1,2
"United States",233,4,7,2,0,2,1
"Argentina",233,4,4,4,3,1,2
"France",233,6,9,6,3,3,1
"Poland",233,6,3,5,4,1,2
"Qatar",234,1,5,2,0,2,1
"Colombia",234,1,4,7,3,4,2
"Belgium",234,2,7,4,1,3,1
"Uruguay",234,2,4,3,3,0,2
"Spain",235,2,7,5,0,5,1
"Italy",235,2,7,4,0,4,2
"Portugal",235,4,7,6,2,4,1
"Colombia",235,4,4,5,3,2,2
"England",235,8,6,8,3,5,1
"Iran",235,8,6,4,1,3,2
"Qatar",236,1,5,6,4,2,1
"Uruguay",236,1,4,5,5,0,2
"Australia",236,4,6,6,4,2,1
"Colombia",236,4,4,2,1,1,2
"England",236,7,5,6,3,3,2
"Poland",236,7,5,6,2,4,1
"England",237,4,7,7,1,6,1
"Mexico",237,4,7,3,0,3,2
"Belgium",237,7,5,5,3,2,1
"Uruguay",237,7,4,4,4,0,2
"Brazil",237,8,7,7,2,5,1
"Denmark",237,8,7,4,1,3,2
"Italy",238,2,5,7,3,4,1
"Poland",238,2,5,6,3,3,2
"France",238,8,5,7,4,3,1
"Switzerland",238,8,5,5,4,1,2
"Italy",239,1,6,5,1,4,1
"Jamaica",239,1,6,5,3,2,2
"Spain",239,7,5,3,1,2,1
"Croatia",239,7,5,3,2,1,2
"England",240,2,9,4,0,4,1
"Japan",240,2,3,4,4,0,2
"Brazil",240,7,7,3,0,3,1
"Croatia",240,7,4,3,2,1,2
"Spain",240,8,6,5,2,3,1
"Colombia",240,8,6,5,4,1,2
"Qatar",241,1,6,5,6,-1,2
"United States",241,1,6,7,4,3,1
"Spain",241,3,6,7,3,4,1
"Costa Rica",241,3,6,3,4,-1,2
"Korea Republic",241,7,5,4,3,1,1
"Italy",241,7,4,3,2,1,2
"Senegal",242,6,6,3,2,1,2
"Australia",242,6,6,7,4,3,1
"Uruguay",243,1,6,4,1,3,1
"United States",243,1,6,3,1,2,2
"Netherlands",243,3,5,4,2,2,1
"Belgium",243,3,4,3,2,1,2
"Portugal",243,7,6,4,4,0,2
"Denmark",243,7,6,7,2,5,1
"Denmark",244,1,9,10,0,10,1
"Poland",244,1,2,2,3,-1,2
"Korea Republic",244,3,6,3,4,-1,1
"Brazil",244,3,4,6,4,2,2
"Netherlands",245,1,7,5,1,4,1
"Switzerland",245,1,7,3,1,2,2
"France",245,4,6,5,4,1,2
"Poland",245,4,6,5,2,3,1
"Chile",245,7,9,7,2,5,1
"Mexico",245,7,4,6,3,3,2
"Netherlands",246,6,5,4,3,1,1
"Switzerland",246,6,4,6,4,2,2
"Portugal",246,8,9,10,4,6,1
"Germany",246,8,4,8,5,3,2
"Chile",247,1,6,5,2,3,1
"Jamaica",247,1,6,3,3,0,2
"Belgium",247,7,9,6,0,6,1
"Australia",247,7,4,3,4,-1,2
"Portugal",248,5,9,7,0,7,1
"Colombia",248,5,4,2,2,0,2
"Iran",248,6,7,2,0,2,1
"England",248,6,4,5,3,2,2
"Denmark",248,8,5,4,3,1,1
"Poland",248,8,4,5,4,1,2
"Japan",249,2,5,1,0,1,1
"Italy",249,2,4,4,3,1,2
"Chile",249,7,6,6,2,4,1
"Morocco",249,7,4,4,4,0,2
"Spain",250,6,7,6,1,5,1
"Colombia",250,6,4,6,4,2,2
"Portugal",250,8,7,7,2,5,1
"Denmark",250,8,7,4,2,2,2
"England",251,3,6,3,3,0,2
"Australia",251,3,6,5,4,1,1
"Portugal",251,5,6,8,4,4,1
"Chile",251,5,6,3,3,0,2
"Portugal",253,5,6,4,4,0,1
"Mexico",253,5,4,5,3,2,2
"Belgium",253,7,6,6,3,3,1
"Japan",253,7,6,2,3,-1,2
"Qatar",254,1,6,4,2,2,2
"Germany",254,1,6,6,3,3,1
"Brazil",254,4,7,5,2,3,2
"Italy",254,4,7,6,2,4,1
"Portugal",254,7,9,8,0,8,1
"Denmark",254,7,3,2,3,-1,2
"Netherlands",254,8,9,10,1,9,1
"Spain",254,8,4,7,4,3,2
"Netherlands",256,2,7,10,2,8,1
"Australia",256,2,4,4,4,0,2
"Italy",256,6,9,4,1,3,1
"Iran",256,6,4,8,4,4,2
"Brazil",257,3,6,5,4,1,2
"Netherlands",257,3,6,9,6,3,1
"France",257,6,7,7,2,5,1
"Algeria",257,6,4,6,5,1,2
"Spain",257,7,4,8,7,1,2
"Colombia",257,7,4,6,4,2,1
"Spain",258,4,7,5,3,2,1
"Switzerland",258,4,4,7,3,4,2
"Italy",258,6,6,4,2,2,1
"Japan",258,6,6,4,4,0,2
"Brazil",258,8,7,7,0,7,1
"Croatia",258,8,4,6,5,1,2
"Algeria",259,1,5,3,2,1,1
"Poland",259,1,4,5,4,1,2
"Senegal",259,4,6,4,2,2,1
"Brazil",259,4,4,8,4,4,2
"Italy",259,5,7,5,2,3,1
"England",259,5,4,3,3,0,2
"Argentina",259,6,7,11,3,8,1
"Mexico",259,6,7,4,1,3,2
"Uruguay",259,8,5,7,5,2,1
"United States",259,8,5,4,3,1,2
"England",260,7,7,7,3,4,1
"Japan",260,7,7,5,2,3,2
"Qatar",261,1,4,2,1,1,1
"Germany",261,1,4,3,3,0,2
"Italy",261,3,6,4,3,1,1
"Belgium",261,3,4,6,5,1,2
"England",261,4,9,6,2,4,1
"Iran",261,4,4,4,4,0,2
"Spain",262,8,7,8,3,5,1
"Chile",262,8,4,4,3,1,2
"Jamaica",263,1,5,4,3,1,1
"Qatar",263,1,4,4,3,1,2
"Argentina",263,6,6,3,1,2,1
"Algeria",263,6,4,2,2,0,2
"England",263,7,6,8,3,5,1
"Chile",263,7,6,5,3,2,2
"France",263,8,6,5,2,3,1
"Croatia",263,8,6,7,6,1,2
"Belgium",264,2,7,5,1,4,1
"Australia",264,2,4,7,3,4,2
"Portugal",265,2,6,7,2,5,1
"Italy",265,2,6,6,3,3,2
"Wales",265,3,5,3,2,1,1
"Argentina",265,3,4,4,3,1,2
"Colombia",266,6,6,4,1,3,1
"Korea Republic",266,6,6,3,2,1,2
"Netherlands",266,8,7,2,0,2,2
"Japan",266,8,7,7,1,6,1
"Portugal",267,3,6,4,1,3,1
"Tunisia",267,3,6,6,4,2,2
"France",267,6,5,2,1,1,2
"Switzerland",267,6,5,3,0,3,1
"Wales",267,8,7,5,3,2,2
"Korea Republic",267,8,7,7,4,3,1
"Colombia",268,1,7,5,3,2,2
"Algeria",268,1,7,5,2,3,1
"Spain",268,2,6,7,3,4,2
"Italy",268,2,6,9,4,5,1
"England",268,3,6,6,3,3,1
"Denmark",268,3,6,7,5,2,2
"Brazil",268,6,7,12,5,7,1
"Mexico",268,6,4,6,5,1,2
"Netherlands",269,1,7,5,0,5,1
"Qatar",269,1,4,4,3,1,2
"Mexico",269,3,6,4,4,0,1
"Senegal",269,3,4,7,6,1,2
"Brazil",269,5,7,6,0,6,1
"Wales",269,5,4,3,3,0,2
"Poland",269,6,7,4,0,4,1
"France",269,6,4,2,1,1,2
"Spain",269,8,9,7,2,5,1
"Chile",269,8,4,8,4,4,2
"Belgium",270,4,9,9,0,9,1
"Uruguay",270,4,4,5,3,2,2
"Spain",270,8,6,5,5,0,2
"Italy",270,8,6,4,2,2,1
"Denmark",271,1,9,6,3,3,1
"Qatar",271,1,4,6,5,1,2
"Brazil",271,4,6,7,3,4,1
"Mexico",271,4,4,6,5,1,2
"England",271,5,7,6,2,4,2
"Italy",271,5,7,9,3,6,1
"France",271,8,9,6,1,5,1
"Australia",271,8,4,4,3,1,2
"Colombia",272,1,5,8,4,4,1
"Qatar",272,1,4,6,5,1,2
"Argentina",272,4,5,6,4,2,1
"Germany",272,4,5,4,3,1,2
"Belgium",273,4,7,5,0,5,1
"Iran",273,4,4,3,3,0,2
"Spain",273,6,5,3,2,1,1
"Mexico",273,6,4,5,3,2,2
"Australia",275,8,6,5,4,1,1
"Croatia",275,8,4,3,2,1,2
"Brazil",276,2,7,12,2,10,1
"Switzerland",276,2,7,5,2,3,2
"Belgium",276,8,7,7,2,5,1
"Senegal",276,8,7,6,2,4,2
"Spain",277,2,6,4,3,1,2
"Italy",277,2,6,7,3,4,1
"Croatia",277,3,5,4,2,2,1
"Japan",277,3,4,3,2,1,2
"Argentina",277,4,5,6,2,4,1
"Switzerland",277,4,4,4,4,0,2
"Portugal",277,6,7,7,3,4,1
"Denmark",277,6,4,4,3,1,2
"Brazil",278,2,5,6,2,4,1
"Iran",278,2,5,2,1,1,2
"Portugal",278,3,4,5,4,1,2
"Australia",278,3,4,4,2,2,1
"France",278,7,7,9,3,6,1
"Wales",278,7,7,4,1,3,2
"Italy",278,8,5,3,2,1,1
"Switzerland",278,8,4,5,2,3,2
"Netherlands",279,1,7,5,2,3,1
"Morocco",279,1,7,5,3,2,2
"England",280,6,6,4,2,2,2
"Germany",280,6,6,6,3,3,1
"France",280,7,7,5,0,5,1
"Netherlands",280,7,7,6,2,4,2
"Croatia",281,1,6,6,2,4,1
"Jamaica",281,1,4,6,3,3,2
"Spain",281,2,7,8,3,5,1
"Mexico",281,2,7,5,3,2,2
"Denmark",282,2,7,3,0,3,1
"Argentina",282,2,4,4,3,1,2
"Italy",283,1,5,4,1,3,1
"Chile",283,1,4,5,4,1,2
"Brazil",283,4,6,5,2,3,1
"Australia",283,4,4,3,4,-1,2
"England",283,5,7,5,0,5,1
"Wales",283,5,4,1,1,0,2
"Spain",283,7,5,5,2,3,1
"Algeria",283,7,5,3,2,1,2
"Italy",284,1,7,10,4,6,1
"Wales",284,1,7,6,2,4,2
"Chile",284,4,6,4,4,0,1
"Korea Republic",284,4,4,3,3,0,2
"Brazil",284,8,9,8,2,6,1
"Mexico",284,8,4,5,6,-1,2
"Spain",285,6,5,4,0,4,1
"Japan",285,6,5,3,2,1,2
"France",286,3,9,12,2,10,1
"Iran",286,3,4,1,2,-1,2
"Brazil",286,6,9,5,1,4,1
"Denmark",286,6,4,4,2,2,2
"Switzerland",287,4,7,4,1,3,1
"England",287,4,4,3,2,1,2
"France",287,7,7,6,0,6,1
"Uruguay",287,7,4,7,2,5,2
"Spain",287,8,7,6,3,3,1
"Croatia",287,8,7,5,3,2,2
"Spain",288,2,9,7,1,6,1
"Chile",288,2,4,4,4,0,2
"Brazil",288,3,7,10,1,9,1
"Algeria",288,3,4,3,3,0,2
"Mexico",288,6,6,6,3,3,1
"Australia",288,6,6,5,3,2,2
"Poland",290,2,6,5,2,3,1
"Iran",290,2,4,2,2,0,2
"Nigeria",290,4,6,3,1,2,1
"Mexico",290,4,4,2,2,0,2
"Belgium",290,5,9,12,4,8,1
"Wales",290,5,4,4,4,0,2
"Switzerland",291,4,9,7,2,5,1
"France",291,4,4,7,5,2,2
"Croatia",292,2,6,6,7,-1,1
"Belgium",292,2,4,10,6,4,2
"Mexico",292,3,6,6,5,1,2
"Iran",292,3,6,7,3,4,1
"Germany",292,7,9,6,1,5,1
"Portugal",292,7,3,4,3,1,2
"England",292,8,6,5,3,2,2
"Colombia",292,8,6,6,3,3,1
"Argentina",293,2,6,9,3,6,1
"Netherlands",293,2,6,5,3,2,2
"Mexico",293,6,5,1,0,1,1
"Chile",293,6,4,4,3,1,2
"Brazil",293,7,7,5,1,4,2
"Italy",293,7,7,7,2,5,1
"Croatia",294,1,9,10,2,8,1
"Morocco",294,1,3,4,5,-1,2
"Mexico",294,2,5,5,3,2,1
"England",294,2,4,5,4,1,2
"Spain",294,3,7,8,3,5,1
"Netherlands",294,3,7,8,4,4,2
"Portugal",294,4,6,6,3,3,1
"Colombia",294,4,6,7,6,1,2
"Netherlands",295,1,6,10,5,5,1
"Algeria",295,1,6,6,5,1,2
"Portugal",295,6,9,5,1,4,1
"Germany",295,6,4,5,4,1,2
"Brazil",296,3,9,6,1,5,1
"Netherlands",296,3,4,3,3,0,2
"Belgium",296,6,5,5,2,3,1
"United States",296,6,5,2,0,2,2
"Japan",297,4,4,3,2,1,1
"Nigeria",297,4,4,2,2,0,2
"France",297,7,7,6,0,6,1
"Australia",297,7,7,2,0,2,2
"Qatar",298,1,6,3,3,0,2
"Croatia",298,1,6,4,3,1,1
"Portugal",298,4,6,4,2,2,1
"Mexico",298,4,6,3,2,1,2
"France",298,7,7,8,3,5,2
"Switzerland",298,7,7,10,3,7,1
"France",299,5,6,7,3,4,1
"Tunisia",299,5,4,4,4,0,2
"Belgium",299,6,7,5,1,4,1
"Switzerland",299,6,7,4,1,3,2
"Denmark",299,8,7,3,0,3,1
"Argentina",299,8,4,3,2,1,2
"France",300,2,7,5,2,3,1
"Poland",300,2,7,3,1,2,2
"Iran",301,6,7,4,1,3,1
"France",301,6,4,2,2,0,2
"Belgium",301,7,6,6,5,1,2
"Netherlands",301,7,6,6,3,3,1
"Argentina",301,8,9,6,1,5,1
"Poland",301,8,4,6,6,0,2
"Germany",302,6,6,9,4,5,1
"Costa Rica",302,6,6,9,5,4,2
"Brazil",302,8,6,5,1,4,1
"Senegal",302,8,6,4,3,1,2
"Qatar",303,1,7,6,3,3,1
"Croatia",303,1,7,4,2,2,2
"Belgium",303,2,9,9,1,8,1
"Mexico",303,2,4,3,2,1,2
"Spain",303,3,7,4,1,3,1
"Italy",303,3,4,7,3,4,2
"Uruguay",303,4,5,4,2,2,1
"England",303,4,4,5,3,2,2
"Costa Rica",303,6,7,5,3,2,1
"France",303,6,4,3,2,1,2
"France",304,3,7,4,1,3,2
"Italy",304,3,7,5,0,5,1
"Portugal",304,5,5,5,2,3,1
"Senegal",304,5,5,5,3,2,2
"Spain",304,8,6,8,2,6,1
"Poland",304,8,6,4,2,2,2
"Korea Republic",305,2,6,4,4,0,1
"Portugal",305,2,4,6,4,2,2
"Mexico",305,6,6,5,7,-2,2
"Iran",305,6,6,3,2,1,1
"France",306,5,7,7,3,4,1
"Korea Republic",306,5,4,4,2,2,2
"Australia",306,6,7,9,3,6,1
"Argentina",306,6,4,5,5,0,2
"Germany",307,1,7,4,2,2,2
"Chile",307,1,7,6,2,4,1
"Argentina",307,4,6,4,4,0,1
"Poland",307,4,4,5,4,1,2
"Netherlands",308,1,5,4,2,2,1
"Qatar",308,1,4,5,4,1,2
"Spain",308,3,5,3,2,1,1
"Colombia",308,3,4,5,1,4,2
"Denmark",308,6,7,5,2,3,1
"Australia",308,6,4,4,4,0,2
"Belgium",308,7,5,5,2,3,1
"Germany",308,7,5,5,3,2,2
"Belgium",309,4,6,3,1,2,1
"Iran",309,4,6,5,4,1,2
"Brazil",309,6,9,10,2,8,1
"Germany",309,6,2,2,3,-1,2
"Denmark",310,1,6,4,2,2,2
"Wales",310,1,6,7,1,6,1
"Netherlands",311,6,6,6,1,5,1
"Spain",311,6,4,5,4,1,2
"Portugal",311,8,6,6,4,2,1
"Australia",311,8,6,2,1,1,2
"Spain",312,7,6,6,4,2,2
"Chile",312,7,6,7,3,4,1
"Brazil",314,3,6,6,4,2,1
"Korea Republic",314,3,6,4,3,1,2
"Italy",315,4,6,3,1,2,2
"Australia",315,4,6,7,3,4,1
"Portugal",315,8,9,9,0,9,1
"Algeria",315,8,3,2,2,0,2
"England",316,2,7,5,2,3,1
"Mexico",316,2,7,3,1,2,2
"Spain",317,2,5,4,3,1,2
"Croatia",317,2,5,5,3,2,1
"Germany",317,3,7,9,3,6,1
"Switzerland",317,3,4,8,5,3,2
"Belgium",317,5,6,6,2,4,1
"Netherlands",317,5,6,8,5,3,2
"England",317,8,7,8,1,7,1
"Uruguay",317,8,4,9,3,6,2
"Algeria",318,2,9,6,1,5,1
"Netherlands",318,2,4,5,5,0,2
"Italy",318,3,5,3,2,1,1
"Iran",318,3,4,2,1,1,2
"Portugal",318,4,7,5,0,5,1
"Croatia",318,4,7,4,2,2,2
"Wales",318,8,6,6,5,1,1
"Belgium",318,8,4,3,3,0,2
"Argentina",319,2,5,6,4,2,1
"Australia",319,2,5,6,5,1,2
"Korea Republic",319,4,6,4,3,1,1
"Belgium",319,4,4,5,3,2,2
"Spain",320,2,9,3,0,3,1
"Germany",320,2,4,3,1,2,2
"Portugal",320,4,6,5,3,2,2
"Uruguay",320,4,6,8,3,5,1
"England",320,6,9,7,1,6,1
"Senegal",320,6,3,3,2,1,2
"Mexico",321,2,4,4,4,0,2
"Australia",321,2,4,3,2,1,1
"Belgium",321,3,6,7,3,4,1
"Algeria",321,3,6,4,3,1,2
"Italy",321,4,6,4,4,0,1
"United States",321,4,4,3,2,1,2
"France",321,5,5,4,3,1,1
"Switzerland",321,5,4,5,3,2,2
"Brazil",321,6,7,7,2,5,1
"Morocco",321,6,4,3,1,2,2
"Belgium",322,7,6,6,6,0,1
"Netherlands",322,7,4,5,5,0,2
"France",323,3,6,5,3,2,1
"Iran",323,3,4,4,3,1,2
"Italy",323,4,5,4,2,2,1
"Costa Rica",323,4,4,3,3,0,2
"Argentina",323,5,9,7,4,3,1
"Tunisia",323,5,4,4,3,1,2
"Senegal",324,1,9,7,1,6,1
"Colombia",324,1,2,2,3,-1,2
"Netherlands",324,6,6,2,5,-3,2
"Nigeria",324,6,6,3,1,2,1
"France",325,2,7,7,3,4,1
"Costa Rica",325,2,4,3,3,0,2
"Brazil",326,2,9,11,2,9,1
"Japan",326,2,4,4,4,0,2
"France",326,3,6,6,4,2,1
"Denmark",326,3,6,4,3,1,2
"Switzerland",327,2,7,5,3,2,1
"England",327,2,4,4,3,1,2
"Spain",327,3,7,2,0,2,1
"Colombia",327,3,4,3,2,1,2
"Portugal",327,4,9,5,1,4,1
"Japan",327,4,4,2,1,1,2
"Argentina",327,5,7,7,3,4,1
"Iran",327,5,4,4,3,1,2
"Brazil",327,8,7,6,2,4,1
"Denmark",327,8,7,4,1,3,2
"Brazil",329,7,4,8,6,2,1
"Morocco",329,7,4,2,2,0,2
"Colombia",330,1,6,5,2,3,2
"Wales",330,1,6,6,2,4,1
"Spain",330,3,7,6,1,5,1
"Poland",330,3,4,3,3,0,2
"Belgium",330,8,5,5,4,1,2
"Denmark",330,8,5,7,3,4,1
"France",331,5,6,5,4,1,1
"Australia",331,5,4,8,4,4,2
"Brazil",331,7,7,7,0,7,1
"Mexico",331,7,7,3,0,3,2
"Uruguay",331,8,9,5,0,5,1
"Spain",331,8,4,3,2,1,2
"Germany",332,1,5,6,3,3,1
"Chile",332,1,5,5,4,1,2
"Spain",332,2,7,5,1,4,1
"Italy",332,2,7,5,2,3,2
"Portugal",333,7,7,5,1,4,2
"Croatia",333,7,7,9,2,7,1
"Spain",334,8,9,5,1,4,1
"Uruguay",334,8,3,2,2,0,2
"Germany",335,1,9,13,1,12,1
"Qatar",335,1,2,3,6,-3,2
"Portugal",335,3,7,5,2,3,2
"Netherlands",335,3,7,10,2,8,1
"France",335,7,6,11,3,8,1
"Iran",335,7,6,4,4,0,2
"Denmark",336,3,6,5,3,2,1
"Portugal",336,3,4,6,5,1,2
"Spain",337,5,6,5,2,3,1
"Colombia",337,5,4,4,4,0,2
"Argentina",337,6,7,4,1,3,1
"Australia",337,6,4,4,4,0,2
"Uruguay",338,3,7,6,1,5,1
"Algeria",338,3,4,3,3,0,2
"Chile",338,5,5,3,1,2,1
"Mexico",338,5,4,3,2,1,2
"Germany",338,7,7,4,0,4,1
"Portugal",338,7,4,4,2,2,2
"Colombia",338,8,7,5,2,3,1
"Belgium",338,8,4,4,4,0,2
"England",339,5,6,6,2,4,1
"Poland",339,5,6,2,2,0,2
"Croatia",339,6,6,5,3,2,1
"Iran",339,6,6,3,2,1,2
"Spain",339,7,9,9,1,8,1
"Denmark",339,7,4,4,2,2,2
"Brazil",340,2,6,6,4,2,1
"Japan",340,2,4,2,2,0,2
"England",340,4,7,4,1,3,1
"Switzerland",340,4,7,2,0,2,2
"Poland",340,7,6,3,3,0,1
"Spain",340,7,4,3,2,1,2
"Denmark",341,1,7,6,3,3,1
"Tunisia",341,1,7,6,4,2,2
"France",341,3,6,8,3,5,1
"United States",341,3,6,6,5,1,2
"Costa Rica",341,5,6,4,6,-2,1
"Portugal",341,5,4,5,2,3,2
"Belgium",341,6,5,9,5,4,1
"Iran",341,6,5,3,1,2,2
"Brazil",341,7,9,6,2,4,1
"Netherlands",341,7,4,2,2,0,2
"England",342,3,9,6,1,5,1
"Mexico",342,3,3,2,2,0,2
"Argentina",342,5,9,8,2,6,1
"Italy",342,5,4,3,2,1,2
"France",342,8,7,5,1,4,1
"Chile",342,8,4,6,3,3,2
"Argentina",343,2,7,6,3,3,1
"Iran",343,2,7,6,4,2,2
"Brazil",343,5,7,4,2,2,2
"Mexico",343,5,7,4,1,3,1
"Belgium",343,6,9,6,2,4,1
"Colombia",343,6,3,5,4,1,2
"Portugal",344,2,7,7,2,5,1
"Poland",344,2,7,3,1,2,2
"Switzerland",344,4,6,7,4,3,1
"Korea Republic",344,4,6,7,5,2,2
"Brazil",345,2,6,4,3,1,1
"Australia",345,2,6,2,2,0,2
"Germany",345,4,9,5,0,5,1
"Jamaica",345,4,4,3,3,0,2
"France",345,7,6,6,1,5,1
"Mexico",345,7,6,3,5,-2,2
"Belgium",346,2,6,5,2,3,1
"Chile",346,2,6,4,3,1,2
"Brazil",346,5,5,8,4,4,1
"Mexico",346,5,5,6,5,1,2
"Colombia",347,1,5,3,2,1,1
"Qatar",347,1,4,7,5,2,2
"France",347,4,6,5,1,4,1
"Switzerland",347,4,6,7,4,3,2
"Belgium",347,8,7,6,3,3,1
"Uruguay",347,8,4,7,5,2,2
"Colombia",348,3,5,3,1,2,2
"Iran",348,3,5,4,1,3,1
"Brazil",348,4,6,6,3,3,1
"Italy",348,4,6,3,2,1,2
"Germany",348,7,9,4,0,4,1
"England",348,7,4,4,3,1,2
"Switzerland",349,1,6,8,4,4,1
"Croatia",349,1,4,6,4,2,2
"Netherlands",350,1,6,4,2,2,1
"Chile",350,1,6,3,2,1,2
"Wales",351,1,9,5,0,5,1
"Colombia",351,1,3,2,2,0,2
"Argentina",351,3,7,4,2,2,2
"Denmark",351,3,7,7,1,6,1
"Uruguay",351,5,4,5,5,0,2
"Australia",351,5,4,3,2,1,1
"Spain",351,6,7,8,1,7,1
"Italy",351,6,7,4,1,3,2
"Portugal",352,2,7,8,4,4,1
"Croatia",352,2,4,5,5,0,2
"Spain",352,3,5,5,4,1,2
"Colombia",352,3,5,4,2,2,1
"England",352,7,6,6,3,3,2
"Uruguay",352,7,6,9,4,5,1
"Spain",353,3,7,5,2,3,1
"Poland",353,3,4,2,2,0,2
"France",353,5,7,5,2,3,1
"Korea Republic",353,5,4,4,4,0,2
"France",354,5,6,6,4,2,1
"Uruguay",354,5,6,3,2,1,2
"Germany",354,8,5,7,5,2,1
"Australia",354,8,4,6,4,2,2
"Wales",355,1,6,2,3,-1,1
"Nigeria",355,1,4,2,2,0,2
"Belgium",355,4,6,8,3,5,1
"Italy",355,4,6,7,3,4,2
"Colombia",355,6,7,9,4,5,1
"Spain",355,6,4,5,4,1,2
"Argentina",355,8,7,5,3,2,2
"Netherlands",355,8,7,6,3,3,1
"Tunisia",356,1,7,5,2,3,2
"Costa Rica",356,1,7,5,1,4,1
"England",356,2,6,6,3,3,1
"Uruguay",356,2,6,4,2,2,2
"Spain",356,4,7,6,3,3,1
"Netherlands",356,4,4,5,3,2,2
"Brazil",356,6,5,3,1,2,2
"Italy",356,6,5,6,2,4,1
"Jamaica",358,1,5,2,0,2,1
"Colombia",358,1,4,3,1,2,2
"Spain",358,4,5,3,1,2,1
"Korea Republic",358,4,5,3,2,1,2
"Germany",358,7,6,6,4,2,1
"Argentina",358,7,4,5,5,0,2
"Spain",359,3,5,6,4,2,1
"Morocco",359,3,4,6,3,3,2
"France",359,5,6,8,1,7,1
"Colombia",359,5,6,4,4,0,2
"Brazil",362,2,6,5,2,3,1
"Korea Republic",362,2,6,6,4,2,2
"France",363,2,7,8,3,5,1
"Italy",363,2,7,5,1,4,2
"Portugal",363,3,9,4,0,4,1
"Netherlands",363,3,4,2,2,0,2
"Belgium",363,5,7,5,0,5,1
"Japan",363,5,7,3,0,3,2
"United States",363,6,9,5,1,4,1
"Algeria",363,6,3,3,3,0,2
"Wales",364,1,6,3,2,1,1
"Mexico",364,1,4,3,2,1,2
"Belgium",364,2,9,10,1,9,1
"Netherlands",364,2,4,4,3,1,2
"Brazil",364,4,7,9,1,8,1
"Iran",364,4,7,7,4,3,2
"Denmark",364,6,9,7,2,5,1
"England",364,6,3,4,5,-1,2
"Uruguay",364,8,9,6,1,5,1
"France",364,8,4,3,1,2,2
"Uruguay",365,4,9,8,2,6,1
"France",365,4,4,5,4,1,2
"Spain",365,7,6,4,1,3,1
"Denmark",365,7,4,2,2,0,2
"France",366,3,9,10,3,7,1
"Germany",366,3,3,5,5,0,2
"England",366,7,6,8,2,6,1
"Uruguay",366,7,4,3,3,0,2
"Argentina",366,8,6,6,1,5,1
"Algeria",366,8,4,4,4,0,2
"Belgium",367,2,5,7,3,4,1
"Wales",367,2,5,5,4,1,2
"Argentina",368,2,5,3,0,3,1
"Netherlands",368,2,5,2,1,1,2
"Uruguay",368,7,5,3,2,1,1
"Portugal",368,7,4,3,2,1,2
"Netherlands",369,2,9,6,3,3,1
"Japan",369,2,4,10,5,5,2
"Spain",369,5,7,7,2,5,1
"Mexico",369,5,4,4,3,1,2
"Brazil",369,6,7,6,2,4,1
"Germany",369,6,7,4,2,2,2
"Belgium",369,8,7,6,1,5,1
"Switzerland",369,8,4,4,4,0,2
"England",370,2,9,7,0,7,1
"Japan",370,2,4,5,4,1,2
"Belgium",370,3,6,6,5,1,2
"Australia",370,3,6,4,2,2,1
"Brazil",371,3,6,6,3,3,1
"Mexico",371,3,6,3,2,1,2
"Uruguay",371,4,9,6,2,4,1
"Belgium",371,4,4,8,5,3,2
"Netherlands",371,5,6,5,4,1,2
"Nigeria",371,5,6,4,2,2,1
"Denmark",371,7,6,6,2,4,1
"Argentina",371,7,4,4,3,1,2
"Spain",372,5,7,6,3,3,2
"Denmark",372,5,7,9,1,8,1
"Algeria",373,4,6,3,1,2,1
"Portugal",373,4,4,3,3,0,2
"France",373,6,5,4,2,2,2
"Uruguay",373,6,5,5,2,3,1
"Colombia",374,3,9,4,0,4,1
"Iran",374,3,3,5,3,2,2
"Spain",374,8,6,4,4,0,1
"Chile",374,8,4,3,2,1,2
"United States",375,1,7,3,1,2,1
"Denmark",375,1,4,4,3,1,2
"Brazil",375,6,7,5,2,3,1
"Japan",375,6,4,6,6,0,2
"Belgium",375,7,5,5,2,3,1
"Uruguay",375,7,5,2,1,1,2
"England",375,8,6,9,4,5,1
"Chile",375,8,6,6,4,2,2
"Mexico",376,1,5,2,1,1,1
"Poland",376,1,4,3,2,1,2
"France",376,7,9,5,0,5,1
"United States",376,7,3,4,4,0,2
"Argentina",377,7,7,4,1,3,1
"Germany",377,7,7,4,2,2,2
"Argentina",378,3,5,4,2,2,1
"Algeria",378,3,5,5,4,1,2
"Italy",378,7,7,4,0,4,1
"Portugal",378,7,4,3,2,1,2
"Spain",379,2,7,5,2,3,2
"Italy",379,2,7,5,1,4,1
"Netherlands",379,3,5,3,2,1,2
"Korea Republic",379,3,5,4,0,4,1
"Croatia",379,5,6,3,1,2,1
"Poland",379,5,6,3,3,0,2
"Chile",380,4,7,4,1,3,1
"Germany",380,4,4,2,1,1,2
"France",380,5,5,4,3,1,1
"Italy",380,5,4,5,3,2,2
"Denmark",381,6,9,7,1,6,1
"Poland",381,6,4,1,1,0,2
"Uruguay",382,2,9,4,1,3,1
"France",382,2,4,5,2,3,2
"Croatia",382,7,6,9,8,1,1
"Spain",382,7,4,4,4,0,2
"Brazil",383,3,6,7,4,3,1
"Switzerland",383,3,6,4,2,2,2
"United States",383,7,6,5,5,0,1
"Spain",383,7,4,4,3,1,2
"England",383,8,9,12,3,9,1
"Iran",383,8,4,3,4,-1,2
"Denmark",384,6,5,7,2,5,1
"Chile",384,6,4,3,2,1,2
"France",384,7,7,6,3,3,1
"Uruguay",384,7,4,4,3,1,2
"Italy",385,6,7,6,2,4,1
"Brazil",385,6,4,5,1,4,2
"Uruguay",385,7,6,4,2,2,1
"Portugal",385,7,4,2,1,1,2
"England",386,2,5,6,2,4,1
"Chile",386,2,4,3,3,0,2
"Portugal",386,5,7,6,0,6,1
"Croatia",386,5,7,3,0,3,2
"Brazil",386,8,7,10,1,9,1
"Netherlands",386,8,7,7,3,4,2
"Colombia",387,3,6,4,1,3,1
"Switzerland",387,3,6,5,3,2,2
"Argentina",387,4,6,5,4,1,1
"Italy",387,4,4,3,2,1,2
"Brazil",387,6,9,6,1,5,1
"Mexico",387,6,4,4,2,2,2
"Germany",388,2,6,5,2,3,1
"Argentina",388,2,4,2,2,0,2
"Mexico",388,4,5,5,0,5,1
"Chile",388,4,5,3,0,3,2
"Australia",389,5,7,9,3,6,1
"Portugal",389,5,4,5,5,0,2
"Qatar",390,1,7,6,1,5,1
"Italy",390,1,7,5,1,4,2
"England",390,2,7,5,1,4,1
"Japan",390,2,7,3,1,2,2
"Argentina",390,6,9,7,3,4,1
"Algeria",390,6,4,7,6,1,2
"France",390,8,5,6,2,4,1
"Chile",390,8,4,5,4,1,2
"Croatia",391,6,7,7,0,7,1
"Japan",391,6,4,2,2,0,2
"Uruguay",392,1,6,4,2,2,1
"Switzerland",392,1,4,2,2,0,2
"England",392,7,9,6,3,3,1
"Colombia",392,7,4,5,4,1,2
"Argentina",393,3,6,9,5,4,1
"Japan",393,3,4,3,3,0,2
"Poland",393,7,6,3,1,2,1
"France",393,7,4,1,1,0,2
"Spain",393,8,6,4,4,0,2
"Germany",393,8,6,8,3,5,1
"Portugal",394,2,6,4,3,1,2
"Wales",394,2,6,7,2,5,1
"Algeria",394,3,5,5,3,2,1
"Belgium",394,3,4,6,5,1,2
"France",394,4,5,3,1,2,1
"Australia",394,4,5,1,0,1,2
"Spain",394,8,6,5,2,3,1
"Italy",394,8,6,3,4,-1,2
"Qatar",395,1,6,5,1,4,1
"Poland",395,1,6,2,1,1,2
"Nigeria",396,1,6,2,1,1,1
"Mexico",396,1,4,2,2,0,2
"France",396,3,6,4,4,0,2
"Uruguay",396,3,6,6,1,5,1
"Qatar",397,1,6,5,2,3,1
"Colombia",397,1,6,4,4,0,2
"Belgium",397,2,6,4,3,1,1
"Croatia",397,2,6,3,3,0,2
"France",397,6,7,7,2,5,1
"Italy",397,6,4,3,1,2,2
"Poland",397,8,7,3,0,3,1
"Portugal",397,8,4,5,4,1,2
"Qatar",398,1,5,3,2,1,2
"Wales",398,1,5,5,3,2,1
"Brazil",399,2,9,11,0,11,1
"Korea Republic",399,2,2,1,4,-3,2
"Italy",399,8,6,3,1,2,1
"Iran",399,8,6,4,4,0,2
"Nigeria",400,2,6,2,3,-1,1
"Japan",400,2,4,3,1,2,2
"Spain",400,3,9,8,1,7,1
"Netherlands",400,3,4,6,2,4,2
"England",400,8,9,11,0,11,1
"Uruguay",400,8,4,6,5,1,2
"Argentina",401,5,7,6,4,2,2
"Germany",401,5,7,5,1,4,1
"Uruguay",401,6,6,6,4,2,2
"Wales",401,6,6,6,3,3,1
"Brazil",401,8,6,7,3,4,1
"Croatia",401,8,4,4,5,-1,2
"England",402,8,7,3,1,2,2
"Italy",402,8,7,8,1,7,1
"Portugal",403,2,6,3,2,1,1
"Colombia",403,2,4,4,2,2,2
"Argentina",403,4,5,7,5,2,1
"Netherlands",403,4,5,4,3,1,2
"Tunisia",404,1,6,3,3,0,1
"Qatar",404,1,4,4,3,1,2
"France",404,4,5,4,1,3,1
"Colombia",404,4,4,4,3,1,2
"Chile",404,8,6,3,1,2,1
"Australia",404,8,4,2,2,0,2
"Spain",405,2,9,5,1,4,1
"Mexico",405,2,4,8,4,4,2
"France",405,5,6,7,3,4,1
"Japan",405,5,6,3,2,1,2
"England",405,8,7,3,0,3,2
"Germany",405,8,7,9,1,8,1
"Brazil",406,3,9,9,1,8,1
"Iran",406,3,4,5,4,1,2
"France",406,5,6,4,2,2,2
"Uruguay",406,5,6,6,2,4,1
"England",406,8,9,8,1,7,1
"Switzerland",406,8,3,4,5,-1,2
"Italy",407,1,9,8,3,5,1
"Nigeria",407,1,4,7,7,0,2
"Colombia",407,4,7,5,0,5,1
"France",407,4,4,4,4,0,2
"Brazil",407,7,6,3,3,0,2
"Denmark",407,7,6,5,3,2,1
"Brazil",408,7,7,7,4,3,1
"Mexico",408,7,7,6,4,2,2
"England",409,2,5,6,3,3,1
"Iran",409,2,5,4,2,2,2
"Belgium",409,5,6,5,3,2,1
"Colombia",409,5,4,4,3,1,2
"Spain",409,8,5,3,2,1,2
"Senegal",409,8,5,4,2,2,1
"Qatar",410,1,6,4,3,1,1
"Italy",410,1,4,4,3,1,2
"France",410,2,9,11,5,6,1
"Germany",410,2,4,2,2,0,2
"Spain",410,5,7,5,2,3,2
"Japan",410,5,7,5,1,4,1
"England",410,7,6,8,3,5,1
"Netherlands",410,7,6,4,3,1,2
"Italy",411,1,6,6,5,1,1
"Algeria",411,1,6,5,5,0,2
"Argentina",411,2,5,4,1,3,1
"Iran",411,2,5,5,3,2,2
"Portugal",411,6,6,5,3,2,1
"Germany",411,6,4,3,1,2,2
"England",411,7,6,8,5,3,1
"Mexico",411,7,6,3,2,1,2
"Brazil",412,4,6,3,4,-1,1
"Mexico",412,4,4,5,2,3,2
"France",412,8,5,5,3,2,1
"Morocco",412,8,5,2,1,1,2
"Denmark",413,1,5,4,3,1,1
"Jamaica",413,1,4,7,6,1,2
"England",413,2,5,3,2,1,2
"Chile",413,2,5,6,2,4,1
"France",413,3,6,7,3,4,1
"Uruguay",413,3,6,4,3,1,2
"Belgium",413,7,9,10,2,8,1
"Colombia",413,7,4,7,6,1,2
"Brazil",414,2,9,5,0,5,1
"Poland",414,2,3,3,4,-1,2
"Senegal",414,3,5,4,2,2,1
"Mexico",414,3,4,4,2,2,2
"Belgium",415,2,9,6,2,4,1
"Algeria",415,2,3,5,5,0,2
"Italy",415,5,6,3,1,2,1
"Portugal",415,5,4,3,2,1,2
"France",415,6,5,3,2,1,1
"Costa Rica",415,6,4,5,3,2,2
"Iran",415,7,9,7,3,4,1
"Uruguay",415,7,4,4,3,1,2
"Denmark",416,5,9,11,1,10,1
"England",416,5,3,4,4,0,2
"Argentina",416,6,6,3,1,2,1
"Iran",416,6,6,2,1,1,2
"Uruguay",416,8,9,10,1,9,1
"France",416,8,3,3,5,-2,2
"Brazil",417,4,7,4,1,3,2
"Mexico",417,4,7,7,2,5,1
"Spain",417,5,7,8,1,7,1
"Netherlands",417,5,7,5,0,5,2
"Italy",417,7,6,6,5,1,1
"Chile",417,7,4,6,6,0,2
"Netherlands",418,3,6,3,2,1,2
"Chile",418,3,6,5,3,2,1
"France",418,4,9,10,3,7,1
"Denmark",418,4,4,4,4,0,2
"Uruguay",418,6,9,4,1,3,1
"England",418,6,3,3,3,0,2
"Qatar",420,1,6,2,4,-2,2
"Italy",420,1,6,9,2,7,1
"France",421,4,7,4,1,3,2
"Colombia",421,4,7,7,2,5,1
"Mexico",421,7,6,6,3,3,1
"Japan",421,7,6,4,3,1,2
"Portugal",422,3,9,7,0,7,1
"Iran",422,3,4,5,3,2,2
"France",422,8,6,3,1,2,2
"Chile",422,8,6,5,2,3,1
"Brazil",423,7,6,4,2,2,1
"Denmark",423,7,6,3,2,1,2
"Portugal",424,3,6,5,3,2,1
"Australia",424,3,6,5,4,1,2
"Brazil",426,3,7,9,0,9,1
"Germany",426,3,4,3,2,1,2
"Belgium",426,4,5,7,3,4,2
"Korea Republic",426,4,5,9,3,6,1
"Brazil",427,4,7,7,0,7,1
"Australia",427,4,7,5,0,5,2
"Netherlands",427,5,6,5,2,3,2
"United States",427,5,6,7,3,4,1
"France",428,6,6,5,2,3,2
"Netherlands",428,6,6,7,2,5,1
"Belgium",429,3,5,8,2,6,1
"Japan",429,3,5,3,1,2,2
"Portugal",429,4,7,7,3,4,2
"Netherlands",429,4,7,6,1,5,1
"Qatar",430,1,6,3,3,0,1
"Switzerland",430,1,6,3,4,-1,2
"Argentina",430,2,6,6,6,0,2
"Poland",430,2,6,7,6,1,1
"Spain",430,3,6,6,3,3,1
"Italy",430,3,6,4,3,1,2
"France",430,4,5,3,2,1,2
"Nigeria",430,4,5,4,2,2,1
"Netherlands",430,6,9,7,2,5,1
"Portugal",430,6,3,2,3,-1,2
"Portugal",431,3,7,10,3,7,1
"Uruguay",431,3,7,8,4,4,2
"Portugal",432,4,5,4,2,2,1
"Croatia",432,4,4,4,4,0,2
"Spain",432,7,5,5,3,2,1
"Nigeria",432,7,4,6,5,1,2
"Argentina",432,8,7,9,4,5,1
"Netherlands",432,8,4,5,3,2,2
"Tunisia",433,6,5,5,3,2,1
"Iran",433,6,4,2,2,0,2
"Wales",433,7,6,5,4,1,1
"Nigeria",433,7,6,3,3,0,2
"Netherlands",434,4,6,5,3,2,1
"Brazil",434,4,4,5,2,3,2
"France",434,5,5,4,2,2,2
"Korea Republic",434,5,5,4,1,3,1
"Portugal",434,6,6,9,5,4,1
"Senegal",434,6,6,8,5,3,2
"France",435,2,5,2,0,2,1
"Costa Rica",435,2,5,2,1,1,2
"Portugal",435,3,5,5,4,1,2
"Japan",435,3,5,6,2,4,1
"Mexico",435,5,6,7,5,2,1
"Brazil",435,5,4,7,4,3,2
"Denmark",436,1,6,7,4,3,1
"Qatar",436,1,4,5,5,0,2
"Italy",436,4,9,6,1,5,1
"Brazil",436,4,3,4,3,1,2
"Belgium",436,5,9,6,1,5,1
"Wales",436,5,4,2,2,0,2
"England",436,7,6,9,4,5,1
"Croatia",436,7,4,4,4,0,2
"Portugal",437,5,9,6,0,6,1
"Poland",437,5,4,3,3,0,2
"Spain",437,6,7,6,2,4,1
"Mexico",437,6,4,4,4,0,2
"Chile",437,8,6,3,2,1,1
"Belgium",437,8,4,6,2,4,2
"Belgium",438,3,6,4,1,3,1
"Croatia",438,3,6,2,1,1,2
"Portugal",438,5,9,10,4,6,1
"Japan",438,5,4,4,4,0,2
"Argentina",438,6,6,4,3,1,2
"Korea Republic",438,6,6,7,4,3,1
"France",439,2,5,6,3,3,1
"Italy",439,2,4,4,2,2,2
"Belgium",440,6,6,10,4,6,1
"Germany",440,6,6,7,4,3,2
"Uruguay",441,4,9,7,3,4,1
"England",441,4,3,3,3,0,2
"Brazil",441,8,5,7,3,4,1
"Mexico",441,8,5,4,2,2,2
"France",442,4,6,9,4,5,1
"United States",442,4,6,4,5,-1,2
"Netherlands",443,1,6,3,1,2,1
"Algeria",443,1,6,3,2,1,2
"Portugal",443,4,5,2,1,1,2
"Morocco",443,4,5,5,2,3,1
"Argentina",443,7,6,8,3,5,1
"Nigeria",443,7,6,3,5,-2,2
"Germany",444,2,6,4,4,0,1
"Australia",444,2,6,4,5,-1,2
"Belgium",444,6,6,6,5,1,2
"Denmark",444,6,6,7,2,5,1
"Argentina",445,3,7,3,0,3,1
"Australia",445,3,4,3,2,1,2
"Netherlands",446,1,7,6,2,4,1
"Jamaica",446,1,4,4,3,1,2
"Mexico",446,3,7,4,0,4,1
"Argentina",446,3,4,3,2,1,2
"Brazil",446,7,6,6,2,4,1
"Korea Republic",446,7,6,5,2,3,2
"Argentina",447,2,7,8,3,5,1
"Netherlands",447,2,7,6,3,3,2
"Brazil",447,3,6,6,3,3,2
"Australia",447,3,6,7,3,4,1
"Germany",447,6,7,5,0,5,1
"United States",447,6,4,2,3,-1,2
"Spain",448,7,6,5,2,3,1
"Poland",448,7,6,4,5,-1,2
"Denmark",449,4,9,10,2,8,1
"Argentina",449,4,4,2,2,0,2
"Croatia",450,1,9,8,2,6,1
"Switzerland",450,1,4,3,2,1,2
"Argentina",450,5,6,6,2,4,1
"Italy",450,5,6,4,1,3,2
"Spain",450,6,7,7,2,5,1
"Uruguay",450,6,7,5,2,3,2
"Denmark",450,7,5,6,2,4,1
"Wales",450,7,5,4,2,2,2
"Argentina",451,7,6,6,1,5,1
"Mexico",451,7,6,5,4,1,2
"Spain",451,8,7,6,1,5,1
"Switzerland",451,8,7,3,1,2,2
"Uruguay",452,1,9,6,1,5,1
"Morocco",452,1,4,3,3,0,2
"Belgium",452,4,6,7,5,2,1
"Mexico",452,4,4,3,2,1,2
"Uruguay",453,3,6,6,4,2,1
"Iran",453,3,6,3,3,0,2
"Netherlands",454,5,5,5,4,1,1
"Spain",454,5,4,4,3,1,2
"England",454,6,6,4,1,3,1
"Mexico",454,6,4,5,2,3,2
"Korea Republic",454,7,6,5,3,2,1
"United States",454,7,4,4,4,0,2
"Spain",455,3,9,4,0,4,1
"Mexico",455,3,4,7,3,4,2
"Brazil",455,4,5,1,0,1,2
"Netherlands",455,4,5,4,1,3,1
"England",456,3,7,6,3,3,2
"Germany",456,3,7,8,2,6,1
"Senegal",457,2,5,4,2,2,1
"Germany",457,2,4,4,3,1,2
"England",457,3,6,7,2,5,1
"Korea Republic",457,3,6,6,3,3,2
"Brazil",457,6,7,7,2,5,1
"Mexico",457,6,7,5,2,3,2
"Spain",457,8,6,6,2,4,1
"Denmark",457,8,6,5,3,2,2
"Chile",458,1,7,4,2,2,1
"Italy",458,1,4,8,5,3,2
"Spain",458,2,7,6,2,4,1
"Iran",458,2,4,3,2,1,2
"Argentina",458,6,6,7,3,4,1
"Netherlands",458,6,6,6,4,2,2
"England",459,2,6,8,3,5,1
"Uruguay",459,2,6,5,3,2,2
"Argentina",459,3,6,6,3,3,1
"Australia",459,3,6,4,4,0,2
"Denmark",459,8,6,3,2,1,1
"France",459,8,4,6,2,4,2
"Colombia",460,1,6,5,3,2,1
"Qatar",460,1,4,3,3,0,2
"Japan",460,2,6,4,5,-1,2
"Morocco",460,2,6,6,4,2,1
"Brazil",460,3,5,4,2,2,1
"Korea Republic",460,3,4,6,4,2,2
"Argentina",461,5,7,3,1,2,1
"Netherlands",461,5,4,3,2,1,2
"Korea Republic",461,6,5,7,6,1,1
"Brazil",461,6,4,7,5,2,2
"Qatar",462,1,7,3,0,3,1
"Denmark",462,1,4,2,1,1,2
"Colombia",462,2,7,6,1,5,1
"Belgium",462,2,4,6,5,1,2
"Denmark",463,1,6,6,2,4,1
"Tunisia",463,1,4,3,3,0,2
"Portugal",463,5,6,2,1,1,1
"Colombia",463,5,4,3,2,1,2
"England",464,2,6,5,1,4,1
"Germany",464,2,6,3,2,1,2
"Denmark",464,3,9,6,2,4,1
"Iran",464,3,4,7,3,4,2
"Nigeria",464,6,6,3,2,1,1
"France",464,6,4,7,4,3,2
"Uruguay",465,7,9,6,0,6,1
"England",465,7,4,5,4,1,2
"Spain",466,4,6,5,4,1,2
"Mexico",466,4,6,6,2,4,1
"Brazil",466,6,6,7,4,3,1
"Italy",466,6,6,4,2,2,2
"Denmark",467,1,9,9,2,7,1
"Jamaica",467,1,4,3,4,-1,2
"Brazil",468,6,6,2,4,-2,2
"Italy",468,6,6,5,1,4,1
"France",469,3,5,3,1,2,2
"Colombia",469,3,5,4,1,3,1
"Brazil",469,6,5,4,3,1,1
"Wales",469,6,4,5,5,0,2
"Portugal",469,7,7,6,2,4,1
"Mexico",469,7,4,3,3,0,2
"Belgium",469,8,7,3,1,2,2
"Chile",469,8,7,3,0,3,1
"Croatia",471,1,6,3,2,1,2
"Morocco",471,1,6,5,3,2,1
"Wales",471,8,6,3,2,1,1
"Netherlands",471,8,4,5,3,2,2
"Brazil",472,2,6,8,4,4,1
"Switzerland",472,2,4,3,3,0,2
"Argentina",472,5,6,4,2,2,1
"Denmark",472,5,6,4,3,1,2
"Mexico",472,6,5,2,0,2,1
"Belgium",472,6,4,5,4,1,2
"Portugal",473,4,6,5,2,3,1
"Morocco",473,4,6,5,3,2,2
"Denmark",474,1,6,4,3,1,1
"Qatar",474,1,4,4,3,1,2
"France",474,3,6,5,3,2,1
"Switzerland",474,3,4,3,3,0,2
"Argentina",474,8,9,9,4,5,1
"Nigeria",474,8,4,5,5,0,2
"Spain",475,4,6,7,2,5,1
"Costa Rica",475,4,6,4,6,-2,2
"Brazil",476,2,6,7,1,6,1
"Japan",476,2,6,4,3,1,2
"Spain",476,8,7,4,1,3,2
"Netherlands",476,8,7,6,1,5,1
"Netherlands",477,1,7,4,2,2,2
"Switzerland",477,1,7,5,1,4,1
"Spain",477,6,7,3,0,3,1
"Croatia",477,6,4,5,2,3,2
"Italy",478,1,9,8,0,8,1
"Chile",478,1,4,4,2,2,2
"France",478,2,7,7,1,6,1
"Colombia",478,2,7,8,3,5,2
"Algeria",478,5,6,4,5,-1,1
"Uruguay",478,5,4,5,3,2,2
"Mexico",478,6,5,4,3,1,1
"Spain",478,6,4,4,2,2,2
"Spain",479,6,6,4,4,0,2
"Colombia",479,6,6,7,2,5,1
"Portugal",479,8,9,6,2,4,1
"Croatia",479,8,3,5,5,0,2
"Spain",480,5,7,4,0,4,1
"Colombia",480,5,4,2,1,1,2
"Germany",480,6,9,5,0,5,1
"Iran",480,6,3,4,4,0,2
"Portugal",480,8,7,10,3,7,1
"Mexico",480,8,7,4,0,4,2
"Spain",481,2,7,7,4,3,1
"Denmark",481,2,4,5,2,3,2
"Iran",481,5,9,6,1,5,1
"Belgium",481,5,4,4,2,2,2
"Chile",481,6,6,4,3,1,1
"England",481,6,4,4,3,1,2
"Spain",482,3,6,7,5,2,1
"Chile",482,3,6,5,4,1,2
"Portugal",482,4,7,7,1,6,1
"Croatia",482,4,7,3,1,2,2
"France",483,5,9,7,1,6,1
"Poland",483,5,2,3,4,-1,2
"Italy",483,6,5,3,1,2,1
"England",483,6,4,5,3,2,2
"Algeria",484,6,6,4,2,2,1
"Denmark",484,6,4,1,1,0,2
"England",484,7,9,6,2,4,1
"Uruguay",484,7,3,3,3,0,2
"Qatar",485,1,6,7,4,3,1
"Croatia",485,1,6,2,3,-1,2
"Argentina",485,3,7,4,1,3,2
"Netherlands",485,3,7,5,1,4,1
"France",485,5,6,8,2,6,1
"Iran",485,5,6,3,3,0,2
"Brazil",485,6,9,5,1,4,1
"Japan",485,6,3,3,3,0,2
"Italy",486,1,9,12,3,9,1
"Qatar",486,1,3,3,4,-1,2
"Spain",486,3,6,7,4,3,1
"Colombia",486,3,6,3,2,1,2
"Brazil",486,7,5,5,4,1,1
"Australia",486,7,4,6,4,2,2
"Brazil",487,2,5,4,3,1,1
"Germany",487,2,4,4,2,2,2
"France",487,5,6,3,1,2,1
"Denmark",487,5,6,4,4,0,2
"Netherlands",487,8,7,5,3,2,1
"Spain",487,8,4,6,4,2,2
"France",488,4,7,4,1,3,2
"Chile",488,4,7,8,1,7,1
"Colombia",489,1,6,5,3,2,1
"Costa Rica",489,1,4,3,2,1,2
"Argentina",489,4,7,7,2,5,1
"Switzerland",489,4,7,6,4,2,2
"Belgium",489,8,6,6,2,4,1
"Senegal",489,8,4,2,2,0,2
"France",490,3,6,5,3,2,1
"Denmark",490,3,4,4,3,1,2
"Argentina",490,4,5,5,3,2,1
"Mexico",490,4,4,5,4,1,2
"Colombia",490,5,6,4,3,1,2
"United States",490,5,6,5,3,2,1
"Brazil",490,8,6,7,2,5,1
"Germany",490,8,6,4,2,2,2
"Uruguay",491,1,7,4,1,3,1
"Senegal",491,1,4,5,3,2,2
"Portugal",491,5,6,4,4,0,2
"Denmark",491,5,6,4,3,1,1
"Wales",491,8,6,5,5,0,2
"Costa Rica",491,8,6,6,5,1,1
"Poland",492,1,6,5,4,1,1
"Algeria",492,1,6,3,3,0,2
"Belgium",492,3,7,5,2,3,1
"Japan",492,3,4,2,2,0,2
"France",493,2,5,3,1,2,1
"Japan",493,2,4,2,2,0,2
"Korea Republic",493,3,6,4,2,2,1
"Portugal",493,3,4,3,2,1,2
"Iran",493,5,5,2,1,1,1
"England",493,5,4,2,1,1,2
"Spain",493,8,7,6,3,3,2
"Germany",493,8,7,6,0,6,1
"Wales",494,2,6,6,1,5,1
"Germany",494,2,4,5,4,1,2
"Uruguay",494,5,9,4,0,4,1
"Belgium",494,5,3,5,3,2,2
"Portugal",494,6,6,6,3,3,1
"Switzerland",494,6,6,4,4,0,2
"France",494,8,9,7,0,7,1
"Italy",494,8,4,3,2,1,2
"Denmark",495,1,4,4,1,3,1
"United States",495,1,4,3,3,0,2
"Portugal",495,5,6,3,3,0,1
"Iran",495,5,4,4,3,1,2
"Argentina",495,7,7,7,2,5,1
"Italy",495,7,4,5,4,1,2
"France",495,8,5,4,2,2,1
"Netherlands",495,8,5,3,2,1,2
"Netherlands",496,1,5,4,2,2,1
"Morocco",496,1,5,4,3,1,2
"Uruguay",496,2,6,5,3,2,1
"Poland",496,2,6,4,3,1,2
"Uruguay",497,3,7,5,3,2,1
"Spain",497,3,4,4,1,3,2
"Spain",498,3,9,6,0,6,1
"Japan",498,3,4,4,3,1,2
"Brazil",498,7,6,7,2,5,1
"Netherlands",498,7,6,3,2,1,2
"Switzerland",499,1,6,6,4,2,1
"Uruguay",499,1,4,4,4,0,2
"United States",499,2,6,7,6,1,1
"Argentina",499,2,4,2,2,0,2
"Belgium",499,4,9,10,4,6,1
"Germany",499,4,4,4,5,-1,2
"Portugal",499,8,7,3,0,3,2
"Denmark",499,8,7,7,1,6,1
"Algeria",500,1,7,8,1,7,1
"Qatar",500,1,4,3,4,-1,2
"Spain",500,2,7,7,3,4,1
"Korea Republic",500,2,7,5,2,3,2
"Belgium",500,5,5,5,2,3,1
"Japan",500,5,4,4,3,1,2
"Belgium",501,2,6,5,3,2,1
"Mexico",501,2,6,4,4,0,2
"France",501,6,5,4,2,2,1
"Denmark",501,6,4,3,3,0,2
"Chile",502,4,5,4,2,2,1
"Nigeria",502,4,4,4,4,0,2
"Croatia",502,5,5,6,3,3,1
"Japan",502,5,4,2,2,0,2
"Brazil",502,8,9,5,1,4,1
"Netherlands",502,8,3,5,5,0,2
"Qatar",503,1,6,6,4,2,1
"Algeria",503,1,4,4,3,1,2
"Argentina",503,3,6,4,4,0,2
"Italy",503,3,6,5,2,3,1
"Brazil",503,4,6,8,3,5,1
"Croatia",503,4,4,2,2,0,2
"Tunisia",503,5,6,7,4,3,1
"Uruguay",503,5,4,4,3,1,2
"Belgium",503,6,7,4,1,3,1
"Australia",503,6,4,2,1,1,2
"Jamaica",504,2,5,4,3,1,1
"Belgium",504,2,4,5,3,2,2
"England",504,5,6,2,1,1,1
"Nigeria",504,5,6,2,2,0,2
"Spain",504,7,6,5,2,3,1
"Poland",504,7,6,5,3,2,2
"Portugal",505,3,7,4,2,2,2
"Netherlands",505,3,7,6,1,5,1
"England",505,8,5,1,0,1,2
"Uruguay",505,8,5,4,1,3,1
"Argentina",506,5,6,6,3,3,1
"Australia",506,5,6,4,4,0,2
"Belgium",506,6,6,6,2,4,1
"Jamaica",506,6,4,1,2,-1,2
"Chile",507,4,5,3,2,1,1
"Algeria",507,4,4,2,2,0,2
"Spain",507,5,7,4,0,4,1
"Germany",507,5,7,2,0,2,2
"Belgium",507,6,9,7,1,6,1
"Denmark",507,6,3,3,3,0,2
"Colombia",507,7,9,5,0,5,1
"England",507,7,3,6,5,1,2
"Brazil",508,5,7,4,1,3,1
"Denmark",508,5,4,6,3,3,2
"Belgium",508,7,4,6,2,4,1
"Korea Republic",508,7,4,3,3,0,2
"Uruguay",508,8,6,5,4,1,2
"Algeria",508,8,6,4,2,2,1
"Argentina",509,2,9,8,2,6,1
"Costa Rica",509,2,4,5,5,0,2
"Italy",509,3,5,6,3,3,1
"Iran",509,3,5,4,3,1,2
"Netherlands",509,4,7,5,3,2,1
"Poland",509,4,4,5,3,2,2
"United States",509,5,7,5,2,3,1
"Portugal",509,5,4,4,3,1,2
"Spain",509,6,6,5,2,3,2
"Uruguay",509,6,6,9,4,5,1
"Colombia",510,5,5,4,2,2,1
"Portugal",510,5,4,8,3,5,2
"Qatar",511,1,6,6,3,3,2
"Netherlands",511,1,6,6,2,4,1
"France",511,5,6,4,3,1,1
"Japan",511,5,4,5,3,2,2
"Portugal",511,7,6,5,1,4,1
"Australia",511,7,6,4,5,-1,2
"Spain",512,2,4,2,1,1,1
"Netherlands",512,2,4,2,2,0,2
"Mexico",512,4,5,5,1,4,1
"Algeria",512,4,5,2,1,1,2
"France",514,3,9,15,1,14,1
"Netherlands",514,3,4,6,5,1,2
"Italy",516,1,6,6,4,2,1
"Qatar",516,1,4,2,2,0,2
"Belgium",516,2,6,7,3,4,1
"Denmark",516,2,6,6,3,3,2
"Argentina",516,5,6,5,4,1,2
"Algeria",516,5,6,7,5,2,1
"England",516,7,9,9,4,5,1
"Chile",516,7,3,6,5,1,2
"France",517,3,6,6,3,3,1
"Poland",517,3,6,4,4,0,2
"Italy",517,4,6,4,3,1,1
"Iran",517,4,4,5,4,1,2
"Denmark",518,6,7,4,2,2,1
"Iran",518,6,4,6,4,2,2
"Senegal",519,1,5,1,0,1,1
"Qatar",519,1,4,2,1,1,2
"Brazil",519,7,5,3,1,2,1
"Iran",519,7,5,3,2,1,2
"Switzerland",520,1,7,5,2,3,1
"Jamaica",520,1,7,4,2,2,2
"Brazil",520,5,7,6,2,4,1
"Germany",520,5,7,2,0,2,2
"Qatar",521,1,7,7,3,4,1
"Netherlands",521,1,4,4,3,1,2
"Portugal",521,6,6,3,2,1,1
"Uruguay",521,6,4,2,1,1,2
"Germany",522,1,6,5,2,3,1
"Chile",522,1,6,6,4,2,2
"Korea Republic",522,2,6,4,4,0,1
"Denmark",522,2,4,3,3,0,2
"Uruguay",522,3,9,6,1,5,1
"United States",522,3,4,5,4,1,2
"France",522,4,6,4,4,0,2
"Netherlands",522,4,6,7,2,5,1
"Argentina",522,6,7,4,0,4,1
"Mexico",522,6,4,5,4,1,2
"Switzerland",522,8,6,6,5,1,1
"Colombia",522,8,4,7,4,3,2
"Argentina",523,4,7,6,2,4,2
"Croatia",523,4,7,9,4,5,1
"Spain",523,5,5,3,2,1,2
"Uruguay",523,5,5,5,2,3,1
"Qatar",524,1,6,5,4,1,2
"Switzerland",524,1,6,5,1,4,1
"Argentina",524,6,7,3,0,3,1
"Japan",524,6,7,3,1,2,2
"Portugal",524,8,6,5,2,3,1
"Iran",524,8,6,4,3,1,2
"United States",525,1,6,5,3,2,1
"Algeria",525,1,6,3,3,0,2
"Japan",525,2,5,3,1,2,1
"Argentina",525,2,4,3,2,1,2
"Qatar",526,1,6,4,4,0,1
"Costa Rica",526,1,6,6,7,-1,2
"Switzerland",526,4,6,7,4,3,1
"Iran",526,4,4,3,2,1,2
"Spain",527,6,7,5,3,2,2
"Netherlands",527,6,7,9,4,5,1
"Denmark",527,7,7,5,1,4,1
"Portugal",527,7,4,5,4,1,2
"Croatia",528,1,6,6,1,5,1
"Poland",528,1,4,1,1,0,2
"Uruguay",528,3,6,3,2,1,1
"Belgium",528,3,4,5,4,1,2
"Croatia",529,1,7,6,2,4,1
"United States",529,1,7,7,4,3,2
"England",530,2,6,3,5,-2,2
"Chile",530,2,6,4,3,1,1
"Belgium",530,6,5,4,3,1,2
"Australia",530,6,5,6,3,3,1
"Portugal",531,6,6,5,2,3,1
"Chile",531,6,6,3,3,0,2
"Germany",532,4,7,4,1,3,1
"Spain",532,4,4,5,4,1,2
"Argentina",532,5,9,6,1,5,1
"Mexico",532,5,4,4,3,1,2
"Mexico",533,4,6,4,3,1,2
"Wales",533,4,6,9,5,4,1
"Germany",533,7,7,8,2,6,1
"France",533,7,4,1,1,0,2
"Croatia",533,8,5,7,4,3,1
"Belgium",533,8,4,5,4,1,2
"England",534,2,5,4,2,2,1
"Iran",534,2,5,4,3,1,2
"France",534,3,7,5,3,2,2
"Mexico",534,3,7,8,2,6,1
"Spain",534,4,5,3,2,1,2
"Netherlands",534,4,5,4,2,2,1
"Brazil",534,6,7,8,3,5,1
"Denmark",534,6,7,5,1,4,2
"Belgium",534,8,6,4,3,1,2
"Italy",534,8,6,5,1,4,1
"Croatia",535,4,6,4,3,1,2
"Algeria",535,4,6,5,2,3,1
"Uruguay",536,1,6,5,2,3,1
"Wales",536,1,6,5,4,1,2
"Spain",536,2,6,6,5,1,2
"Iran",536,2,6,7,4,3,1
"Portugal",536,4,7,9,2,7,1
"Colombia",536,4,4,6,3,3,2
"France",536,7,9,8,1,7,1
"Japan",536,7,3,2,3,-1,2
"Belgium",538,6,6,5,2,3,1
"Wales",538,6,6,3,2,1,2
"France",539,6,7,7,2,5,1
"Mexico",539,6,7,7,3,4,2
"Portugal",539,7,6,3,4,-1,2
"Korea Republic",539,7,6,7,3,4,1
"England",540,4,7,4,2,2,1
"Croatia",540,4,4,3,2,1,2
"Netherlands",540,6,9,5,1,4,1
"Brazil",540,6,4,3,2,1,2
"France",540,7,5,6,1,5,1
"Chile",540,7,5,1,0,1,2
"Croatia",541,3,6,4,3,1,1
"Morocco",541,3,4,4,3,1,2
"England",542,4,5,3,2,1,2
"Switzerland",542,4,5,5,3,2,1
"France",542,8,6,5,2,3,1
"Mexico",542,8,4,4,4,0,2
"Qatar",543,1,6,4,5,-1,1
"United States",543,1,4,5,3,2,2
"Italy",544,2,9,5,1,4,1
"England",544,2,4,3,1,2,2
"Spain",544,4,6,6,4,2,1
"Germany",544,4,6,2,2,0,2
"France",544,8,4,4,1,3,1
"Morocco",544,8,4,2,2,0,2
"France",545,6,6,2,2,0,2
"United States",545,6,6,2,1,1,1
"Belgium",546,2,6,7,3,4,1
"Italy",546,2,6,4,4,0,2
"Spain",546,4,5,5,1,4,1
"Colombia",546,4,5,2,1,1,2
"Qatar",547,1,5,7,5,2,1
"Mexico",547,1,4,4,3,1,2
"Colombia",547,5,9,10,3,7,1
"Poland",547,5,4,4,3,1,2
"France",548,3,5,5,3,2,1
"Colombia",548,3,5,4,3,1,2
"Argentina",548,7,5,6,3,3,1
"Australia",548,7,5,5,3,2,2
"Italy",549,8,6,5,2,3,1
"Chile",549,8,6,6,4,2,2
"Argentina",550,4,5,3,0,3,1
"Croatia",550,4,5,3,2,1,2
"Mexico",551,1,6,8,2,6,1
"Wales",551,1,6,6,2,4,2
"Korea Republic",551,2,9,4,1,3,1
"Senegal",551,2,4,5,2,3,2
"Croatia",551,4,5,6,5,1,1
"Belgium",551,4,4,7,6,1,2
"France",551,6,9,7,1,6,1
"Switzerland",551,6,3,3,4,-1,2
"Netherlands",551,8,9,7,1,6,1
"Spain",551,8,4,5,3,2,2
"Denmark",552,4,6,5,3,2,1
"Australia",552,4,4,5,3,2,2
"Denmark",553,3,9,6,3,3,1
"United States",553,3,4,4,2,2,2
"England",554,4,9,5,0,5,1
"Italy",554,4,4,4,2,2,2
"Netherlands",555,3,9,6,1,5,1
"Iran",555,3,4,4,3,1,2
"Spain",555,7,6,3,4,-1,2
"Poland",555,7,6,9,5,4,1
"Italy",556,6,7,4,1,3,1
"Chile",556,6,7,3,1,2,2
"Argentina",556,7,6,5,4,1,2
"Mexico",556,7,6,6,3,3,1
"Chile",557,5,5,3,0,3,1
"Croatia",557,5,4,6,5,1,2
"Denmark",557,8,9,7,2,5,1
"Brazil",557,8,4,8,4,4,2
"Qatar",558,1,7,3,0,3,2
"Italy",558,1,7,7,1,6,1
"Netherlands",558,7,6,6,2,4,1
"Switzerland",558,7,6,3,3,0,2
"Spain",559,3,6,3,2,1,2
"Mexico",559,3,6,8,2,6,1
"Denmark",559,8,7,7,5,2,1
"Argentina",559,8,4,4,3,1,2
"Brazil",560,2,6,7,3,4,1
"Wales",560,2,6,4,2,2,2
"France",560,3,7,4,1,3,2
"Japan",560,3,7,5,1,4,1
"Denmark",561,6,5,5,4,1,1
"Japan",561,6,4,6,4,2,2
"Portugal",562,2,6,6,2,4,1
"Uruguay",562,2,6,4,3,1,2
"Belgium",562,5,6,7,4,3,1
"Tunisia",562,5,6,4,2,2,2
"France",562,7,6,4,3,1,2
"Colombia",562,7,6,5,3,2,1
"Spain",562,8,6,5,2,3,1
"Korea Republic",562,8,4,3,4,-1,2
"Belgium",563,3,7,3,0,3,1
"Netherlands",563,3,7,2,0,2,2
"Netherlands",564,1,4,5,3,2,1
"Wales",564,1,4,4,3,1,2
"Argentina",565,4,5,4,2,2,1
"Italy",565,4,5,2,1,1,2
"Uruguay",565,7,7,6,1,5,1
"Belgium",565,7,4,6,3,3,2
"Germany",566,1,5,5,3,2,1
"Costa Rica",566,1,5,5,4,1,2
"Spain",566,2,7,4,0,4,1
"Algeria",566,2,4,2,2,0,2
"Brazil",569,2,7,5,1,4,2
"Mexico",569,2,7,7,2,5,1
"England",569,3,5,4,3,1,1
"Iran",569,3,4,5,5,0,2
"Colombia",569,8,6,7,2,5,1
"Switzerland",569,8,6,3,2,1,2
"England",570,3,6,9,5,4,1
"Colombia",570,3,6,3,4,-1,2
"Belgium",570,5,6,5,1,4,1
"Uruguay",570,5,6,4,3,1,2
"Senegal",571,1,7,4,0,4,1
"Qatar",571,1,4,3,3,0,2
"France",571,2,7,5,1,4,1
"Uruguay",571,2,7,4,1,3,2
"Spain",571,3,6,7,3,4,1
"Switzerland",571,3,4,2,2,0,2
"England",571,5,9,5,0,5,1
"Nigeria",571,5,4,2,2,0,2
"Italy",571,8,5,2,1,1,2
"Korea Republic",571,8,5,3,1,2,1
"Portugal",573,7,7,10,1,9,1
"Chile",573,7,4,3,3,0,2
"Croatia",576,1,9,9,3,6,1
"Chile",576,1,3,6,7,-1,2
"Argentina",576,6,9,5,1,4,1
"Nigeria",576,6,3,3,3,0,2
"Poland",577,3,5,3,1,2,1
"Portugal",577,3,4,3,2,1,2
"France",577,5,6,5,2,3,1
"Korea Republic",577,5,4,3,1,2,2
"Netherlands",577,8,6,7,5,2,1
"Switzerland",577,8,6,5,4,1,2
"Senegal",578,1,6,4,3,1,1
"Qatar",578,1,4,4,3,1,2
"Belgium",578,6,5,5,2,3,1
"Iran",578,6,5,3,2,1,2
"Uruguay",579,1,7,6,3,3,1
"Senegal",579,1,4,3,3,0,2
"Croatia",579,4,7,4,2,2,1
"Iran",579,4,4,4,2,2,2
"Portugal",579,8,7,6,2,4,1
"Colombia",579,8,7,3,1,2,2
"Japan",580,7,9,5,2,3,1
"Brazil",580,7,3,4,3,1,2
"Spain",581,2,7,5,0,5,1
"Korea Republic",581,2,7,4,2,2,2
"England",581,3,9,9,3,6,1
"Switzerland",581,3,3,8,7,1,2
"France",581,5,9,11,2,9,1
"Uruguay",581,5,4,2,1,1,2
"Argentina",581,7,7,6,2,4,2
"Mexico",581,7,7,7,2,5,1
"Portugal",581,8,7,3,1,2,1
"Australia",581,8,4,3,1,2,2
"Argentina",582,2,6,6,3,3,1
"Korea Republic",582,2,6,6,5,1,2
"Mexico",582,4,9,7,2,5,1
"Iran",582,4,2,2,3,-1,2
"Uruguay",582,6,9,8,2,6,1
"Portugal",582,6,3,9,6,3,2
"Brazil",583,3,9,11,2,9,1
"Japan",583,3,4,6,5,1,2
"France",583,8,5,6,2,4,1
"Chile",583,8,5,3,2,1,2
"Denmark",584,1,6,5,2,3,1
"Tunisia",584,1,6,3,3,0,2
"Uruguay",585,5,9,6,2,4,1
"England",585,5,4,4,4,0,2
"Spain",585,7,9,6,1,5,1
"Korea Republic",585,7,4,9,4,5,2
"Belgium",585,8,6,7,3,4,1
"Italy",585,8,6,6,4,2,2
"France",587,2,4,6,3,3,1
"Japan",587,2,4,4,4,0,2
"Korea Republic",587,6,6,6,5,1,1
"Argentina",587,6,4,6,3,3,2
"England",588,3,6,4,3,1,1
"Algeria",588,3,4,3,2,1,2
"Brazil",588,4,7,6,0,6,1
"Jamaica",588,4,4,3,4,-1,2
"Germany",588,5,9,7,1,6,1
"Belgium",588,5,3,4,4,0,2
"France",588,7,5,4,2,2,1
"Colombia",588,7,5,3,2,1,2
"Algeria",589,1,7,3,1,2,1
"Mexico",589,1,4,5,4,1,2
"Argentina",589,2,9,7,1,6,1
"Germany",589,2,3,7,4,3,2
"Brazil",589,7,9,6,2,4,1
"Wales",589,7,4,5,1,4,2
"Qatar",590,1,7,6,2,4,1
"Croatia",590,1,7,4,2,2,2
"Spain",590,5,9,7,3,4,1
"Japan",590,5,4,4,3,1,2
"England",590,6,5,4,3,1,1
"Mexico",590,6,4,6,5,1,2
"Switzerland",590,8,5,4,3,1,2
"Iran",590,8,5,4,1,3,1
"Croatia",591,1,7,6,3,3,1
"Nigeria",591,1,4,2,2,0,2
"Japan",591,2,5,4,3,1,1
"Germany",591,2,4,5,4,1,2
"Qatar",592,1,6,3,1,2,2
"Switzerland",592,1,6,5,2,3,1
"Croatia",592,5,7,4,1,3,2
"Australia",592,5,7,6,0,6,1
"Denmark",592,6,9,5,2,3,1
"Chile",592,6,4,7,6,1,2
"Mexico",593,3,7,7,2,5,1
"Korea Republic",593,3,4,4,4,0,2
"Senegal",593,4,7,3,0,3,1
"Spain",593,4,4,7,3,4,2
"Croatia",593,8,5,6,1,5,1
"Australia",593,8,4,2,2,0,2
"Portugal",594,3,5,4,2,2,1
"Germany",594,3,5,6,5,1,2
"Spain",594,8,7,6,3,3,2
"Colombia",594,8,7,8,4,4,1
"France",595,4,7,10,1,9,1
"Colombia",595,4,7,5,1,4,2
"Croatia",595,5,6,3,1,2,1
"United States",595,5,6,3,4,-1,2
"Uruguay",595,7,6,7,3,4,1
"Spain",595,7,4,2,1,1,2
"France",596,3,7,5,1,4,1
"Morocco",596,3,4,5,4,1,2
"Mexico",597,5,6,5,2,3,1
"Iran",597,5,6,4,3,1,2
"Brazil",597,7,9,4,1,3,1
"Costa Rica",597,7,4,5,3,2,2
"France",597,8,6,5,4,1,1
"Korea Republic",597,8,4,3,2,1,2
"Korea Republic",598,4,6,3,2,1,1
"Chile",598,4,4,4,3,1,2
"Argentina",598,5,6,6,5,1,2
"Wales",598,5,6,7,4,3,1
"France",598,6,7,6,1,5,1
"Algeria",598,6,7,4,2,2,2
"Argentina",599,3,7,8,3,5,1
"Germany",599,3,7,2,0,2,2
"Colombia",601,1,6,5,2,3,1
"Qatar",601,1,4,4,3,1,2
"Belgium",601,2,7,6,2,4,1
"Japan",601,2,4,3,2,1,2
"France",601,4,6,7,3,4,1
"Tunisia",601,4,6,3,5,-2,2
"Argentina",601,6,5,5,3,2,1
"United States",601,6,4,3,2,1,2
"Germany",602,4,6,8,2,6,1
"Switzerland",602,4,6,5,3,2,2
"Spain",602,5,6,3,3,0,1
"Japan",602,5,4,4,3,1,2
"Korea Republic",602,8,7,6,2,4,1
"England",602,8,4,4,2,2,2
"Netherlands",603,1,7,10,2,8,1
"Morocco",603,1,7,5,3,2,2
"Portugal",603,7,7,10,2,8,1
"Germany",603,7,7,5,2,3,2
"England",604,3,6,7,2,5,1
"Germany",604,3,6,4,1,3,2
"Chile",604,5,5,1,0,1,1
"Croatia",604,5,4,4,2,2,2
"Belgium",604,8,6,5,3,2,1
"Denmark",604,8,4,2,2,0,2
"Argentina",605,6,9,4,0,4,1
"Mexico",605,6,4,2,2,0,2
"Croatia",605,7,9,6,0,6,1
"France",605,7,4,1,1,0,2
"England",605,8,7,9,2,7,1
"Netherlands",605,8,7,4,1,3,2
"Denmark",606,2,5,3,1,2,1
"Brazil",606,2,4,6,4,2,2
"Argentina",606,3,6,4,2,2,2
"Germany",606,3,6,6,3,3,1
"England",606,4,6,3,1,2,1
"Uruguay",606,4,6,6,5,1,2
"Mexico",606,6,5,3,2,1,2
"Poland",606,6,5,3,1,2,1
"Colombia",607,6,7,7,4,3,1
"France",607,6,4,5,4,1,2
"Qatar",608,1,6,8,5,3,1
"Germany",608,1,6,5,3,2,2
"Denmark",608,7,7,7,4,3,1
"Tunisia",608,7,7,5,3,2,2
"Mexico",608,8,6,3,3,0,1
"Portugal",608,8,4,3,1,2,2
"Portugal",609,7,9,10,2,8,1
"Croatia",609,7,4,5,5,0,2
"Belgium",610,6,7,9,2,7,1
"Italy",610,6,4,5,4,1,2
"Spain",611,3,6,3,2,1,2
"Poland",611,3,6,5,1,4,1
"Belgium",611,4,9,10,1,9,1
"Croatia",611,4,3,6,4,2,2
"France",611,5,7,8,1,7,1
"Netherlands",611,5,7,6,1,5,2
"Senegal",612,1,5,4,2,2,1
"Costa Rica",612,1,4,6,5,1,2
"England",613,7,7,7,4,3,2
"Korea Republic",613,7,7,6,2,4,1
"Iran",614,5,9,7,2,5,1
"Colombia",614,5,3,5,4,1,2
"Portugal",614,8,7,7,3,4,1
"Italy",614,8,7,7,4,3,2
"Senegal",615,1,6,5,2,3,1
"Costa Rica",615,1,6,4,3,1,2
"France",616,6,7,4,2,2,2
"Uruguay",616,6,7,6,1,5,1
"Spain",616,8,5,5,2,3,1
"Chile",616,8,5,1,0,1,2
"Germany",617,1,7,9,3,6,1
"Senegal",617,1,7,3,1,2,2
"Argentina",617,3,7,7,1,6,1
"Italy",617,3,7,4,0,4,2
"Brazil",617,8,9,9,1,8,1
"Morocco",617,8,4,3,3,0,2
"Qatar",618,1,7,7,2,5,1
"Senegal",618,1,7,6,3,3,2
"Spain",618,6,6,4,2,2,2
"Australia",618,6,6,8,4,4,1
"Portugal",618,7,6,3,4,-1,2
"Denmark",618,7,6,5,3,2,1
"Germany",620,2,6,2,3,-1,1
"England",620,2,4,5,4,1,2
"Brazil",620,5,9,6,1,5,1
"Senegal",620,5,4,3,2,1,2
"Uruguay",620,7,7,4,1,3,1
"Portugal",620,7,4,4,3,1,2
"Senegal",621,1,5,2,1,1,1
"Denmark",621,1,4,3,1,2,2
"Brazil",621,4,6,5,2,3,1
"Switzerland",621,4,6,3,2,1,2
"Croatia",621,8,6,6,2,4,1
"United States",621,8,6,2,3,-1,2
"Belgium",623,7,7,7,4,3,1
"Poland",623,7,7,4,2,2,2
"Mexico",624,8,9,5,0,5,1
"Portugal",624,8,4,5,3,2,2
"France",625,6,7,9,2,7,1
"Germany",625,6,7,8,3,5,2
"Netherlands",625,7,5,6,2,4,1
"United States",625,7,5,2,1,1,2
"Colombia",626,3,9,6,2,4,1
"Portugal",626,3,4,5,3,2,2
"Brazil",626,7,7,6,0,6,1
"Iran",626,7,4,3,2,1,2
"Italy",626,8,9,4,1,3,1
"Algeria",626,8,4,3,2,1,2
"Portugal",627,5,6,8,2,6,1
"Mexico",627,5,6,4,3,1,2
"Spain",627,8,6,2,2,0,1
"Chile",627,8,4,4,3,1,2
"Mexico",629,2,7,8,2,6,1
"Australia",629,2,7,6,2,4,2
"Croatia",629,3,6,4,2,2,1
"Belgium",629,3,4,3,2,1,2
"France",629,5,6,4,2,2,1
"Denmark",629,5,6,4,3,1,2
"Brazil",629,6,5,1,0,1,2
"Senegal",629,6,5,2,0,2,1
"Spain",629,7,5,6,3,3,1
"Germany",629,7,5,4,2,2,2
"Italy",630,2,5,3,2,1,1
"France",630,2,4,4,2,2,2
"Argentina",630,5,6,4,2,2,1
"Jamaica",630,5,6,3,2,1,2
"Poland",630,7,9,6,1,5,1
"Uruguay",630,7,3,4,4,0,2
"France",632,8,5,3,2,1,2
"Netherlands",632,8,5,4,2,2,1
"Algeria",633,1,6,3,1,2,1
"Qatar",633,1,4,2,1,1,2
"Spain",633,5,9,10,1,9,1
"Netherlands",633,5,4,3,4,-1,2
"England",633,7,7,4,1,3,1
"Italy",633,7,4,5,2,3,2
"Belgium",634,2,7,8,0,8,1
"Denmark",634,2,7,5,1,4,2
"Argentina",634,3,9,8,0,8,1
"United States",634,3,4,4,4,0,2
"Spain",634,4,7,5,2,3,2
"Netherlands",634,4,7,8,1,7,1
"France",634,6,6,7,4,3,1
"Uruguay",634,6,6,4,2,2,2
"Australia",634,7,5,3,2,1,1
"Brazil",634,7,4,3,2,1,2
"Iran",634,8,6,5,3,2,1
"England",634,8,4,4,3,1,2
"Mexico",635,3,9,5,1,4,1
"Argentina",635,3,4,3,3,0,2
"England",635,7,5,7,3,4,1
"Germany",635,7,5,4,2,2,2
"France",637,2,6,4,3,1,1
"Colombia",637,2,4,6,5,1,2
"Portugal",637,3,9,5,1,4,1
"Mexico",637,3,3,2,2,0,2
"Brazil",638,2,6,7,2,5,1
"Netherlands",638,2,6,6,2,4,2
"England",638,5,6,5,3,2,1
"Senegal",638,5,4,2,2,0,2
"Germany",638,8,5,5,4,1,2
"Iran",638,8,5,4,2,2,1
"Argentina",640,2,6,7,2,5,1
"Wales",640,2,6,8,5,3,2
"France",640,5,6,5,3,2,1
"Japan",640,5,4,5,4,1,2
"Portugal",641,4,7,5,1,4,1
"Wales",641,4,4,2,2,0,2
"England",641,5,9,6,1,5,1
"Chile",641,5,4,7,3,4,2
"Brazil",642,5,6,6,5,1,1
"Iran",642,5,4,5,3,2,2
"England",642,7,5,7,3,4,1
"United States",642,7,5,4,1,3,2
"Italy",643,6,7,7,2,5,1
"Switzerland",643,6,7,3,1,2,2
"Spain",643,8,5,2,1,1,1
"Japan",643,8,4,3,2,1,2
"Spain",644,2,9,6,0,6,1
"Netherlands",644,2,3,3,3,0,2
"England",644,6,5,7,4,3,1
"Nigeria",644,6,4,3,3,0,2
"Italy",644,8,6,3,1,2,1
"Belgium",644,8,4,2,1,1,2
"Qatar",645,1,6,3,3,0,1
"Algeria",645,1,4,4,2,2,2
"Uruguay",645,4,6,3,3,0,2
"Senegal",645,4,6,6,4,2,1
"Brazil",645,5,7,6,1,5,2
"Netherlands",645,5,7,7,1,6,1
"Belgium",646,5,6,7,3,4,1
"Uruguay",646,5,4,2,2,0,2
"Portugal",647,6,7,5,0,5,1
"Uruguay",647,6,7,6,4,2,2
"Spain",648,5,9,7,0,7,1
"Croatia",648,5,4,3,1,2,2
"Brazil",649,2,5,6,2,4,1
"Netherlands",649,2,5,6,5,1,2
"Portugal",649,4,9,5,0,5,1
"Italy",649,4,3,5,3,2,2
"Wales",650,1,5,4,3,1,1
"Croatia",650,1,4,4,4,0,2
"Spain",650,3,9,8,3,5,1
"Uruguay",650,3,3,3,3,0,2
"France",651,2,6,5,2,3,1
"Iran",651,2,4,2,1,1,2
"Switzerland",651,4,7,6,1,5,1
"Mexico",651,4,4,2,2,0,2
"Brazil",651,8,5,4,3,1,2
"Denmark",651,8,5,4,1,3,1
"Brazil",652,2,7,5,2,3,2
"Netherlands",652,2,7,8,3,5,1
"Portugal",652,5,9,11,2,9,1
"Uruguay",652,5,4,2,3,-1,2
"Costa Rica",652,8,5,3,2,1,1
"Belgium",652,8,4,6,3,3,2
"Croatia",653,6,6,3,2,1,1
"Australia",653,6,4,3,2,1,2
"Italy",654,1,7,7,2,5,1
"Jamaica",654,1,4,7,4,3,2
"Japan",654,5,6,4,4,0,1
"Spain",654,5,4,6,3,3,2
"Germany",654,8,7,5,2,3,1
"Poland",654,8,4,8,6,2,2
"Spain",656,4,6,4,1,3,1
"Uruguay",656,4,6,4,3,1,2
"Argentina",657,3,5,2,0,2,1
"United States",657,3,5,3,2,1,2
"England",657,7,5,4,3,1,2
"Croatia",657,7,5,6,3,3,1
"Switzerland",658,1,6,7,5,2,1
"Algeria",658,1,4,5,5,0,2
"France",658,8,7,11,3,8,1
"Italy",658,8,7,7,1,6,2
"England",659,5,6,4,4,0,2
"Italy",659,5,6,6,3,3,1
"Italy",660,7,6,6,4,2,1
"Iran",660,7,6,7,7,0,2
"France",661,5,9,7,1,6,1
"Denmark",661,5,4,5,3,2,2
"Netherlands",661,6,7,9,3,6,1
"Argentina",661,6,4,7,6,1,2
"England",662,8,6,4,4,0,2
"Italy",662,8,6,6,3,3,1
"France",663,4,5,6,4,2,2
"Colombia",663,4,5,6,3,3,1
"Argentina",663,7,5,3,2,1,1
"Croatia",663,7,4,5,3,2,2
"Morocco",664,1,5,2,0,2,1
"Poland",664,1,4,1,1,0,2
"Spain",664,5,7,6,2,4,1
"Uruguay",664,5,7,5,2,3,2
"Denmark",664,7,5,5,1,4,1
"Chile",664,7,5,5,3,2,2
"England",665,6,5,5,2,3,1
"Uruguay",665,6,5,2,1,1,2
"Brazil",667,3,7,5,2,3,1
"Australia",667,3,4,3,2,1,2
"England",667,4,6,10,2,8,1
"Mexico",667,4,6,3,3,0,2
"Colombia",667,6,6,4,4,0,2
"Wales",667,6,6,2,1,1,1
"France",667,8,6,9,5,4,1
"Chile",667,8,6,5,7,-2,2
"Brazil",668,5,6,6,2,4,1
"Mexico",668,5,6,6,3,3,2
"Denmark",668,7,9,7,3,4,1
"Argentina",668,7,4,5,4,1,2
"Japan",669,2,6,4,2,2,1
"Belgium",669,2,4,1,1,0,2
"Germany",669,3,7,4,2,2,2
"Australia",669,3,7,4,1,3,1
"France",669,4,6,6,1,5,1
"Colombia",669,4,6,4,1,3,2
"Denmark",669,8,6,7,3,4,1
"Chile",669,8,6,5,4,1,2
"Croatia",670,1,6,4,3,1,1
"Poland",670,1,4,4,3,1,2
"Colombia",670,5,6,3,2,1,1
"Portugal",670,5,4,8,3,5,2
"England",670,8,4,4,4,0,2
"Italy",670,8,4,4,3,1,1
"Spain",671,4,6,6,2,4,1
"Iran",671,4,6,7,5,2,2
"Brazil",671,5,7,8,1,7,1
"Australia",671,5,4,7,4,3,2
"Spain",672,2,5,4,2,2,1
"Korea Republic",672,2,5,3,2,1,2
"Portugal",673,4,6,6,2,4,1
"Costa Rica",673,4,6,4,4,0,2
"Brazil",673,6,9,11,3,8,1
"United States",673,6,4,2,3,-1,2
"Belgium",673,8,6,2,1,1,2
"Italy",673,8,6,4,2,2,1
"Brazil",674,4,5,5,3,2,1
"United States",674,4,5,2,1,1,2
"Spain",674,7,6,2,1,1,1
"Tunisia",674,7,6,3,3,0,2
"Belgium",674,8,6,3,1,2,2
"Italy",674,8,6,7,3,4,1
"Germany",675,1,7,6,2,4,1
"Switzerland",675,1,4,5,3,2,2
"Denmark",676,1,9,11,1,10,1
"Chile",676,1,4,2,2,0,2
"Argentina",676,3,7,7,2,5,2
"Italy",676,3,7,10,3,7,1
"Mexico",677,1,6,4,2,2,1
"Poland",677,1,4,3,2,1,2
"France",677,6,9,8,1,7,1
"Switzerland",677,6,4,4,5,-1,2
"Spain",678,2,6,3,1,2,1
"Korea Republic",678,2,6,3,2,1,2
"Argentina",678,4,7,4,0,4,1
"United States",678,4,4,3,3,0,2
"Denmark",678,6,7,4,2,2,1
"France",678,6,4,9,6,3,2
"Brazil",678,7,6,8,4,4,1
"Italy",678,7,4,5,4,1,2
"Switzerland",679,1,6,5,3,2,1
"Costa Rica",679,1,4,3,3,0,2
"Mexico",679,2,5,3,2,1,2
"Senegal",679,2,5,3,1,2,1
"England",679,8,7,5,1,4,1
"Uruguay",679,8,7,3,1,2,2
"Argentina",680,4,9,9,2,7,1
"Australia",680,4,4,6,5,1,2
"Croatia",680,5,6,4,2,2,2
"Korea Republic",680,5,6,7,1,6,1
"Belgium",682,5,7,4,1,3,1
"Netherlands",682,5,7,5,3,2,2
"Spain",682,6,7,5,3,2,1
"Germany",682,6,4,5,4,1,2
"Croatia",682,8,9,4,0,4,1
"Portugal",682,8,3,4,4,0,2
"Colombia",683,1,7,5,3,2,2
"Wales",683,1,7,6,2,4,1
"Belgium",683,2,6,7,4,3,1
"Nigeria",683,2,6,3,3,0,2
"Brazil",683,6,6,6,3,3,1
"Japan",683,6,6,4,2,2,2
"Spain",683,8,6,5,4,1,2
"Korea Republic",683,8,6,4,2,2,1
"Switzerland",684,1,7,5,1,4,1
"Uruguay",684,1,4,3,3,0,2
"England",684,2,5,4,3,1,1
"Australia",684,2,4,4,3,1,2
"Morocco",684,4,5,4,2,2,1
"Italy",684,4,4,3,3,0,2
"Portugal",684,5,9,5,2,3,1
"Denmark",684,5,3,8,6,2,2
"Netherlands",684,6,9,9,3,6,1
"Poland",684,6,4,5,4,1,2
"Korea Republic",686,2,5,8,4,4,1
"Denmark",686,2,4,6,5,1,2
"Spain",686,8,9,8,0,8,1
"Croatia",686,8,4,2,2,0,2
"Italy",687,1,6,6,2,4,1
"Costa Rica",687,1,6,7,5,2,2
"Belgium",687,2,6,7,3,4,1
"United States",687,2,6,4,3,1,2
"France",687,4,9,6,2,4,1
"Nigeria",687,4,4,7,4,3,2
"Switzerland",687,5,6,4,3,1,1
"Argentina",687,5,4,5,3,2,2
"Brazil",687,6,7,7,4,3,1
"Netherlands",687,6,4,7,4,3,2
"Portugal",687,8,7,8,3,5,1
"Croatia",687,8,4,3,2,1,2
"Colombia",688,1,6,6,4,2,1
"United States",688,1,4,7,6,1,2
"Japan",688,2,5,3,2,1,1
"France",688,2,4,2,2,0,2
"Belgium",688,5,9,4,0,4,1
"Switzerland",688,5,4,2,2,0,2
"England",688,8,6,3,2,1,2
"Netherlands",688,8,6,4,2,2,1
"Uruguay",689,4,6,8,4,4,1
"Algeria",689,4,6,7,7,0,2
"Switzerland",689,5,9,9,2,7,1
"Portugal",689,5,3,5,5,0,2
"Mexico",689,6,5,2,1,1,1
"Argentina",689,6,4,5,3,2,2
"Qatar",690,1,6,4,5,-1,2
"Italy",690,1,6,7,4,3,1
"England",690,2,5,3,2,1,1
"Colombia",690,2,4,3,2,1,2
"Spain",690,5,5,4,1,3,1
"Korea Republic",690,5,5,5,3,2,2
"Belgium",690,7,6,3,4,-1,2
"Chile",690,7,6,5,3,2,1
"Colombia",691,1,9,7,0,7,1
"Jamaica",691,1,4,2,3,-1,2
"Mexico",691,6,7,5,2,3,1
"Wales",691,6,4,3,2,1,2
"Netherlands",691,7,9,7,2,5,1
"France",691,7,4,4,3,1,2
"Brazil",692,3,6,8,2,6,1
"Japan",692,3,4,1,1,0,2
"Spain",693,2,5,4,2,2,1
"Tunisia",693,2,5,1,0,1,2
"Brazil",693,6,6,6,4,2,2
"Mexico",693,6,6,5,1,4,1
"Belgium",694,2,6,4,1,3,1
"Denmark",694,2,6,6,4,2,2
"Uruguay",694,7,7,4,0,4,1
"England",694,7,4,6,2,4,2
"Spain",694,8,7,5,1,4,2
"Germany",694,8,7,5,0,5,1
"Belgium",695,2,5,3,2,1,2
"Japan",695,2,5,5,3,2,1
"Mexico",695,4,7,5,3,2,1
"Australia",695,4,4,4,3,1,2
"Brazil",695,6,6,9,3,6,1
"Germany",695,6,6,8,3,5,2
"Portugal",695,7,6,6,4,2,1
"Switzerland",695,7,6,4,3,1,2
"Argentina",696,2,7,7,3,4,1
"Croatia",696,2,7,7,4,3,2
"Iran",696,3,6,9,5,4,1
"France",696,3,4,4,2,2,2
"Belgium",696,4,9,10,4,6,1
"Denmark",696,4,4,3,4,-1,2
"Switzerland",696,6,9,5,1,4,1
"Germany",696,6,3,4,4,0,2
"Netherlands",697,4,6,6,6,0,1
"Belgium",697,4,4,2,1,1,2
"Costa Rica",697,5,6,2,2,0,1
"Uruguay",697,5,4,5,3,2,2
"Italy",697,6,9,9,3,6,1
"Brazil",697,6,4,8,4,4,2
"Mexico",698,2,6,7,4,3,1
"Belgium",698,2,4,3,3,0,2
"Brazil",698,4,7,3,1,2,2
"Netherlands",698,4,7,5,1,4,1
"Uruguay",698,5,7,4,1,3,2
"Japan",698,5,7,6,2,4,1
"Chile",700,1,6,4,1,3,1
"Jamaica",700,1,6,2,6,-4,2
"Germany",700,3,6,3,2,1,1
"Switzerland",700,3,4,2,1,1,2
"Belgium",700,4,7,7,2,5,1
"Denmark",700,4,4,5,4,1,2
"Argentina",700,5,7,6,1,5,1
"Italy",700,5,4,3,3,0,2
"Portugal",700,7,7,9,5,4,1
"Iran",700,7,7,6,4,2,2
"Brazil",700,8,7,7,1,6,2
"Netherlands",700,8,7,8,1,7,1
"Switzerland",701,1,7,8,2,6,1
"Colombia",701,1,4,3,2,1,2
"Belgium",701,3,7,7,2,5,1
"Algeria",701,3,4,5,5,0,2
"England",701,5,7,6,2,4,1
"Mexico",701,5,4,4,4,0,2
"Spain",702,2,6,8,1,7,1
"Denmark",702,2,6,6,3,3,2
"France",702,5,7,5,2,3,1
"Italy",702,5,4,6,4,2,2
"Nigeria",703,1,9,5,0,5,1
"Netherlands",703,1,4,7,2,5,2
"Brazil",703,3,7,7,5,2,2
"Germany",703,3,7,6,3,3,1
"England",703,4,6,5,2,3,1
"Australia",703,4,6,2,6,-4,2
"Brazil",704,2,7,5,1,4,1
"Germany",704,2,4,5,4,1,2
"Argentina",704,4,5,5,3,2,1
"Switzerland",704,4,4,6,5,1,2
"Italy",704,8,5,2,1,1,1
"Portugal",704,8,4,3,2,1,2
"Denmark",705,2,6,2,2,0,1
"Switzerland",705,2,4,7,5,2,2
"England",705,4,6,5,2,3,1
"Australia",705,4,4,2,2,0,2
"Qatar",706,1,7,3,0,3,1
"Nigeria",706,1,7,3,1,2,2
"Belgium",706,7,7,7,1,6,1
"Tunisia",706,7,4,5,3,2,2
"Belgium",707,3,5,7,5,2,1
"Iran",707,3,4,5,5,0,2
"Qatar",708,1,4,2,1,1,1
"Denmark",708,1,4,2,2,0,2
"England",708,2,9,4,1,3,1
"Mexico",708,2,3,3,2,1,2
"Denmark",710,4,6,6,3,3,1
"Senegal",710,4,6,3,3,0,2
"Portugal",710,8,5,3,2,1,2
"Croatia",710,8,5,2,0,2,1
"Switzerland",711,1,7,6,2,4,1
"Algeria",711,1,4,3,3,0,2
"France",711,2,6,7,7,0,1
"Germany",711,2,4,6,5,1,2
"Netherlands",711,5,9,8,2,6,1
"Iran",711,5,3,6,6,0,2
"England",711,6,6,5,4,1,2
"Uruguay",711,6,6,10,5,5,1
"Portugal",711,8,9,6,2,4,1
"Croatia",711,8,4,3,3,0,2
"Brazil",712,6,6,6,1,5,1
"Croatia",712,6,4,2,2,0,2
"Italy",712,7,7,3,1,2,2
"Iran",712,7,7,5,1,4,1
"Switzerland",713,1,7,7,2,5,1
"Qatar",713,1,4,6,6,0,2
"England",714,2,6,4,1,3,1
"Algeria",714,2,6,3,3,0,2
"Belgium",714,4,9,5,1,4,1
"Italy",714,4,4,6,3,3,2
"France",714,7,9,6,0,6,1
"Morocco",714,7,3,2,2,0,2
"Qatar",715,1,5,5,3,2,1
"Costa Rica",715,1,4,3,3,0,2
"Mexico",715,4,7,4,1,3,1
"Morocco",715,4,7,4,2,2,2
"Brazil",716,4,7,7,3,4,1
"Croatia",716,4,7,7,5,2,2
"England",717,3,6,4,1,3,1
"Mexico",717,3,6,3,2,1,2
"Argentina",717,4,6,5,3,2,2
"Croatia",717,4,6,6,3,3,1
"France",717,5,6,6,1,5,1
"Germany",717,5,6,3,2,1,2
"Spain",717,6,5,3,1,2,1
"Uruguay",717,6,5,2,1,1,2
"Senegal",718,2,6,4,3,1,1
"England",718,2,4,6,5,1,2
"Spain",718,4,6,7,3,4,1
"Uruguay",718,4,6,5,3,2,2
"Belgium",719,2,5,3,2,1,1
"Algeria",719,2,4,5,4,1,2
"Colombia",719,6,9,7,1,6,1
"Portugal",719,6,4,4,3,1,2
"France",719,7,7,12,2,10,1
"Italy",719,7,7,6,2,4,2
"Korea Republic",720,2,5,2,1,1,1
"Switzerland",720,2,4,4,4,0,2
"Belgium",720,6,5,2,0,2,1
"Iran",720,6,5,4,3,1,2
"Portugal",721,3,6,3,1,2,2
"Senegal",721,3,6,5,2,3,1
"England",721,6,6,6,4,2,2
"Japan",721,6,6,7,4,3,1
"England",722,7,7,4,1,3,2
"Colombia",722,7,7,6,2,4,1
"Netherlands",724,2,5,4,3,1,1
"Tunisia",724,2,4,4,3,1,2
"Portugal",724,3,6,10,3,7,1
"Japan",724,3,6,8,5,3,2
"Germany",724,5,5,5,2,3,1
"Brazil",724,5,4,4,3,1,2
"Argentina",724,6,9,6,1,5,1
"Italy",724,6,4,3,2,1,2
"Colombia",724,8,6,4,1,3,1
"Senegal",724,8,6,2,1,1,2
"Italy",725,3,7,5,0,5,1
"Chile",725,3,4,3,1,2,2
"England",726,8,5,9,5,4,1
"Korea Republic",726,8,4,7,5,2,2
"Portugal",727,2,7,5,1,4,1
"Germany",727,2,4,5,3,2,2
"Argentina",727,6,9,6,1,5,1
"Wales",727,6,4,2,1,1,2
"Portugal",728,2,7,2,0,2,2
"Croatia",728,2,7,3,0,3,1
"Mexico",728,5,9,7,3,4,1
"Brazil",728,5,4,1,1,0,2
"Colombia",729,6,6,4,2,2,2
"United States",729,6,6,5,2,3,1
"France",729,7,6,5,4,1,2
"Tunisia",729,7,6,5,3,2,1
"Argentina",730,4,9,5,1,4,1
"Switzerland",730,4,3,5,5,0,2
"Portugal",730,5,7,6,0,6,1
"Croatia",730,5,7,2,0,2,2
"Germany",730,7,5,3,2,1,2
"Chile",730,7,5,4,2,2,1
"France",731,5,7,4,2,2,2
"Germany",731,5,7,3,0,3,1
"Japan",732,2,9,9,3,6,1
"Italy",732,2,4,4,2,2,2
"Belgium",732,7,9,10,1,9,1
"Australia",732,7,3,4,4,0,2
"Netherlands",733,1,9,6,1,5,1
"Wales",733,1,4,4,4,0,2
"Mexico",733,2,5,4,3,1,2
"Japan",733,2,5,5,3,2,1
"Senegal",733,4,6,6,4,2,1
"Uruguay",733,4,4,4,3,1,2
"Portugal",733,7,6,4,1,3,1
"Germany",733,7,4,3,2,1,2
"Uruguay",734,1,9,9,4,5,1
"Qatar",734,1,4,4,3,1,2
"England",734,3,7,6,3,3,1
"Mexico",734,3,4,4,3,1,2
"Brazil",734,4,5,3,1,2,1
"Denmark",734,4,5,4,3,1,2
"France",736,4,9,5,1,4,1
"Italy",736,4,4,4,3,1,2
"Belgium",736,7,6,6,5,1,2
"Netherlands",736,7,6,5,3,2,1
"Portugal",737,4,6,5,2,3,1
"Colombia",737,4,6,4,2,2,2
"Brazil",737,5,7,4,1,3,1
"Croatia",737,5,7,3,1,2,2
"Italy",737,8,6,4,1,3,1
"Australia",737,8,6,4,3,1,2
"United States",738,1,6,4,3,1,1
"Colombia",738,1,4,6,4,2,2
"Brazil",738,5,6,9,4,5,1
"Croatia",738,5,6,6,2,4,2
"Denmark",739,1,7,10,6,4,1
"Chile",739,1,4,6,5,1,2
"Spain",739,3,7,5,3,2,2
"Iran",739,3,7,4,1,3,1
"Spain",740,2,7,6,2,4,1
"Croatia",740,2,4,5,4,1,2
"England",740,3,6,4,2,2,1
"Colombia",740,3,6,3,2,1,2
"Belgium",740,4,7,6,1,5,1
"Italy",740,4,7,5,2,3,2
"Belgium",741,4,9,8,1,7,1
"Germany",741,4,4,3,3,0,2
"Brazil",741,7,6,8,1,7,1
"Japan",741,7,6,5,3,2,2
"Spain",742,3,7,6,2,4,1
"Poland",742,3,4,2,2,0,2
"Belgium",742,4,7,4,2,2,1
"Iran",742,4,4,3,2,1,2
"Denmark",742,7,5,7,2,5,1
"Switzerland",742,7,5,6,2,4,2
"Netherlands",742,8,5,4,2,2,1
"France",742,8,4,4,2,2,2
"Wales",743,1,7,5,2,3,1
"Nigeria",743,1,4,5,5,0,2
"England",743,3,7,7,3,4,1
"Germany",743,3,4,1,1,0,2
"Spain",743,6,7,6,2,4,1
"Uruguay",743,6,7,7,4,3,2
"Qatar",744,1,7,5,1,4,2
"Netherlands",744,1,7,6,0,6,1
"Spain",744,2,7,7,2,5,1
"Denmark",744,2,7,5,2,3,2
"England",744,5,6,2,1,1,2
"Korea Republic",744,5,6,6,3,3,1
"Denmark",745,4,5,4,3,1,1
"Brazil",745,4,4,3,2,1,2
"Wales",745,5,5,4,3,1,1
"Colombia",745,5,4,3,2,1,2
"Tunisia",745,6,6,2,1,1,1
"Belgium",745,6,4,4,3,1,2
"Netherlands",746,3,6,4,5,-1,1
"England",746,3,4,3,1,2,2
"Portugal",746,5,6,7,4,3,1
"Poland",746,5,6,4,4,0,2
"France",746,6,6,6,4,2,1
"Uruguay",746,6,6,5,4,1,2
"Spain",746,7,7,3,1,2,2
"Denmark",746,7,7,4,1,3,1
"Argentina",746,8,7,5,1,4,1
"Iran",746,8,7,2,0,2,2
"Denmark",747,4,6,6,1,5,1
"Chile",747,4,6,2,6,-4,2
"Belgium",747,7,7,5,1,4,1
"Mexico",747,7,7,4,2,2,2
"Argentina",747,8,6,8,4,4,1
"Costa Rica",747,8,6,5,4,1,2
"Spain",748,3,7,7,4,3,2
"Colombia",748,3,7,6,2,4,1
"Argentina",748,7,5,3,2,1,2
"Italy",748,7,5,7,3,4,1
"France",749,2,6,4,2,2,1
"Mexico",749,2,6,4,3,1,2
"Belgium",749,6,7,4,0,4,2
"Netherlands",749,6,7,8,2,6,1
"Senegal",749,7,6,5,5,0,1
"Denmark",749,7,4,6,6,0,2
"Portugal",750,3,9,9,4,5,1
"Switzerland",750,3,4,4,4,0,2
"Italy",750,6,5,2,0,2,2
"Wales",750,6,5,6,1,5,1
"Portugal",751,7,5,1,0,1,1
"Switzerland",751,7,4,5,3,2,2
"Brazil",751,8,7,7,2,5,1
"Italy",751,8,7,4,0,4,2
"Korea Republic",752,7,5,4,2,2,1
"Chile",752,7,4,2,2,0,2
"Netherlands",752,8,6,7,4,3,1
"Switzerland",752,8,6,6,4,2,2
"Qatar",753,1,5,4,3,1,2
"Uruguay",753,1,5,7,3,4,1
"France",753,2,6,5,3,2,1
"Croatia",753,2,4,4,3,1,2
"Brazil",753,3,6,6,4,2,1
"United States",753,3,4,4,4,0,2
"Argentina",753,4,9,4,0,4,1
"Denmark",753,4,3,3,3,0,2
"Belgium",753,5,7,5,1,4,1
"Colombia",753,5,4,3,2,1,2
"England",753,6,6,6,2,4,1
"Germany",753,6,6,5,3,2,2
"Qatar",754,1,6,3,2,1,2
"Chile",754,1,6,6,4,2,1
"Spain",754,3,7,5,3,2,2
"Netherlands",754,3,7,4,0,4,1
"France",754,4,9,9,3,6,1
"Costa Rica",754,4,2,2,3,-1,2
"Argentina",755,6,9,7,0,7,1
"Wales",755,6,4,6,5,1,2
"Korea Republic",756,2,7,8,0,8,1
"Denmark",756,2,4,5,7,-2,2
"Netherlands",756,3,5,3,1,2,1
"France",756,3,4,3,2,1,2
"Belgium",756,5,5,2,1,1,2
"Uruguay",756,5,5,7,3,4,1
"Iran",757,4,5,3,2,1,1
"Spain",757,4,4,4,3,1,2
"Portugal",758,8,7,8,3,5,1
"Wales",758,8,4,3,2,1,2
"Argentina",760,2,6,4,5,-1,2
"Nigeria",760,2,6,4,2,2,1
"France",761,7,7,3,1,2,2
"Iran",761,7,7,3,0,3,1
"Argentina",761,8,7,2,0,2,2
"Denmark",761,8,7,3,0,3,1
"Mexico",762,1,5,2,1,1,1
"Wales",762,1,4,4,2,2,2
"France",762,4,7,6,2,4,1
"Iran",762,4,7,3,0,3,2
"Portugal",762,8,7,6,2,4,1
"Colombia",762,8,4,5,5,0,2
"Uruguay",763,1,9,5,2,3,1
"Wales",763,1,4,4,3,1,2
"Mexico",763,3,6,5,4,1,1
"Chile",763,3,6,5,5,0,2
"Denmark",765,3,6,9,5,4,1
"Korea Republic",765,3,6,4,4,0,2
"France",765,4,7,4,1,3,1
"Uruguay",765,4,4,3,2,1,2
"England",765,7,6,5,3,2,1
"Wales",765,7,6,4,3,1,2
"France",766,6,7,5,3,2,1
"Italy",766,6,4,8,5,3,2
"Spain",767,4,9,6,1,5,1
"Iran",767,4,4,3,3,0,2
"Brazil",767,6,6,5,2,3,1
"Netherlands",767,6,4,2,1,1,2
"Belgium",767,8,7,7,2,5,1
"Italy",767,8,4,6,5,1,2
"Uruguay",768,7,7,3,1,2,1
"Wales",768,7,4,3,2,1,2
"Chile",769,2,5,3,2,1,1
"Netherlands",769,2,4,5,4,1,2
"Belgium",769,3,5,4,1,3,1
"Croatia",769,3,4,2,2,0,2
"Jamaica",769,7,6,3,7,-4,1
"Denmark",769,7,4,7,1,6,2
"Netherlands",770,1,7,2,0,2,1
"Chile",770,1,4,2,1,1,2
"Australia",771,5,9,4,1,3,1
"Spain",771,5,3,3,3,0,2
"Mexico",771,6,6,7,5,2,1
"Senegal",771,6,4,4,4,0,2
"Brazil",771,7,9,9,4,5,1
"Denmark",771,7,3,4,3,1,2
"Colombia",771,8,7,7,3,4,1
"Japan",771,8,7,3,1,2,2
"Australia",772,3,9,6,2,4,1
"Portugal",772,3,4,4,3,1,2
"Argentina",772,7,7,6,1,5,1
"Germany",772,7,7,5,1,4,2
"Australia",773,5,9,9,4,5,1
"Mexico",773,5,4,4,3,1,2
"Uruguay",773,7,6,7,3,4,1
"Morocco",773,7,6,3,2,1,2
"Spain",774,2,6,6,4,2,1
"Nigeria",774,2,6,5,4,1,2
"Chile",774,3,6,6,3,3,1
"England",774,3,4,3,2,1,2
"Belgium",776,2,9,5,0,5,1
"Mexico",776,2,3,2,3,-1,2
"Argentina",776,3,7,3,0,3,1
"Wales",776,3,4,2,1,1,2
"Brazil",776,5,9,8,0,8,1
"Netherlands",776,5,3,2,3,-1,2
"Uruguay",776,8,6,5,3,2,2
"Switzerland",776,8,6,7,4,3,1
"Argentina",777,5,7,6,2,4,1
"Denmark",777,5,7,4,1,3,2
"Mexico",778,3,7,5,2,3,1
"England",778,3,4,2,1,1,2
"France",778,6,9,8,0,8,1
"Japan",778,6,4,1,2,-1,2
"Portugal",778,7,9,11,2,9,1
"Uruguay",778,7,4,4,4,0,2
"Iran",779,7,5,5,4,1,1
"Argentina",779,7,4,6,4,2,2
"Portugal",779,8,9,6,1,5,1
"Colombia",779,8,4,3,2,1,2
"France",780,5,5,9,4,5,1
"Denmark",780,5,4,4,3,1,2
"Uruguay",781,1,7,6,2,4,2
"United States",781,1,7,8,2,6,1
"France",781,3,7,4,1,3,1
"Poland",781,3,4,2,2,0,2
"England",781,6,6,6,2,4,1
"Croatia",781,6,6,4,1,3,2
"Netherlands",782,2,5,5,4,1,1
"France",782,2,4,4,4,0,2
"Italy",782,3,6,4,3,1,1
"Korea Republic",782,3,4,5,4,1,2
"Portugal",782,4,7,6,0,6,1
"Australia",782,4,4,3,3,0,2
"Switzerland",782,5,7,4,2,2,1
"Mexico",782,5,4,2,1,1,2
"England",782,6,7,6,1,5,1
"Japan",782,6,7,5,3,2,2
"England",783,4,6,8,6,2,2
"Netherlands",783,4,6,9,3,6,1
"Denmark",783,8,6,5,5,0,1
"Chile",783,8,4,5,3,2,2
"Denmark",784,1,7,7,3,4,1
"Chile",784,1,7,5,3,2,2
"England",785,5,5,4,2,2,1
"Switzerland",785,5,5,4,3,1,2
"Poland",786,3,7,3,1,2,2
"Korea Republic",786,3,7,5,1,4,1
"Brazil",786,4,9,11,0,11,1
"Senegal",786,4,4,4,4,0,2
"Spain",787,2,9,12,4,8,1
"Nigeria",787,2,4,4,4,0,2
"France",787,3,7,9,3,6,1
"Germany",787,3,4,4,4,0,2
"Denmark",787,5,9,8,4,4,1
"Brazil",787,5,4,3,2,1,2
"Argentina",787,7,6,5,3,2,2
"Croatia",787,7,6,6,2,4,1
"Netherlands",788,4,6,6,3,3,1
"Costa Rica",788,4,6,5,3,2,2
"Belgium",788,6,6,2,2,0,2
"Japan",788,6,6,3,1,2,1
"Brazil",788,7,5,2,0,2,1
"Mexico",788,7,4,2,2,0,2
"Qatar",789,1,6,6,5,1,1
"Senegal",789,1,4,5,4,1,2
"Poland",790,1,6,4,2,2,2
"Algeria",790,1,6,6,2,4,1
"France",790,5,7,7,5,2,2
"Netherlands",790,5,7,5,0,5,1
"Switzerland",791,1,5,3,2,1,1
"Uruguay",791,1,4,3,3,0,2
"Netherlands",791,3,6,9,4,5,1
"France",791,3,4,5,4,1,2
"England",791,8,9,8,3,5,1
"Croatia",791,8,3,5,5,0,2
"Netherlands",792,1,6,6,2,4,1
"Algeria",792,1,4,3,1,2,2
"Iran",792,7,5,2,1,1,1
"Denmark",792,7,4,4,3,1,2
"Argentina",793,6,9,6,1,5,1
"Tunisia",793,6,3,2,3,-1,2
"Spain",793,7,5,8,3,5,1
"Switzerland",793,7,4,8,4,4,2
"Belgium",793,8,6,4,3,1,1
"Senegal",793,8,6,4,4,0,2
"England",794,4,6,7,4,3,1
"Netherlands",794,4,6,5,5,0,2
"France",794,7,5,6,4,2,1
"Tunisia",794,7,5,4,3,1,2
"Chile",796,1,9,8,2,6,1
"Germany",796,1,3,6,5,1,2
"Croatia",796,2,7,4,2,2,1
"Japan",796,2,4,6,4,2,2
"Denmark",796,3,7,5,1,4,1
"Australia",796,3,7,6,3,3,2
"Italy",796,7,9,9,2,7,1
"Belgium",796,7,4,7,3,4,2
"Qatar",797,1,6,3,2,1,1
"Wales",797,1,6,4,4,0,2
"Belgium",797,4,5,4,2,2,1
"Poland",797,4,5,3,2,1,2
"Japan",797,8,5,2,1,1,1
"England",797,8,4,4,3,1,2
"Qatar",798,1,5,2,1,1,1
"Costa Rica",798,1,4,4,2,2,2
"Germany",798,2,6,5,2,3,1
"Wales",798,2,4,5,4,1,2
"Uruguay",798,4,6,6,2,4,1
"England",798,4,4,4,4,0,2
"Argentina",798,6,5,6,5,1,1
"Mexico",798,6,4,5,4,1,2
"Belgium",798,8,7,6,1,5,2
"Colombia",798,8,7,9,2,7,1
"Argentina",800,3,5,4,2,2,1
"Denmark",800,3,4,5,5,0,2
"England",800,5,7,3,0,3,2
"Colombia",800,5,7,4,0,4,1
"Brazil",800,7,5,6,1,5,1
"Netherlands",800,7,4,6,4,2,2
"Uruguay",801,4,7,7,2,5,1
"Senegal",801,4,4,2,3,-1,2
"Argentina",801,5,9,5,1,4,1
"Australia",801,5,3,3,3,0,2
"Portugal",801,7,6,6,2,4,2
"Croatia",801,7,6,6,1,5,1
"France",802,8,6,6,2,4,1
"Wales",802,8,6,4,4,0,2
"Morocco",803,1,6,6,3,3,1
"Germany",803,1,4,4,2,2,2
"Australia",803,5,5,2,1,1,1
"Wales",803,5,4,5,4,1,2
"England",804,2,6,5,4,1,1
"Colombia",804,2,4,5,3,2,2
"Belgium",804,5,9,6,1,5,1
"Chile",804,5,3,5,3,2,2
"Netherlands",804,8,6,5,4,1,1
"Portugal",804,8,4,7,5,2,2
"Poland",805,6,7,5,1,4,1
"Iran",805,6,4,3,3,0,2
"Brazil",806,5,5,4,1,3,1
"Croatia",806,5,5,1,0,1,2
"Denmark",806,6,6,4,3,1,2
"Costa Rica",806,6,6,5,2,3,1
"Australia",806,7,6,6,4,2,1
"Argentina",806,7,4,7,5,2,2
"France",806,8,7,4,1,3,1
"Chile",806,8,4,4,3,1,2
"Denmark",807,3,6,3,1,2,1
"Iran",807,3,6,4,3,1,2
"England",807,4,6,6,5,1,2
"Mexico",807,4,6,6,4,2,1
"Colombia",807,6,6,2,5,-3,1
"Spain",807,6,4,7,4,3,2
"Qatar",808,1,7,5,2,3,1
"Netherlands",808,1,4,4,4,0,2
"United States",809,6,6,6,3,3,1
"Portugal",809,6,4,3,4,-1,2
"Belgium",810,4,7,9,1,8,1
"Netherlands",810,4,7,8,1,7,2
"France",810,5,6,7,4,3,1
"Uruguay",810,5,6,5,4,1,2
"Spain",810,8,5,2,1,1,2
"Germany",810,8,5,3,1,2,1
"Germany",811,1,6,8,5,3,1
"Chile",811,1,4,4,2,2,2
"Belgium",811,2,5,4,1,3,1
"Italy",811,2,5,2,1,1,2
"Spain",811,3,6,4,2,2,2
"Uruguay",811,3,6,5,2,3,1
"Argentina",811,4,9,7,2,5,1
"Denmark",811,4,4,4,3,1,2
"Morocco",812,1,6,6,4,2,1
"Qatar",812,1,4,5,5,0,2
"Iran",812,6,6,4,4,0,1
"Mexico",812,6,4,9,6,3,2
"Brazil",813,4,9,7,0,7,1
"Netherlands",813,4,3,4,5,-1,2
"Belgium",813,6,6,4,2,2,2
"Chile",813,6,6,6,2,4,1
"Qatar",814,1,6,3,1,2,2
"Croatia",814,1,6,5,1,4,1
"Denmark",814,5,6,4,2,2,2
"Korea Republic",814,5,6,6,3,3,1
"Spain",814,6,5,2,0,2,1
"Chile",814,6,5,1,0,1,2
"Argentina",814,8,6,4,1,3,1
"Algeria",814,8,6,3,3,0,2
"Qatar",815,1,5,2,1,1,2
"Uruguay",815,1,5,3,1,2,1
"Brazil",815,4,7,4,0,4,1
"Morocco",815,4,4,2,2,0,2
"France",815,6,9,7,1,6,1
"Japan",815,6,4,3,3,0,2
"Mexico",816,8,6,2,2,0,1
"England",816,8,4,4,1,3,2
"Qatar",818,1,6,7,7,0,2
"Croatia",818,1,6,4,2,2,1
"Iran",818,8,5,2,1,1,1
"England",818,8,4,4,1,3,2
"Qatar",819,1,5,6,4,2,1
"Morocco",819,1,5,5,4,1,2
"France",819,3,9,8,3,5,1
"Iran",819,3,4,3,3,0,2
"Uruguay",819,5,9,4,0,4,1
"Portugal",819,5,4,3,2,1,2
"Brazil",819,6,9,7,3,4,1
"Germany",819,6,3,4,3,1,2
"France",820,4,6,3,1,2,1
"Denmark",820,4,6,3,2,1,2
"Netherlands",820,5,9,7,2,5,1
"Portugal",820,5,3,4,4,0,2
"Iran",821,3,6,2,1,1,1
"Mexico",821,3,4,2,2,0,2
"Argentina",821,4,6,3,2,1,2
"United States",821,4,6,6,2,4,1
"Portugal",822,5,7,5,1,4,1
"Netherlands",822,5,7,4,1,3,2
"Italy",822,6,6,10,4,6,1
"England",822,6,4,7,6,1,2
"Italy",823,1,7,7,2,5,1
"Switzerland",823,1,7,4,2,2,2
"Denmark",824,4,6,5,4,1,1
"Chile",824,4,6,6,7,-1,2
"Belgium",824,5,7,6,2,4,1
"Morocco",824,5,4,5,4,1,2
"Brazil",824,6,5,1,0,1,1
"Mexico",824,6,4,3,3,0,2
"Spain",824,8,6,5,4,1,2
"Netherlands",824,8,6,3,1,2,1
"Spain",825,6,7,6,3,3,1
"Mexico",825,6,7,5,3,2,2
"Brazil",826,4,6,3,2,1,1
"Costa Rica",826,4,4,3,2,1,2
"Argentina",827,5,5,3,2,1,2
"Australia",827,5,5,5,3,2,1
"Netherlands",828,1,7,6,2,4,1
"Algeria",828,1,4,3,3,0,2
"Mexico",828,2,6,7,2,5,1
"Australia",828,2,6,4,7,-3,2
"Germany",828,4,5,4,2,2,1
"Belgium",828,4,4,8,3,5,2
"Croatia",828,5,6,4,4,0,1
"Japan",828,5,4,2,2,0,2
"Argentina",828,6,5,5,3,2,1
"Morocco",828,6,5,3,2,1,2
"Brazil",830,4,5,4,1,3,1
"Iran",830,4,5,5,3,2,2
"England",830,8,7,4,0,4,1
"Algeria",830,8,4,1,1,0,2
"France",831,2,6,7,3,4,1
"Mexico",831,2,4,2,1,1,2
"Belgium",831,3,9,10,1,9,1
"Uruguay",831,3,4,3,3,0,2
"Argentina",831,4,6,4,3,1,2
"Netherlands",831,4,6,4,2,2,1
"England",831,7,7,10,2,8,1
"Colombia",831,7,4,4,4,0,2
"Spain",832,3,5,2,1,1,1
"Iran",832,3,4,3,2,1,2
"France",832,4,5,3,2,1,2
"Senegal",832,4,5,4,2,2,1
"Uruguay",833,3,9,4,0,4,1
"England",833,3,4,6,4,2,2
"Brazil",833,4,6,3,2,1,2
"Germany",833,4,6,6,2,4,1
"Portugal",833,7,6,7,3,4,1
"Netherlands",833,7,6,7,4,3,2
"Brazil",834,3,6,6,2,4,1
"Poland",834,3,6,6,6,0,2
"Colombia",835,4,5,3,2,1,1
"Portugal",835,4,4,5,3,2,2
"France",835,5,6,4,3,1,2
"Algeria",835,5,6,6,2,4,1
"France",836,5,5,4,2,2,1
"Denmark",836,5,4,5,4,1,2
"Argentina",836,7,6,9,1,8,1
"United States",836,7,4,3,6,-3,2
"France",837,3,4,1,1,0,2
"Colombia",837,3,4,3,2,1,1
"England",837,6,6,2,1,1,1
"Denmark",837,6,4,4,4,0,2
"Brazil",837,7,5,6,2,4,1
"Wales",837,7,5,3,1,2,2
"Belgium",838,5,7,8,0,8,1
"Uruguay",838,5,4,2,2,0,2
"Netherlands",839,1,6,3,2,1,1
"Chile",839,1,4,5,3,2,2
"Spain",839,4,6,2,2,0,2
"Korea Republic",839,4,6,4,2,2,1
"Belgium",839,8,7,6,1,5,1
"Senegal",839,8,4,4,4,0,2
"Germany",840,1,6,4,1,3,1
"Qatar",840,1,4,5,5,0,2
"Spain",840,2,6,5,3,2,1
"Italy",840,2,4,4,2,2,2
"Colombia",840,6,6,5,4,1,2
"Iran",840,6,6,6,3,3,1
"Uruguay",840,7,9,6,1,5,1
"France",840,7,4,3,3,0,2
"England",840,8,5,2,1,1,2
"Croatia",840,8,5,2,0,2,1
"Uruguay",841,7,6,3,3,0,2
"Korea Republic",841,7,6,5,2,3,1
"Netherlands",842,1,9,8,3,5,1
"Qatar",842,1,3,5,3,2,2
"Brazil",842,5,7,7,0,7,1
"Denmark",842,5,7,4,0,4,2
"Korea Republic",843,4,6,5,4,1,1
"Portugal",843,4,4,6,5,1,2
"Germany",844,3,9,7,1,6,1
"United States",844,3,4,4,5,-1,2
"Brazil",844,4,7,10,1,9,1
"Japan",844,4,4,4,4,0,2
"Argentina",844,5,7,10,0,10,1
"Mexico",844,5,7,5,2,3,2
"England",844,6,6,4,1,3,1
"Italy",844,6,6,3,1,2,2
"Argentina",846,4,6,4,3,1,2
"Netherlands",846,4,6,8,1,7,1
"Portugal",846,5,6,2,2,0,2
"Poland",846,5,6,4,2,2,1
"Croatia",846,6,6,4,3,1,1
"Iran",846,6,4,6,5,1,2
"Brazil",847,5,9,15,2,13,1
"Netherlands",847,5,4,4,4,0,2
"Uruguay",847,6,6,5,3,2,2
"Japan",847,6,6,7,3,4,1
"Belgium",847,8,7,5,3,2,2
"Denmark",847,8,7,8,5,3,1
"Uruguay",848,1,7,5,1,4,1
"Switzerland",848,1,4,4,3,1,2
"Croatia",848,4,7,7,3,4,2
"Korea Republic",848,4,7,10,3,7,1
"Brazil",848,6,6,7,3,4,1
"Australia",848,6,6,7,5,2,2
"Portugal",848,8,7,3,1,2,2
"Denmark",848,8,7,4,1,3,1
"Denmark",849,3,6,3,1,2,2
"Wales",849,3,6,7,2,5,1
"Portugal",849,6,5,4,2,2,2
"Colombia",849,6,5,6,1,5,1
"Switzerland",849,8,9,7,3,4,1
"England",849,8,4,3,2,1,2
"Colombia",850,1,7,5,2,3,2
"Tunisia",850,1,7,5,1,4,1
"Brazil",851,2,6,8,2,6,1
"Germany",851,2,6,5,2,3,2
"England",851,3,9,11,2,9,1
"Colombia",851,3,4,6,4,2,2
"Argentina",851,7,7,6,3,3,1
"Croatia",851,7,4,6,4,2,2
"France",852,7,7,4,0,4,1
"Germany",852,7,7,5,2,3,2
"Mexico",853,2,5,2,1,1,2
"Iran",853,2,5,3,1,2,1
"France",853,4,6,7,4,3,2
"Uruguay",853,4,6,7,3,4,1
"Germany",853,5,9,5,1,4,1
"Argentina",853,5,4,8,4,4,2
"England",853,8,5,5,2,3,1
"Colombia",853,8,5,4,3,1,2
"Colombia",854,1,6,5,2,3,1
"United States",854,1,6,4,3,1,2
"Brazil",854,2,6,7,1,6,1
"Denmark",854,2,4,2,2,0,2
"France",854,3,6,5,3,2,1
"Japan",854,3,6,7,7,0,2
"Netherlands",854,6,6,6,2,4,1
"Senegal",854,6,6,4,3,1,2
"Spain",854,8,7,3,1,2,1
"Australia",854,8,4,6,2,4,2
"Brazil",855,5,7,5,1,4,1
"Croatia",855,5,4,1,1,0,2
"Uruguay",856,1,6,6,5,1,1
"Poland",856,1,6,6,6,0,2
"Portugal",856,5,5,6,3,3,1
"Croatia",856,5,4,3,3,0,2
"Mexico",857,1,7,4,1,3,2
"Chile",857,1,7,5,1,4,1
"France",857,2,7,5,1,4,1
"Germany",857,2,7,4,1,3,2
"Argentina",857,4,6,3,2,1,2
"Netherlands",857,4,6,5,2,3,1
"Brazil",857,5,7,11,1,10,1
"Italy",857,5,7,5,2,3,2
"Spain",858,4,6,6,2,4,1
"Mexico",858,4,6,3,3,0,2
"Portugal",858,5,7,5,2,3,1
"Colombia",858,5,7,6,4,2,2
"Spain",859,7,9,3,0,3,1
"Uruguay",859,7,3,2,2,0,2
"Germany",860,4,7,9,3,6,1
"Spain",860,4,4,5,5,0,2
"England",860,5,9,6,1,5,1
"Uruguay",860,5,4,2,1,1,2
"Netherlands",861,1,6,5,2,3,1
"Costa Rica",861,1,6,5,3,2,2
"Brazil",861,2,7,6,0,6,1
"Germany",861,2,7,3,0,3,2
"Italy",861,7,7,5,2,3,1
"Poland",861,7,4,7,5,2,2
"Spain",861,8,6,3,2,1,2
"Switzerland",861,8,6,4,2,2,1
"Brazil",862,2,6,10,3,7,1
"Croatia",862,2,6,3,1,2,2
"Belgium",862,3,5,3,2,1,1
"Netherlands",862,3,4,4,3,1,2
"Portugal",862,4,5,4,2,2,1
"Australia",862,4,4,3,1,2,2
"Spain",862,5,6,6,1,5,1
"Morocco",862,5,6,5,6,-1,2
"Mexico",862,6,6,5,4,1,1
"Iran",862,6,6,3,3,0,2
"France",862,8,6,8,1,7,1
"Colombia",862,8,6,3,4,-1,2
"Portugal",863,2,5,3,1,2,1
"Mexico",863,2,4,2,2,0,2
"Spain",863,4,6,4,2,2,1
"Uruguay",863,4,4,2,1,1,2
"Italy",863,8,9,7,1,6,1
"Brazil",863,8,3,1,2,-1,2
"Brazil",864,3,7,5,1,4,1
"Italy",864,3,7,2,0,2,2
"Algeria",864,5,5,3,2,1,1
"France",864,5,4,4,3,1,2
"Iran",864,7,9,7,2,5,1
"Portugal",864,7,2,3,4,-1,2
"Brazil",865,3,9,6,1,5,1
"Morocco",865,3,3,5,6,-1,2
"Portugal",865,7,7,4,0,4,1
"Denmark",865,7,7,4,1,3,2
"Denmark",866,6,5,4,1,3,1
"Wales",866,6,5,6,4,2,2
"Qatar",867,1,6,3,2,1,1
"Netherlands",867,1,4,7,6,1,2
"Italy",867,5,5,4,2,2,1
"Brazil",867,5,4,5,4,1,2
"Qatar",868,1,6,7,4,3,1
"Algeria",868,1,4,5,5,0,2
"Brazil",868,2,6,5,2,3,1
"Wales",868,2,4,1,2,-1,2
"Argentina",868,4,7,7,1,6,1
"Germany",868,4,7,3,1,2,2
"Jamaica",868,7,6,2,2,0,1
"Croatia",868,7,4,4,3,1,2
"Italy",868,8,6,6,2,4,1
"England",868,8,4,1,2,-1,2
"Portugal",869,3,6,6,1,5,1
"Chile",869,3,6,6,3,3,2
"Costa Rica",870,7,5,4,2,2,1
"Chile",870,7,4,3,3,0,2
"France",871,4,7,2,0,2,2
"Chile",871,4,7,4,0,4,1
"Australia",871,6,6,3,2,1,1
"Spain",871,6,4,3,2,1,2
"Brazil",872,4,6,4,1,3,1
"Australia",872,4,6,5,5,0,2
"Spain",872,5,6,7,5,2,1
"Switzerland",872,5,4,5,3,2,2
"Uruguay",874,2,9,5,1,4,1
"Australia",874,2,4,4,3,1,2
"Brazil",874,3,7,5,1,4,1
"Germany",874,3,4,5,4,1,2
"England",874,6,6,7,2,5,1
"Colombia",874,6,6,6,2,4,2
"Netherlands",874,7,6,4,4,0,2
"Tunisia",874,7,6,7,3,4,1
"Germany",875,2,6,4,1,3,1
"Algeria",875,2,4,3,4,-1,2
"Portugal",875,3,7,7,2,5,1
"Netherlands",875,3,7,4,2,2,2
"Argentina",875,5,6,4,2,2,2
"Poland",875,5,6,7,2,5,1
"Belgium",875,7,7,5,2,3,2
"Uruguay",875,7,7,6,2,4,1
"Denmark",875,8,6,3,4,-1,2
"Iran",875,8,6,5,4,1,1
"Portugal",876,2,9,7,1,6,1
"Uruguay",876,2,3,4,4,0,2
"Belgium",876,3,7,6,0,6,1
"Netherlands",876,3,7,4,2,2,2
"Germany",876,5,7,8,4,4,1
"Chile",876,5,4,4,4,0,2
"Argentina",876,7,6,7,3,4,1
"Switzerland",876,7,6,6,6,0,2
"Argentina",877,2,7,7,2,5,1
"Germany",877,2,7,6,2,4,2
"Italy",877,3,5,6,4,2,2
"Iran",877,3,5,6,3,3,1
"Spain",877,6,9,11,2,9,1
"Uruguay",877,6,3,6,6,0,2
"Netherlands",877,8,6,3,3,0,1
"Belgium",877,8,4,4,4,0,2
"Spain",878,3,6,4,4,0,2
"Netherlands",878,3,6,4,1,3,1
"France",878,8,6,8,2,6,1
"Chile",878,8,6,5,6,-1,2
"Netherlands",879,4,5,5,1,4,1
"Chile",879,4,4,3,2,1,2
"Belgium",879,6,6,3,2,1,1
"Colombia",879,6,4,3,2,1,2
"Brazil",880,2,9,6,2,4,1
"Nigeria",880,2,4,7,5,2,2
"England",880,6,6,4,4,0,2
"Uruguay",880,6,6,3,1,2,1
"Spain",881,3,6,4,2,2,1
"Korea Republic",881,3,6,2,3,-1,2
"Switzerland",881,6,5,6,4,2,1
"Mexico",881,6,4,5,5,0,2
"Portugal",881,8,7,8,4,4,1
"Italy",881,8,4,4,3,1,2
"Tunisia",882,5,6,3,1,2,1
"Korea Republic",882,5,6,3,3,0,2
"Portugal",882,6,5,9,6,3,1
"Mexico",882,6,5,6,5,1,2
"Belgium",882,8,6,7,3,4,1
"Uruguay",882,8,6,4,4,0,2
"France",883,6,6,6,3,3,2
"Iran",883,6,6,7,2,5,1
"Mexico",884,1,7,6,3,3,1
"Morocco",884,1,7,6,4,2,2
"Colombia",884,6,6,5,3,2,1
"Japan",884,6,6,4,3,1,2
"Spain",884,8,7,2,0,2,1
"Denmark",884,8,4,4,3,1,2
"England",885,5,4,7,5,2,1
"Iran",885,5,4,5,5,0,2
"Belgium",885,7,7,6,2,4,1
"Netherlands",885,7,4,4,4,0,2
"Spain",885,8,9,7,2,5,1
"Colombia",885,8,2,4,5,-1,2
"England",886,4,9,10,2,8,1
"Australia",886,4,4,5,5,0,2
"Japan",886,7,5,5,3,2,1
"Mexico",886,7,4,6,3,3,2
"Argentina",886,8,6,7,2,5,1
"Germany",886,8,6,4,2,2,2
"Belgium",887,3,6,3,2,1,1
"Germany",887,3,4,3,2,1,2
"France",887,4,7,5,1,4,1
"Italy",887,4,7,5,3,2,2
"England",887,7,9,5,0,5,1
"Japan",887,7,4,3,2,1,2
"Mexico",887,8,7,5,0,5,1
"Switzerland",887,8,4,2,3,-1,2
"Portugal",888,7,7,3,1,2,1
"Italy",888,7,4,3,2,1,2
"Croatia",888,8,6,5,3,2,1
"Costa Rica",888,8,6,3,2,1,2
"Qatar",889,1,5,1,0,1,2
"Germany",889,1,5,3,1,2,1
"Australia",889,5,6,2,2,0,1
"Croatia",889,5,4,3,2,1,2
"Portugal",889,8,6,6,3,3,1
"Morocco",889,8,6,3,4,-1,2
"Croatia",890,1,7,4,1,3,2
"Wales",890,1,7,8,1,7,1
"Tunisia",890,5,6,3,1,2,1
"Denmark",890,5,4,1,1,0,2
"England",890,6,7,5,1,4,1
"Nigeria",890,6,7,6,3,3,2
"Chile",891,3,6,4,4,0,1
"Spain",891,3,4,5,3,2,2
"England",891,4,7,8,3,5,1
"Italy",891,4,4,5,3,2,2
"Portugal",892,6,7,7,1,6,1
"Colombia",892,6,7,4,1,3,2
"Belgium",892,7,7,6,0,6,1
"Algeria",892,7,4,2,2,0,2
"Spain",893,7,6,6,4,2,1
"Poland",893,7,6,3,2,1,2
"Belgium",894,3,5,8,5,3,1
"Croatia",894,3,4,6,5,1,2
"Switzerland",895,7,5,6,5,1,1
"Germany",895,7,4,6,4,2,2
"Morocco",896,1,9,4,0,4,1
"Mexico",896,1,3,3,3,0,2
"Portugal",896,8,6,6,4,2,2
"Uruguay",896,8,6,7,3,4,1
"Belgium",897,2,6,4,1,3,1
"Netherlands",897,2,6,5,4,1,2
"Portugal",898,2,9,6,2,4,1
"Denmark",898,2,4,6,5,1,2
"Brazil",898,3,7,5,3,2,2
"Italy",898,3,7,5,2,3,1
"England",898,4,6,3,2,1,1
"Iran",898,4,4,3,2,1,2
"Croatia",898,5,7,7,2,5,1
"France",898,5,4,3,2,1,2
"Mexico",898,8,6,4,3,1,1
"Switzerland",898,8,4,2,1,1,2
"Qatar",899,1,7,3,1,2,2
"Italy",899,1,7,6,2,4,1
"England",899,8,5,3,1,2,1
"Netherlands",899,8,4,5,1,4,2
"Wales",900,1,6,6,2,4,1
"Nigeria",900,1,4,2,2,0,2
"Italy",900,2,9,13,5,8,1
"England",900,2,4,9,8,1,2
"Netherlands",901,4,7,5,2,3,2
"Iran",901,4,7,8,4,4,1
"Italy",902,2,6,11,3,8,1
"Japan",902,2,6,6,4,2,2
"Brazil",902,4,5,3,1,2,1
"Denmark",902,4,4,2,1,1,2
"France",902,6,7,7,3,4,1
"Netherlands",902,6,7,7,4,3,2
"Wales",902,7,6,4,2,2,1
"Spain",902,7,4,6,3,3,2
"Qatar",903,1,5,4,1,3,1
"Uruguay",903,1,5,4,3,1,2
"Portugal",903,3,6,6,2,4,1
"Netherlands",903,3,6,5,3,2,2
"Brazil",903,4,6,5,2,3,1
"Mexico",903,4,4,2,2,0,2
"Wales",904,2,6,3,2,1,2
"Australia",904,2,6,3,1,2,1
"Portugal",904,3,6,7,1,6,1
"Mexico",904,3,6,3,2,1,2
"Spain",904,7,6,6,5,1,2
"Algeria",904,7,6,9,7,2,1
"Portugal",905,3,7,7,2,5,1
"Colombia",905,3,7,3,1,2,2
"Belgium",905,8,6,4,3,1,2
"Italy",905,8,6,4,2,2,1
"Uruguay",906,5,5,8,6,2,1
"Morocco",906,5,5,4,3,1,2
"Belgium",906,7,7,7,4,3,1
"Japan",906,7,4,6,5,1,2
"Netherlands",908,2,9,7,0,7,1
"Brazil",908,2,3,5,4,1,2
"Portugal",909,2,6,3,2,1,1
"Uruguay",909,2,4,1,1,0,2
"Denmark",909,8,6,5,2,3,1
"Switzerland",909,8,4,3,2,1,2
"Argentina",910,3,6,6,4,2,2
"Mexico",910,3,6,4,1,3,1
"Denmark",910,8,6,5,3,2,1
"France",910,8,4,3,3,0,2
"England",911,3,7,4,0,4,1
"Chile",911,3,7,5,3,2,2
"France",912,8,9,6,2,4,1
"Algeria",912,8,4,4,2,2,2
"France",913,3,7,6,1,5,1
"Chile",913,3,4,6,6,0,2
"Brazil",914,2,6,4,2,2,2
"Netherlands",914,2,6,6,3,3,1
"Mexico",914,4,5,4,3,1,1
"Korea Republic",914,4,4,7,4,3,2
"Spain",914,5,7,5,1,4,1
"Switzerland",914,5,7,4,1,3,2
"France",914,6,9,5,0,5,1
"Australia",914,6,3,1,2,-1,2
"France",915,6,7,4,0,4,1
"United States",915,6,4,2,2,0,2
"Colombia",916,1,5,6,2,4,1
"Switzerland",916,1,5,4,2,2,2
"France",916,4,7,7,1,6,1
"Japan",916,4,7,4,1,3,2
"Mexico",916,6,9,7,2,5,1
"Iran",916,6,4,4,3,1,2
"Germany",917,5,9,9,0,9,1
"Spain",917,5,4,2,2,0,2
"Switzerland",918,1,7,6,3,3,1
"Jamaica",918,1,4,6,4,2,2
"Brazil",918,3,9,8,2,6,1
"Korea Republic",918,3,4,5,4,1,2
"Uruguay",919,1,5,3,1,2,1
"Switzerland",919,1,4,3,2,1,2
"France",919,3,6,5,3,2,2
"Wales",919,3,6,5,2,3,1
"Belgium",919,7,9,10,1,9,1
"United States",919,7,4,5,5,0,2
"Qatar",920,1,6,3,5,-2,1
"Croatia",920,1,4,3,1,2,2
"Brazil",920,7,6,7,1,6,1
"Italy",920,7,6,4,1,3,2
"Chile",921,7,6,6,3,3,1
"Germany",921,7,4,5,5,0,2
"Italy",922,8,7,6,2,4,1
"Poland",922,8,7,4,2,2,2
"Switzerland",923,3,6,3,2,1,1
"Spain",923,3,4,5,4,1,2
"France",925,3,6,3,1,2,1
"Chile",925,3,4,2,2,0,2
"England",926,2,9,9,2,7,1
"Australia",926,2,3,4,3,1,2
"Argentina",926,5,6,6,4,2,1
"Switzerland",926,5,4,5,4,1,2
"United States",926,6,6,4,3,1,2
"Algeria",926,6,6,5,3,2,1
"Brazil",927,3,5,3,1,2,1
"Australia",927,3,4,2,2,0,2
"United States",928,6,6,2,3,-1,2
"Nigeria",928,6,6,3,1,2,1
"France",928,7,6,8,4,4,1
"Germany",928,7,6,5,4,1,2
"England",929,3,7,9,4,5,1
"Netherlands",929,3,7,4,2,2,2
"France",929,4,6,6,4,2,2
"Mexico",929,4,6,5,2,3,1
"Portugal",929,7,9,10,2,8,1
"Uruguay",929,7,4,3,4,-1,2
"Korea Republic",930,6,5,5,4,1,1
"France",930,6,4,8,4,4,2
"Spain",930,7,5,3,2,1,1
"Uruguay",930,7,4,5,4,1,2
"Germany",931,1,6,7,3,4,1
"Jamaica",931,1,4,1,1,0,2
"Spain",932,5,6,6,3,3,1
"Nigeria",932,5,6,3,2,1,2
"Argentina",933,3,5,5,3,2,1
"Korea Republic",933,3,4,4,3,1,2
"Portugal",933,5,6,8,2,6,1
"Wales",933,5,6,3,3,0,2
"Qatar",934,1,6,6,4,2,2
"Denmark",934,1,6,5,2,3,1
"Belgium",934,4,9,5,2,3,1
"Chile",934,4,3,5,5,0,2
"Spain",934,5,6,8,2,6,1
"Japan",934,5,6,7,6,1,2
"Portugal",934,8,5,5,3,2,1
"Uruguay",934,8,5,4,3,1,2
"Morocco",935,1,5,5,3,2,1
"Switzerland",935,1,4,4,3,1,2
"Belgium",935,3,7,5,1,4,1
"Korea Republic",935,3,7,4,1,3,2
"Argentina",937,2,5,5,3,2,2
"Germany",937,2,5,6,2,4,1
"England",937,7,6,4,3,1,2
"Denmark",937,7,6,6,2,4,1
"Denmark",938,4,6,4,3,1,1
"Spain",938,4,4,3,1,2,2
"Germany",938,6,6,6,2,4,1
"Portugal",938,6,4,2,2,0,2
"Brazil",938,7,4,4,3,1,1
"Tunisia",938,7,4,4,4,0,2
"Qatar",939,1,6,4,2,2,1
"Wales",939,1,6,4,3,1,2
"Poland",940,4,5,7,6,1,1
"Germany",940,4,4,6,5,1,2
"England",941,3,5,6,5,1,1
"Senegal",941,3,4,6,5,1,2
"Mexico",942,5,5,6,3,3,1
"Australia",942,5,5,3,2,1,2
"England",943,4,5,6,3,3,1
"Denmark",943,4,5,4,3,1,2
"Mexico",943,5,6,8,3,5,1
"Spain",943,5,4,2,2,0,2
"Germany",943,6,6,4,4,0,2
"Switzerland",943,6,6,4,3,1,1
"Netherlands",944,1,7,7,2,5,1
"Qatar",944,1,4,3,2,1,2
"Mexico",944,2,6,4,3,1,1
"Japan",944,2,4,4,3,1,2
"France",944,3,7,5,1,4,1
"Australia",944,3,4,4,2,2,2
"Argentina",945,6,9,5,1,4,1
"Japan",945,6,3,4,4,0,2
"Brazil",946,2,7,7,2,5,1
"Germany",946,2,4,2,2,0,2
"Italy",946,4,4,3,1,2,1
"Morocco",946,4,4,3,3,0,2
"Belgium",946,5,6,5,4,1,1
"Tunisia",946,5,4,2,1,1,2
"England",946,7,7,7,1,6,1
"Netherlands",946,7,7,7,3,4,2
"Denmark",947,2,7,5,2,3,1
"France",947,2,4,3,2,1,2
"Belgium",947,7,6,3,2,1,2
"Colombia",947,7,6,7,3,4,1
"Portugal",947,8,5,5,3,2,1
"Chile",947,8,4,2,1,1,2
"Argentina",948,8,7,5,1,4,1
"Australia",948,8,4,3,3,0,2
"Brazil",949,6,6,8,4,4,1
"Switzerland",949,6,6,4,4,0,2
"Denmark",950,2,4,7,7,0,2
"Morocco",950,2,4,6,5,1,1
"Argentina",950,3,7,3,0,3,1
"Mexico",950,3,4,4,4,0,2
"Belgium",950,5,6,6,5,1,2
"Chile",950,5,6,5,2,3,1
"Korea Republic",950,6,9,4,1,3,1
"Portugal",950,6,4,4,2,2,2
"France",950,8,7,9,1,8,1
"Italy",950,8,4,4,2,2,2
"Brazil",951,4,6,5,2,3,1
"Nigeria",951,4,6,4,2,2,2
"Mexico",952,4,5,3,1,2,1
"Australia",952,4,5,2,1,1,2
"Belgium",952,5,9,9,4,5,1
"Japan",952,5,4,6,4,2,2
"England",952,7,6,7,4,3,1
"Croatia",952,7,6,4,3,1,2
"Portugal",953,5,5,4,3,1,2
"Chile",953,5,5,5,3,2,1
"Spain",953,7,6,5,4,1,1
"Japan",953,7,4,4,2,2,2
"Brazil",954,4,6,7,1,6,1
"Poland",954,4,4,5,4,1,2
"Wales",955,1,6,3,2,1,2
"Morocco",955,1,6,4,2,2,1
"Brazil",955,2,7,7,2,5,2
"Netherlands",955,2,7,7,0,7,1
"Belgium",956,5,6,6,4,2,1
"Chile",956,5,6,3,4,-1,2
"Portugal",956,8,5,3,2,1,1
"Denmark",956,8,4,2,1,1,2
"Brazil",957,2,6,4,3,1,2
"Mexico",957,2,6,4,2,2,1
"Belgium",957,3,9,8,3,5,1
"Uruguay",957,3,4,2,2,0,2
"Argentina",957,4,9,8,0,8,1
"Morocco",957,4,3,4,3,1,2
"Spain",957,5,7,4,1,3,2
"Germany",957,5,7,8,2,6,1
"France",957,7,6,7,3,4,1
"Denmark",957,7,6,3,2,1,2
"Netherlands",958,1,7,5,1,4,1
"Algeria",958,1,7,3,1,2,2
"Italy",958,2,9,6,1,5,1
"France",958,2,4,2,1,1,2
"Belgium",958,4,7,5,2,3,1
"Chile",958,4,7,6,4,2,2
"Qatar",959,1,6,4,3,1,1
"Germany",959,1,4,4,2,2,2
"Senegal",960,3,7,5,1,4,1
"Argentina",960,3,4,3,1,2,2
"Brazil",960,4,7,10,3,7,1
"Netherlands",960,4,7,6,2,4,2
"Korea Republic",960,7,9,6,3,3,1
"Spain",960,7,4,5,4,1,2
"France",961,3,7,3,1,2,1
"Korea Republic",961,3,4,3,1,2,2
"Spain",961,4,7,5,2,3,1
"Chile",961,4,4,5,4,1,2
"Belgium",961,6,6,9,3,6,1
"Uruguay",961,6,6,8,6,2,2
"Brazil",961,7,9,10,2,8,1
"Denmark",961,7,4,7,4,3,2
"England",962,5,6,7,2,5,1
"Uruguay",962,5,6,3,4,-1,2
"Argentina",962,7,6,7,2,5,1
"Germany",962,7,6,3,2,1,2
"Algeria",963,3,6,4,4,0,1
"Colombia",963,3,4,4,2,2,2
"Brazil",963,5,7,7,2,5,1
"Netherlands",963,5,7,4,1,3,2
"Italy",964,2,9,9,3,6,1
"United States",964,2,4,5,5,0,2
"Croatia",964,5,6,5,2,3,2
"Wales",964,5,6,5,1,4,1
"Senegal",964,7,6,4,3,1,1
"Colombia",964,7,4,3,3,0,2
"France",965,2,6,6,4,2,1
"Uruguay",965,2,4,4,4,0,2
"Uruguay",966,1,7,5,2,3,1
"Jamaica",966,1,7,4,2,2,2
"Netherlands",966,2,9,4,0,4,1
"Argentina",966,2,3,4,3,1,2
"Portugal",966,3,5,2,1,1,2
"Mexico",966,3,5,3,1,2,1
"Brazil",966,5,7,10,5,5,1
"Germany",966,5,7,5,3,2,2
"England",966,7,5,3,1,2,1
"Croatia",966,7,5,1,0,1,2
"Belgium",966,8,5,3,1,2,1
"Chile",966,8,5,2,1,1,2
"Qatar",967,1,9,9,2,7,1
"Nigeria",967,1,4,5,4,1,2
"Portugal",967,2,7,13,2,11,1
"Germany",967,2,7,4,2,2,2
"Senegal",967,5,5,2,1,1,1
"Mexico",967,5,4,5,4,1,2
"Argentina",968,2,5,5,4,1,1
"Wales",968,2,4,2,2,0,2
"Belgium",968,5,6,4,4,0,1
"Italy",968,5,4,4,2,2,2
"Korea Republic",968,6,5,4,2,2,1
"United States",968,6,4,3,2,1,2
"Colombia",968,7,6,4,2,2,1
"Spain",968,7,4,4,2,2,2
"Italy",969,5,9,11,4,7,1
"Costa Rica",969,5,3,3,3,0,2
"Netherlands",971,1,9,6,2,4,1
"Poland",971,1,4,4,2,2,2
"France",971,2,9,9,3,6,1
"Korea Republic",971,2,4,6,3,3,2
"Spain",971,5,7,5,3,2,2
"Chile",971,5,7,4,1,3,1
"Netherlands",972,2,5,4,1,3,1
"Switzerland",972,2,5,1,0,1,2
"Argentina",972,3,9,4,0,4,1
"Tunisia",972,3,4,3,1,2,2
"Brazil",972,6,7,4,2,2,2
"Croatia",972,6,7,6,1,5,1
"Italy",973,1,6,3,2,1,1
"Tunisia",973,1,6,2,4,-2,2
"Argentina",973,2,5,4,1,3,1
"Wales",973,2,4,2,2,0,2
"Spain",973,4,5,6,3,3,1
"Chile",973,4,4,4,3,1,2
"England",973,6,6,3,5,-2,2
"Mexico",973,6,6,7,4,3,1
"Colombia",974,6,7,3,1,2,1
"United States",974,6,4,4,2,2,2
"Portugal",974,7,6,5,1,4,1
"Switzerland",974,7,6,3,3,0,2
"Germany",975,1,7,4,2,2,2
"Chile",975,1,7,4,1,3,1
"Korea Republic",975,3,9,4,0,4,1
"Italy",975,3,4,3,2,1,2
"France",975,4,7,6,3,3,2
"Wales",975,4,7,11,3,8,1
"Netherlands",975,6,7,4,1,3,1
"Australia",975,6,4,3,2,1,2
"Argentina",975,7,6,6,4,2,1
"Japan",975,7,6,4,4,0,2
"Colombia",976,1,6,6,3,3,1
"Switzerland",976,1,6,3,3,0,2
"England",976,4,6,7,4,3,1
"Iran",976,4,6,6,5,1,2
"Italy",977,2,5,6,3,3,1
"Korea Republic",977,2,4,9,6,3,2
"Portugal",977,3,7,5,0,5,1
"Switzerland",977,3,4,1,2,-1,2
"England",977,5,6,3,2,1,1
"Uruguay",977,5,4,5,4,1,2
"Mexico",978,3,6,2,1,1,2
"Tunisia",978,3,6,4,2,2,1
"Argentina",978,4,6,4,5,-1,2
"Germany",978,4,6,7,1,6,1
"Brazil",979,2,5,5,3,2,1
"Algeria",979,2,4,1,1,0,2
"Germany",979,5,7,4,2,2,1
"Argentina",979,5,4,3,2,1,2
"Spain",979,7,6,6,2,4,1
"Switzerland",979,7,4,2,2,0,2
"Mexico",980,3,7,7,1,6,1
"Poland",980,3,7,3,1,2,2
"Portugal",981,3,6,3,2,1,2
"Costa Rica",981,3,6,3,1,2,1
"England",981,5,6,5,4,1,2
"Denmark",981,5,6,7,2,5,1
"Algeria",981,6,5,4,3,1,1
"Switzerland",981,6,4,2,1,1,2
"France",981,8,5,4,1,3,1
"Colombia",981,8,5,2,0,2,2
"Brazil",982,3,5,3,2,1,2
"Korea Republic",982,3,5,7,2,5,1
"Argentina",982,8,7,5,1,4,2
"Germany",982,8,7,7,2,5,1
"Senegal",983,4,5,5,2,3,1
"Colombia",983,4,4,4,4,0,2
"England",983,5,5,9,7,2,1
"Mexico",983,5,5,6,5,1,2
"Brazil",983,6,6,6,2,4,1
"Denmark",983,6,6,5,3,2,2
"England",984,2,7,4,2,2,2
"Australia",984,2,7,8,2,6,1
"Korea Republic",984,5,7,7,3,4,1
"Argentina",984,5,4,5,4,1,2
"Chile",984,7,6,5,3,2,1
"Mexico",984,7,4,4,4,0,2
"Italy",984,8,6,4,2,2,1
"Switzerland",984,8,4,3,3,0,2
"Mexico",985,2,6,7,1,6,1
"Nigeria",985,2,4,3,4,-1,2
"Italy",985,3,6,4,1,3,1
"Iran",985,3,6,3,3,0,2
"Brazil",985,5,7,8,4,4,1
"Netherlands",985,5,7,7,4,3,2
"Germany",986,4,6,3,3,0,1
"Brazil",986,4,4,5,4,1,2
"England",986,7,5,4,3,1,2
"Colombia",986,7,5,7,4,3,1
"Italy",987,1,6,7,2,5,1
"Switzerland",987,1,6,6,3,3,2
"Australia",988,2,7,4,2,2,1
"Italy",988,2,4,5,4,1,2
"Argentina",988,3,6,4,4,0,2
"Senegal",988,3,6,3,2,1,1
"Portugal",988,8,6,10,5,5,1
"Switzerland",988,8,6,6,5,1,2
"Nigeria",989,5,6,3,3,0,1
"England",989,5,4,4,2,2,2
"Portugal",989,8,9,7,2,5,1
"Wales",989,8,3,3,4,-1,2
"Qatar",991,1,5,2,1,1,2
"Poland",991,1,5,5,2,3,1
"Senegal",991,4,5,4,2,2,1
"Portugal",991,4,4,3,2,1,2
"Mexico",991,6,6,3,3,0,1
"Spain",991,6,4,4,3,1,2
"England",991,8,7,6,0,6,1
"Korea Republic",991,8,4,3,2,1,2
"Netherlands",992,1,6,4,3,1,1
"Morocco",992,1,4,3,4,-1,2
"Spain",992,4,6,4,1,3,2
"Colombia",992,4,6,7,3,4,1
"Netherlands",994,1,5,3,0,3,1
"Chile",994,1,5,3,2,1,2
"Spain",994,7,5,5,3,2,1
"Korea Republic",994,7,4,7,6,1,2
"Portugal",994,8,6,7,3,4,1
"Italy",994,8,6,6,3,3,2
"Italy",995,5,6,3,3,0,1
"Wales",995,5,4,6,5,1,2
"Australia",995,6,9,4,0,4,1
"Brazil",995,6,4,3,2,1,2
"Nigeria",995,8,5,1,0,1,1
"Uruguay",995,8,4,3,2,1,2
"France",996,2,6,5,4,1,2
"Korea Republic",996,2,6,8,5,3,1
"Spain",996,4,7,8,2,6,1
"Japan",996,4,4,5,3,2,2
"Denmark",996,6,9,5,1,4,1
"Brazil",996,6,4,6,3,3,2
"Portugal",998,5,7,3,1,2,2
"Australia",998,5,7,6,3,3,1
"Spain",999,2,6,6,3,3,1
"Korea Republic",999,2,6,7,6,1,2
"Argentina",999,7,7,6,1,5,1
"Japan",999,7,7,4,1,3,2
"Netherlands",1000,1,7,5,1,4,1
"Switzerland",1000,1,7,4,1,3,2
"Mexico",1000,2,6,6,5,1,1
"England",1000,2,4,7,4,3,2
"Spain",1000,8,7,6,2,4,1
"Iran",1000,8,7,8,6,2,2
"Italy",2,1,4,4,3,1,2
"Costa Rica",2,1,4,5,4,1,1
"Senegal",3,1,6,5,4,1,1
"Costa Rica",3,1,4,2,2,0,2
"Belgium",5,6,6,7,4,3,1
"Mexico",5,6,6,5,2,3,2
"Spain",5,7,7,4,1,3,1
"Japan",5,7,7,3,0,3,2
"England",5,8,6,3,1,2,1
"Colombia",5,8,4,3,3,0,2
"Colombia",6,8,4,4,4,0,1
"Costa Rica",6,8,4,3,3,0,2
"United States",7,2,5,4,3,1,1
"Netherlands",7,2,4,3,3,0,2
"England",7,5,5,2,1,1,2
"Morocco",7,5,5,3,2,1,1
"Belgium",8,3,6,9,4,5,1
"Jamaica",8,3,4,4,4,0,2
"Croatia",9,1,5,2,1,1,1
"Wales",9,1,5,1,0,1,2
"Uruguay",14,1,5,5,1,4,2
"Algeria",14,1,5,7,3,4,1
"Wales",14,6,6,3,2,1,1
"Brazil",14,6,4,4,4,0,2
"Italy",15,1,5,5,1,4,1
"Wales",15,1,4,4,4,0,2
"England",15,4,5,4,3,1,2
"Germany",15,4,5,6,5,1,1
"Portugal",16,7,6,7,2,5,1
"Germany",16,7,4,5,5,0,2
"Brazil",16,8,7,6,3,3,1
"Denmark",16,8,7,5,2,3,2
"Italy",17,1,7,4,1,3,1
"Chile",17,1,4,2,2,0,2
"Portugal",17,6,5,5,4,1,1
"Colombia",17,6,5,4,3,1,2
"Spain",18,3,5,5,2,3,1
"Colombia",18,3,5,3,0,3,2
"Chile",19,7,9,4,1,3,1
"Mexico",19,7,2,4,5,-1,2
"Brazil",20,4,5,4,2,2,2
"Netherlands",20,4,5,4,0,4,1
"Spain",22,2,5,3,2,1,2
"Mexico",22,2,5,4,3,1,1
"Spain",23,2,5,2,1,1,1
"Iran",23,2,5,1,0,1,2
"Denmark",23,3,5,4,3,1,1
"Switzerland",23,3,5,1,0,1,2
"Argentina",23,7,9,5,2,3,1
"Japan",23,7,4,3,3,0,2
"Colombia",26,3,5,5,4,1,1
"Iran",26,3,5,3,2,1,2
"France",27,3,6,4,3,1,1
"Japan",27,3,6,3,2,1,2
"Netherlands",28,3,4,4,3,1,1
"Chile",28,3,4,3,2,1,2
"Argentina",30,3,6,5,5,0,1
"Korea Republic",30,3,4,4,4,0,2
"Netherlands",34,1,6,6,5,1,2
"United States",34,1,6,7,4,3,1
"Wales",36,2,7,3,1,2,1
"Italy",36,2,4,3,3,0,2
"Denmark",36,3,9,5,1,4,1
"Korea Republic",36,3,2,2,3,-1,2
"Colombia",42,7,6,4,3,1,1
"Belgium",42,7,4,3,3,0,2
"Wales",42,8,5,4,3,1,1
"Denmark",42,8,4,5,5,0,2
"Brazil",44,3,6,3,2,1,2
"Netherlands",44,3,6,5,4,1,1
"Qatar",50,1,6,6,5,1,2
"Netherlands",50,1,6,5,3,2,1
"England",51,2,6,4,3,1,1
"Colombia",51,2,6,3,2,1,2
"Belgium",53,3,6,6,5,1,1
"Uruguay",53,3,4,3,3,0,2
"Iran",53,4,6,3,2,1,1
"Spain",53,4,4,3,3,0,2
"Croatia",53,7,5,3,1,2,1
"Costa Rica",53,7,3,3,3,0,2
"Netherlands",55,5,9,9,3,6,1
"Argentina",55,5,2,5,7,-2,2
"Italy",58,1,5,6,4,2,1
"Switzerland",58,1,3,4,4,0,2
"England",61,6,5,5,4,1,1
"Switzerland",61,6,4,4,4,0,2
"Qatar",62,1,6,3,2,1,2
"Netherlands",62,1,6,6,5,1,1
"Qatar",63,1,6,3,3,0,2
"Chile",63,1,6,5,5,0,1
"France",64,4,4,3,3,0,2
"Mexico",64,4,4,6,5,1,1
"Iran",65,4,6,3,2,1,1
"Chile",65,4,4,3,3,0,2
"Netherlands",66,5,5,3,2,1,2
"Japan",66,5,5,4,2,2,1
"Argentina",66,7,4,5,3,2,1
"United States",66,7,4,2,2,0,2
"Netherlands",69,5,6,3,4,-1,1
"Wales",69,5,4,4,3,1,2
"Belgium",71,7,5,3,1,2,2
"Korea Republic",71,7,5,7,2,5,1
"Italy",72,6,5,3,2,1,1
"Chile",72,6,5,1,0,1,2
"Belgium",73,3,6,7,6,1,2
"Chile",73,3,6,5,2,3,1
"England",73,6,6,8,3,5,1
"Japan",73,6,4,4,4,0,2
"Croatia",75,4,6,3,3,0,1
"Australia",75,4,4,4,3,1,2
"Argentina",75,5,5,1,0,1,2
"Mexico",75,5,5,3,2,1,1
"Switzerland",78,5,5,3,2,1,1
"Nigeria",78,5,4,3,3,0,2
"Uruguay",79,4,5,2,1,1,1
"Iran",79,4,5,1,0,1,2
"Wales",79,7,6,3,4,-1,1
"France",79,7,4,6,5,1,2
"Morocco",81,8,5,3,2,1,1
"Uruguay",81,8,4,3,3,0,2
"Italy",82,1,4,4,3,1,1
"Poland",82,1,4,4,4,0,2
"Germany",82,5,6,5,4,1,1
"Japan",82,5,6,3,2,1,2
"Brazil",84,7,6,7,6,1,1
"Australia",84,7,6,5,4,1,2
"Portugal",85,2,5,3,1,2,1
"Italy",85,2,5,2,0,2,2
"Brazil",87,5,6,2,1,1,2
"Germany",87,5,6,3,2,1,1
"Italy",87,6,6,6,4,2,1
"Portugal",87,6,4,3,4,-1,2
"England",87,8,9,6,0,6,1
"Poland",87,8,3,4,5,-1,2
"Uruguay",89,1,5,5,2,3,2
"Switzerland",89,1,5,6,3,3,1
"Spain",97,4,6,7,3,4,1
"Senegal",97,4,6,5,5,0,2
"Korea Republic",98,4,7,6,3,3,1
"Netherlands",98,4,4,3,3,0,2
"Mexico",98,8,6,7,3,4,1
"Chile",98,8,6,5,4,1,2
"Belgium",99,2,6,6,5,1,1
"Uruguay",99,2,6,5,4,1,2
"England",101,5,6,4,2,2,2
"Chile",101,5,6,5,3,2,1
"Denmark",105,4,5,3,2,1,2
"Chile",105,4,5,4,3,1,1
"Brazil",106,2,6,8,3,5,1
"Australia",106,2,6,5,4,1,2
"Korea Republic",107,6,9,6,1,5,1
"Belgium",107,6,4,4,3,1,2
"Denmark",107,7,5,3,1,2,2
"Australia",107,7,5,5,3,2,1
"Poland",111,7,6,4,3,1,1
"Australia",111,7,6,3,2,1,2
"Switzerland",112,3,7,4,0,4,1
"Mexico",112,3,4,3,3,0,2
"Spain",112,4,6,9,7,2,1
"Poland",112,4,6,8,6,2,2
"Portugal",112,5,5,5,2,3,1
"Italy",112,5,3,2,2,0,2
"Qatar",113,1,6,3,2,1,1
"Netherlands",113,1,4,2,2,0,2
"Portugal",114,2,9,8,0,8,1
"Nigeria",114,2,4,2,4,-2,2
"Chile",118,8,6,6,4,2,1
"England",118,8,4,3,3,0,2
"Mexico",119,7,6,4,3,1,2
"Algeria",119,7,6,5,4,1,1
"Belgium",121,7,7,9,5,4,1
"Mexico",121,7,4,7,7,0,2
"Wales",121,8,6,4,2,2,1
"Brazil",121,8,4,3,3,0,2
"Brazil",124,8,5,4,3,1,2
"Denmark",124,8,5,5,4,1,1
"Belgium",127,6,4,3,3,0,2
"Wales",127,6,4,3,2,1,1
"Italy",129,2,5,4,3,1,1
"Chile",129,2,5,3,2,1,2
"England",131,2,5,2,0,2,2
"Uruguay",131,2,5,4,2,2,1
"Australia",131,6,5,7,6,1,1
"Wales",131,6,4,4,4,0,2
"Mexico",132,2,6,3,4,-1,1
"Japan",132,2,4,5,4,1,2
"Japan",136,3,7,2,0,2,1
"France",136,3,4,2,2,0,2
"Brazil",136,5,6,8,2,6,1
"Denmark",136,5,6,6,5,1,2
"Germany",137,1,9,10,2,8,1
"Qatar",137,1,2,3,5,-2,2
"Qatar",139,1,5,3,1,2,2
"Germany",139,1,5,4,2,2,1
"Denmark",139,7,5,4,2,2,1
"Nigeria",139,7,3,5,5,0,2
"Portugal",146,6,5,4,1,3,1
"Colombia",146,6,5,3,2,1,2
"Brazil",147,7,6,6,4,2,1
"Netherlands",147,7,6,5,3,2,2
"England",148,4,4,5,3,2,1
"Colombia",148,4,4,4,2,2,2
"France",151,5,5,5,3,2,1
"Wales",151,5,5,4,2,2,2
"Iran",151,6,6,4,3,1,1
"Poland",151,6,4,5,5,0,2
"Netherlands",152,1,9,5,2,3,1
"Qatar",152,1,2,2,3,-1,2
"Colombia",153,6,9,5,1,4,1
"France",153,6,4,2,2,0,2
"Mexico",154,1,9,8,2,6,1
"Qatar",154,1,3,3,4,-1,2
"Spain",157,5,5,5,4,1,1
"Denmark",157,5,5,4,3,1,2
"Colombia",158,1,7,5,2,3,1
"Costa Rica",158,1,4,3,3,0,2
"France",158,2,5,5,4,1,1
"Poland",158,2,5,4,3,1,2
"Argentina",159,7,5,2,1,1,2
"Mexico",159,7,5,3,2,1,1
"England",161,4,9,7,2,5,1
"Uruguay",161,4,4,5,5,0,2
"Senegal",162,2,6,5,3,2,1
"Korea Republic",162,2,6,4,3,1,2
"Colombia",163,1,6,4,3,1,1
"United States",163,1,6,3,2,1,2
"France",164,4,9,7,1,6,1
"Croatia",164,4,3,4,6,-2,2
"Argentina",168,5,6,6,4,2,1
"Italy",168,5,6,4,2,2,2
"Denmark",170,1,5,1,0,1,2
"Jamaica",170,1,5,3,2,1,1
"Croatia",171,2,6,3,1,2,2
"Senegal",171,2,6,7,5,2,1
"Colombia",174,1,6,6,3,3,1
"Switzerland",174,1,6,4,1,3,2
"Spain",174,4,9,7,3,4,1
"Tunisia",174,4,2,3,4,-1,2
"Belgium",174,8,6,3,2,1,1
"Italy",174,8,4,3,3,0,2
"Brazil",178,4,6,5,3,2,2
"Germany",178,4,6,6,4,2,1
"Uruguay",180,6,6,3,2,1,2
"Iran",180,6,6,4,3,1,1
"Mexico",181,2,9,6,0,6,1
"Japan",181,2,2,2,3,-1,2
"Colombia",184,7,6,4,3,1,1
"Iran",184,7,6,3,2,1,2
"France",186,6,6,4,2,2,2
"Germany",186,6,6,5,3,2,1
"France",189,2,5,6,3,3,1
"Colombia",189,2,4,3,3,0,2
"Argentina",190,2,5,4,3,1,1
"Denmark",190,2,5,2,1,1,2
"Denmark",192,1,7,6,2,4,1
"Costa Rica",192,1,7,4,0,4,2
"England",192,3,7,8,3,5,1
"United States",192,3,7,7,2,5,2
"England",193,4,5,3,2,1,1
"Denmark",193,4,4,3,3,0,2
"Spain",198,4,5,6,4,2,1
"Algeria",198,4,5,4,2,2,2
"Brazil",198,6,5,5,4,1,1
"Denmark",198,6,5,3,2,1,2
"Italy",199,1,6,4,1,3,1
"Wales",199,1,4,3,4,-1,2
"Belgium",199,4,6,5,3,2,1
"Iran",199,4,4,5,6,-1,2
"Argentina",202,8,6,3,1,2,2
"Australia",202,8,6,5,3,2,1
"France",205,2,6,6,1,5,1
"Croatia",205,2,6,4,3,1,2
"Uruguay",206,4,5,6,4,2,1
"United States",206,4,5,5,3,2,2
"United States",210,2,6,5,4,1,1
"Belgium",210,2,4,5,5,0,2
"Poland",214,1,6,5,3,2,1
"Qatar",214,1,4,4,4,0,2
"Colombia",215,6,4,5,5,0,1
"Morocco",215,6,4,4,4,0,2
"Iran",216,4,6,4,3,1,1
"Brazil",216,4,4,5,5,0,2
"France",217,8,9,7,3,4,1
"Denmark",217,8,2,4,5,-1,2
"Denmark",220,4,7,8,2,6,1
"Brazil",220,4,4,3,3,0,2
"Iran",220,8,6,3,2,1,1
"Wales",220,8,4,4,4,0,2
"Belgium",225,5,7,4,1,3,1
"Germany",225,5,4,3,3,0,2
"Argentina",226,4,9,3,0,3,1
"Italy",226,4,4,4,4,0,2
"Tunisia",227,2,4,4,4,0,1
"Korea Republic",227,2,4,3,3,0,2
"Jamaica",229,1,9,6,2,4,1
"Senegal",229,1,2,6,7,-1,2
"Iran",229,8,6,5,2,3,1
"Chile",229,8,4,3,4,-1,2
"Argentina",230,3,7,4,2,2,1
"United States",230,3,7,3,1,2,2
"Qatar",231,1,6,3,2,1,1
"Chile",231,1,6,2,1,1,2
"Portugal",232,3,7,5,1,4,2
"Italy",232,3,7,6,2,4,1
"Belgium",232,6,9,6,1,5,1
"Iran",232,6,4,5,6,-1,2
"Qatar",235,1,5,4,3,1,1
"Nigeria",235,1,5,3,2,1,2
"France",235,5,6,2,1,1,2
"Poland",235,5,6,5,4,1,1
"Croatia",236,8,5,3,2,1,1
"Algeria",236,8,4,4,4,0,2
"France",240,4,5,4,3,1,1
"Mexico",240,4,5,3,2,1,2
"Netherlands",241,5,5,4,3,1,1
"Iran",241,5,5,3,2,1,2
"Korea Republic",243,2,6,4,2,2,1
"Brazil",243,2,4,5,5,0,2
"Belgium",244,2,6,4,3,1,1
"Japan",244,2,4,3,3,0,2
"Italy",248,1,6,6,4,2,1
"Chile",248,1,6,5,3,2,2
"United States",249,4,5,6,5,1,2
"Korea Republic",249,4,5,7,6,1,1
"Poland",249,8,7,6,3,3,1
"Germany",249,8,4,4,4,0,2
"Belgium",250,5,7,5,2,3,1
"Italy",250,5,7,4,1,3,2
"Switzerland",255,1,9,7,3,4,1
"Denmark",255,1,4,3,3,0,2
"Germany",257,1,5,10,6,4,1
"Qatar",257,1,3,5,5,0,2
"Italy",257,2,4,5,4,1,1
"Iran",257,2,4,4,3,1,2
"Belgium",259,7,9,6,0,6,1
"Japan",259,7,3,2,3,-1,2
"England",264,3,5,4,3,1,1
"United States",264,3,3,4,4,0,2
"Uruguay",268,5,5,1,0,1,2
"Korea Republic",268,5,5,2,1,1,1
"Chile",270,6,9,7,3,4,1
"Germany",270,6,3,3,4,-1,2
"Mexico",270,7,5,5,4,1,1
"England",270,7,4,4,4,0,2
"Mexico",272,7,6,3,3,0,1
"Belgium",272,7,4,5,4,1,2
"France",273,3,6,3,1,2,2
"Denmark",273,3,6,5,3,2,1
"Germany",274,7,5,2,1,1,2
"Chile",274,7,5,3,2,1,1
"Argentina",280,3,5,2,1,1,1
"Australia",280,3,3,2,2,0,2
"Chile",285,8,7,4,2,2,1
"Nigeria",285,8,4,4,3,1,2
"Portugal",288,5,5,1,0,1,2
"Costa Rica",288,5,5,3,2,1,1
"Argentina",288,8,4,4,4,0,1
"Nigeria",288,8,4,3,3,0,2
"Senegal",290,1,5,4,3,1,1
"Germany",290,1,4,3,3,0,2
"Argentina",291,7,6,3,1,2,2
"Netherlands",291,7,6,4,2,2,1
"Germany",296,1,7,3,1,2,1
"Morocco",296,1,4,4,4,0,2
"Germany",297,8,4,4,4,0,2
"Costa Rica",297,8,4,5,3,2,1
"Italy",299,4,5,4,3,1,1
"Morocco",299,4,3,4,4,0,2
"Spain",300,5,7,2,0,2,2
"Chile",300,5,7,3,1,2,1
"Belgium",302,5,9,12,1,11,1
"Switzerland",302,5,3,4,7,-3,2
"Denmark",303,8,5,4,1,3,1
"Iran",303,8,5,6,4,2,2
"France",305,3,6,3,2,1,2
"United States",305,3,6,5,4,1,1
"Croatia",305,5,6,5,4,1,2
"Chile",305,5,6,7,3,4,1
"Belgium",306,2,5,6,1,5,1
"Japan",306,2,5,4,3,1,2
"Denmark",307,2,5,4,3,1,1
"Wales",307,2,4,5,5,0,2
"Argentina",311,7,7,9,3,6,1
"Germany",311,7,4,3,5,-2,2
"Brazil",313,2,5,4,2,2,2
"Netherlands",313,2,5,5,3,2,1
"Argentina",314,6,5,4,2,2,2
"Denmark",314,6,5,5,3,2,1
"Iran",315,3,5,4,3,1,1
"Germany",315,3,4,4,4,0,2
"Colombia",317,1,5,5,4,1,1
"Nigeria",317,1,5,4,3,1,2
"Germany",324,2,5,4,2,2,1
"Tunisia",324,2,5,2,0,2,2
"Belgium",325,5,7,4,0,4,1
"Germany",325,5,4,5,5,0,2
"Qatar",326,1,5,4,3,1,1
"Wales",326,1,5,2,1,1,2
"Switzerland",326,6,7,4,1,3,1
"Iran",326,6,4,3,3,0,2
"England",326,7,6,6,2,4,1
"United States",326,7,6,5,5,0,2
"Italy",327,1,9,5,0,5,1
"Qatar",327,1,4,3,3,0,2
"Argentina",332,5,7,5,2,3,2
"Mexico",332,5,7,6,3,3,1
"Iran",334,5,7,5,3,2,1
"Chile",334,5,4,3,3,0,2
"Belgium",335,5,7,3,1,2,2
"Croatia",335,5,7,4,2,2,1
"Croatia",342,2,6,5,2,3,1
"Iran",342,2,4,4,5,-1,2
"Portugal",342,4,4,6,6,0,2
"Netherlands",342,4,4,5,4,1,1
"Switzerland",343,1,7,2,0,2,1
"Qatar",343,1,4,5,5,0,2
"England",343,4,6,3,1,2,2
"Denmark",343,4,6,5,3,2,1
"Netherlands",344,1,9,5,1,4,1
"Qatar",344,1,2,2,3,-1,2
"Wales",346,8,5,3,2,1,2
"Algeria",346,8,5,5,4,1,1
"Belgium",349,3,6,4,3,1,2
"Senegal",349,3,6,6,5,1,1
"Belgium",358,6,6,4,1,3,1
"Denmark",358,6,6,5,4,1,2
"Portugal",359,2,6,4,2,2,1
"Denmark",359,2,6,3,1,2,2
"Netherlands",360,1,6,4,2,2,2
"Chile",360,1,6,6,4,2,1
"Belgium",360,5,7,6,2,4,1
"Mexico",360,5,4,3,3,0,2
"Australia",362,8,6,5,2,3,1
"France",362,8,4,3,3,0,2
"Argentina",363,4,9,6,1,5,1
"Mexico",363,4,4,3,4,-1,2
"Spain",363,8,5,2,1,1,1
"Croatia",363,8,4,3,3,0,2
"Netherlands",366,6,5,3,1,2,2
"Korea Republic",366,6,5,5,3,2,1
"Belgium",368,3,9,11,4,7,1
"Iran",368,3,4,7,7,0,2
"Denmark",369,1,9,8,0,8,1
"United States",369,1,2,2,4,-2,2
"Qatar",371,1,6,3,2,1,2
"Colombia",371,1,6,3,1,2,1
"Belgium",374,4,7,9,3,6,1
"Switzerland",374,4,4,7,6,1,2
"Croatia",374,6,9,6,1,5,1
"Australia",374,6,4,6,6,0,2
"Belgium",376,3,6,5,3,2,2
"Germany",376,3,6,5,2,3,1
"France",379,6,6,6,3,3,1
"Switzerland",379,6,6,5,2,3,2
"Portugal",379,8,5,4,2,2,2
"Iran",379,8,5,5,3,2,1
"Qatar",381,1,6,7,6,1,1
"Switzerland",381,1,6,4,3,1,2
"Netherlands",382,4,7,5,1,4,1
"United States",382,4,4,4,5,-1,2
"Qatar",383,1,7,4,0,4,2
"Colombia",383,1,7,7,3,4,1
"Argentina",383,6,6,4,3,1,1
"Mexico",383,6,6,2,1,1,2
"Qatar",387,1,4,4,3,1,1
"Germany",387,1,4,4,4,0,2
"Mexico",391,7,6,6,4,2,1
"France",391,7,4,4,4,0,2
"Denmark",392,2,7,6,3,3,2
"Iran",392,2,7,7,4,3,1
"France",392,5,5,1,0,1,2
"Chile",392,5,5,2,1,1,1
"Argentina",392,6,7,7,1,6,1
"Costa Rica",392,6,4,4,4,0,2
"Belgium",393,2,7,5,3,2,1
"Denmark",393,2,7,4,2,2,2
"Uruguay",394,6,9,5,2,3,1
"United States",394,6,4,4,3,1,2
"England",397,4,6,4,3,1,1
"Denmark",397,4,4,5,4,1,2
"Germany",399,3,6,6,5,1,1
"Australia",399,3,6,4,3,1,2
"Belgium",399,4,9,8,3,5,1
"Switzerland",399,4,3,4,5,-1,2
"Spain",399,6,5,6,4,2,1
"Croatia",399,6,4,5,5,0,2
"Argentina",400,7,6,5,1,4,2
"Switzerland",400,7,6,10,6,4,1
"Iran",403,7,5,4,2,2,1
"England",403,7,4,3,3,0,2
"Portugal",405,6,9,7,2,5,1
"Chile",405,6,3,5,6,-1,2
"Argentina",406,6,5,1,0,1,2
"Mexico",406,6,5,3,2,1,1
"Belgium",411,5,6,6,3,3,2
"Uruguay",411,5,6,7,4,3,1
"Belgium",412,7,5,6,3,3,1
"Japan",412,7,5,4,1,3,2
"Costa Rica",413,6,5,3,2,1,1
"Argentina",413,6,3,3,3,0,2
"Korea Republic",416,4,5,2,1,1,1
"Poland",416,4,3,4,4,0,2
"France",417,2,6,3,2,1,1
"Senegal",417,2,4,3,3,0,2
"Jamaica",419,7,5,3,2,1,1
"Denmark",419,7,4,2,2,0,2
"Qatar",422,1,6,3,1,2,2
"Uruguay",422,1,6,6,4,2,1
"Spain",423,6,9,7,3,4,1
"Senegal",423,6,4,6,6,0,2
"Belgium",425,3,9,7,4,3,1
"Costa Rica",425,3,2,2,3,-1,2
"Brazil",425,8,7,5,1,4,2
"Korea Republic",425,8,7,6,2,4,1
"Poland",426,1,6,3,1,2,1
"Qatar",426,1,4,3,3,0,2
"Germany",428,3,7,6,3,3,1
"Senegal",428,3,4,8,7,1,2
"Croatia",431,2,5,6,3,3,1
"Spain",431,2,4,3,3,0,2
"Qatar",432,1,6,4,3,1,2
"Algeria",432,1,6,5,2,3,1
"Belgium",432,2,6,6,3,3,2
"Mexico",432,2,6,7,4,3,1
"Chile",432,6,6,8,5,3,1
"England",432,6,4,6,7,-1,2
"Italy",435,7,6,2,2,0,1
"Chile",435,7,4,3,3,0,2
"Mexico",439,5,9,7,2,5,1
"Australia",439,5,4,6,5,1,2
"Tunisia",441,3,5,3,2,1,1
"Argentina",441,3,3,3,3,0,2
"Argentina",442,3,9,9,2,7,1
"Italy",442,3,4,2,2,0,2
"England",443,6,5,7,3,4,1
"Jamaica",443,6,4,5,6,-1,2
"Germany",445,4,6,6,5,1,1
"England",445,4,4,5,5,0,2
"Wales",447,1,4,3,4,-1,2
"Costa Rica",447,1,4,5,3,2,1
"England",451,2,7,4,1,3,2
"Netherlands",451,2,7,6,3,3,1
"Belgium",451,3,6,7,3,4,1
"Italy",451,3,6,5,1,4,2
"Croatia",451,5,6,6,4,2,1
"United States",451,5,6,5,3,2,2
"Korea Republic",452,6,5,5,2,3,1
"Croatia",452,6,4,4,5,-1,2
"Uruguay",456,5,6,4,1,3,1
"Australia",456,5,4,3,4,-1,2
"Portugal",465,2,5,3,0,3,1
"Japan",465,2,4,3,3,0,2
"France",466,3,5,3,2,1,1
"Iran",466,3,4,2,2,0,2
"Netherlands",467,5,5,4,1,3,1
"Switzerland",467,5,5,3,0,3,2
"Spain",468,2,5,4,2,2,1
"Wales",468,2,3,3,3,0,2
"Portugal",471,2,9,10,2,8,1
"Iran",471,2,3,5,7,-2,2
"Spain",474,4,7,4,0,4,1
"Germany",474,4,4,3,4,-1,2
"Belgium",483,8,6,4,2,2,2
"Chile",483,8,6,5,3,2,1
"Spain",485,7,6,4,2,2,2
"Uruguay",485,7,6,5,3,2,1
"Italy",487,3,9,6,2,4,1
"Argentina",487,3,4,4,4,0,2
"Portugal",487,4,5,4,1,3,1
"Japan",487,4,5,4,3,1,2
"Italy",488,8,9,7,2,5,1
"Iran",488,8,3,3,4,-1,2
"Wales",490,7,4,4,4,0,1
"Jamaica",490,7,4,2,2,0,2
"Chile",491,4,6,4,3,1,1
"Mexico",491,4,4,3,3,0,2
"Qatar",494,1,6,2,1,1,1
"Nigeria",494,1,4,3,3,0,2
"Denmark",496,7,4,3,2,1,2
"Iran",496,7,4,5,4,1,1
"England",498,6,6,6,5,1,1
"Tunisia",498,6,6,5,4,1,2
"Mexico",499,5,6,4,4,0,1
"Japan",499,5,4,5,5,0,2
"Brazil",501,3,9,5,0,5,1
"Japan",501,3,2,2,3,-1,2
"France",510,4,5,5,2,3,1
"Croatia",510,4,5,4,1,3,2
"Brazil",513,5,5,4,3,1,2
"Wales",513,5,5,3,1,2,1
"Belgium",513,8,9,6,2,4,1
"Morocco",513,8,2,4,5,-1,2
"Argentina",514,7,6,5,3,2,1
"Jamaica",514,7,6,7,6,1,2
"Qatar",517,1,9,4,1,3,1
"Tunisia",517,1,3,3,4,-1,2
"Spain",517,6,4,3,3,0,2
"Japan",517,6,4,3,2,1,1
"Belgium",519,4,6,5,1,4,1
"Uruguay",519,4,6,5,2,3,2
"Argentina",519,8,5,2,1,1,2
"Italy",519,8,5,3,2,1,1
"Croatia",521,5,5,5,3,2,1
"Switzerland",521,5,5,3,1,2,2
"Nigeria",526,6,6,6,4,2,1
"France",526,6,4,5,5,0,2
"Switzerland",527,2,6,2,3,-1,1
"Korea Republic",527,2,4,6,5,1,2
"France",529,2,5,2,1,1,2
"Colombia",529,2,5,3,2,1,1
"Netherlands",531,8,4,2,1,1,1
"Switzerland",531,8,4,2,2,0,2
"Brazil",532,2,9,8,1,7,1
"Wales",532,2,4,3,3,0,2
"Argentina",533,2,6,4,2,2,2
"Denmark",533,2,6,6,4,2,1
"Argentina",534,7,5,8,5,3,1
"Germany",534,7,5,7,4,3,2
"Italy",538,1,9,9,0,9,1
"Jamaica",538,1,3,3,6,-3,2
"Germany",539,2,5,5,4,1,1
"Japan",539,2,5,4,3,1,2
"Spain",541,5,6,4,2,2,2
"United States",541,5,6,5,3,2,1
"Argentina",541,7,7,5,3,2,1
"Denmark",541,7,4,5,4,1,2
"Argentina",546,7,7,5,1,4,1
"Algeria",546,7,4,3,3,0,2
"Colombia",549,1,6,6,3,3,1
"Wales",549,1,4,6,6,0,2
"Belgium",549,6,5,3,2,1,1
"Switzerland",549,6,5,1,0,1,2
"England",549,7,7,6,3,3,1
"Uruguay",549,7,7,5,2,3,2
"Colombia",552,1,5,4,3,1,1
"Senegal",552,1,5,2,1,1,2
"Morocco",553,1,6,2,1,1,1
"Colombia",553,1,4,2,2,0,2
"Mexico",555,4,7,6,4,2,1
"Brazil",555,4,4,4,4,0,2
"Germany",556,1,9,8,2,6,1
"United States",556,1,3,5,6,-1,2
"France",557,2,4,4,3,1,1
"Uruguay",557,2,4,3,3,0,2
"Italy",560,6,6,3,1,2,2
"Iran",560,6,6,4,2,2,1
"Colombia",561,2,9,5,1,4,1
"England",561,2,3,4,5,-1,2
"Wales",562,1,6,6,4,2,1
"Nigeria",562,1,6,5,3,2,2
"Germany",563,4,5,1,0,1,2
"Switzerland",563,4,5,2,1,1,1
"England",565,8,6,3,1,2,2
"Switzerland",565,8,6,4,2,2,1
"Brazil",566,3,5,3,2,1,1
"Wales",566,3,4,2,2,0,2
"France",566,5,6,3,2,1,2
"Uruguay",566,5,6,6,1,5,1
"Netherlands",568,1,5,5,2,3,1
"Qatar",568,1,4,4,5,-1,2
"Qatar",569,1,5,3,1,2,1
"Denmark",569,1,5,2,0,2,2
"Portugal",572,8,6,6,2,4,2
"Chile",572,8,6,7,3,4,1
"Netherlands",575,1,5,5,3,2,1
"Qatar",575,1,4,4,4,0,2
"Portugal",575,4,6,5,1,4,1
"Croatia",575,4,6,4,4,0,2
"Senegal",576,8,4,3,3,0,2
"Costa Rica",576,8,4,4,3,1,1
"Argentina",577,4,5,3,1,2,1
"Japan",577,4,5,5,4,1,2
"Qatar",580,1,9,7,2,5,1
"Senegal",580,1,4,3,3,0,2
"Algeria",580,6,9,4,1,3,1
"England",580,6,3,2,3,-1,2
"England",582,3,6,7,4,3,1
"Colombia",582,3,6,5,2,3,2
"Belgium",586,4,7,9,4,5,2
"Denmark",586,4,7,10,5,5,1
"Switzerland",587,1,6,4,2,2,2
"Costa Rica",587,1,6,6,4,2,1
"Argentina",588,2,6,4,3,1,2
"Switzerland",588,2,6,5,4,1,1
"France",589,4,7,4,2,2,1
"Tunisia",589,4,4,3,3,0,2
"Mexico",591,6,9,4,0,4,1
"Chile",591,6,4,3,2,1,2
"Korea Republic",592,8,5,4,3,1,1
"Senegal",592,8,4,3,3,0,2
"Uruguay",594,1,5,2,1,1,2
"United States",594,1,5,3,2,1,1
"Portugal",595,6,9,8,2,6,1
"Switzerland",595,6,4,4,3,1,2
"Qatar",596,1,7,6,3,3,1
"Germany",596,1,7,5,2,3,2
"Spain",597,6,7,6,3,3,1
"Italy",597,6,7,5,2,3,2
"Denmark",599,1,6,9,4,5,1
"Costa Rica",599,1,4,5,4,1,2
"Iran",599,6,6,3,1,2,1
"Portugal",599,6,4,3,3,0,2
"Brazil",604,7,5,4,2,2,1
"Wales",604,7,4,5,5,0,2
"Uruguay",605,1,5,2,1,1,2
"United States",605,1,5,3,2,1,1
"Belgium",606,5,6,11,8,3,1
"Chile",606,5,6,8,5,3,2
"Wales",609,1,5,6,4,2,1
"Morocco",609,1,5,4,2,2,2
"France",612,3,5,1,0,1,2
"Uruguay",612,3,5,4,3,1,1
"Portugal",612,4,5,3,1,2,2
"Mexico",612,4,5,4,2,2,1
"England",615,2,7,5,0,5,2
"Korea Republic",615,2,7,6,1,5,1
"England",618,3,9,6,0,6,1
"Colombia",618,3,4,3,3,0,2
"Germany",621,6,5,5,0,5,1
"Morocco",621,6,4,4,4,0,2
"Portugal",621,7,5,4,1,3,2
"Uruguay",621,7,5,5,2,3,1
"Brazil",622,7,6,7,3,4,1
"Italy",622,7,6,6,2,4,2
"Chile",625,5,5,5,4,1,1
"Mexico",625,5,4,6,6,0,2
"France",626,5,6,7,5,2,1
"Australia",626,5,4,3,4,-1,2
"Qatar",630,1,6,6,3,3,1
"Germany",630,1,6,6,5,1,2
"Argentina",633,6,5,4,3,1,2
"Germany",633,6,5,5,4,1,1
"Switzerland",638,6,6,3,1,2,2
"Algeria",638,6,6,4,2,2,1
"Belgium",640,3,9,4,0,4,1
"Morocco",640,3,2,3,4,-1,2
"Spain",642,2,6,3,1,2,1
"Wales",642,2,4,3,3,0,2
"Brazil",644,7,6,6,3,3,1
"Iran",644,7,6,6,5,1,2
"Colombia",646,7,7,4,1,3,1
"United States",646,7,7,3,0,3,2
"France",648,4,9,7,2,5,1
"Wales",648,4,4,6,5,1,2
"Korea Republic",648,6,5,4,3,1,1
"Uruguay",648,6,4,7,7,0,2
"Spain",649,8,7,4,0,4,2
"Colombia",649,8,7,5,1,4,1
"Colombia",650,7,6,3,2,1,1
"United States",650,7,4,3,3,0,2
"Poland",652,4,7,5,3,2,1
"Colombia",652,4,4,4,4,0,2
"Chile",655,5,5,2,1,1,1
"Belgium",655,5,4,4,4,0,2
"Brazil",659,4,5,4,3,1,2
"Switzerland",659,4,5,5,4,1,1
"Germany",661,3,5,3,2,1,1
"Spain",661,3,4,3,3,0,2
"Brazil",664,2,9,6,2,4,1
"Korea Republic",664,2,4,5,5,0,2
"Argentina",665,2,5,4,3,1,1
"Tunisia",665,2,5,3,2,1,2
"Portugal",666,7,6,3,1,2,2
"United States",666,7,6,4,2,2,1
"Belgium",667,5,9,10,1,9,1
"Netherlands",667,5,3,4,6,-2,2
"Belgium",668,3,9,8,0,8,1
"Tunisia",668,3,3,2,4,-2,2
"Qatar",672,1,6,7,3,4,1
"Colombia",672,1,6,5,4,1,2
"Belgium",672,4,6,9,2,7,1
"Japan",672,4,6,6,4,2,2
"Netherlands",674,3,6,7,2,5,1
"Portugal",674,3,4,5,5,0,2
"Croatia",674,6,6,5,5,0,2
"Japan",674,6,6,7,1,6,1
"Belgium",676,7,4,3,3,0,2
"Algeria",676,7,4,5,4,1,1
"Italy",681,1,7,5,2,3,1
"Chile",681,1,4,4,4,0,2
"Argentina",681,5,5,3,1,2,2
"Denmark",681,5,5,7,2,5,1
"Colombia",681,6,7,3,1,2,1
"Nigeria",681,6,7,2,0,2,2
"Argentina",686,3,9,6,2,4,1
"Netherlands",686,3,4,7,6,1,2
"Brazil",686,4,6,5,3,2,2
"Mexico",686,4,6,6,4,2,1
"Germany",689,2,9,3,0,3,1
"Iran",689,2,3,4,5,-1,2
"Mexico",694,4,4,4,4,0,2
"Japan",694,4,4,3,2,1,1
"Brazil",694,5,7,5,2,3,1
"Iran",694,5,4,2,2,0,2
"Portugal",697,2,6,3,1,2,1
"Wales",697,2,4,2,2,0,2
"England",697,8,5,4,1,3,1
"Mexico",697,8,5,3,0,3,2
"England",700,6,6,4,2,2,1
"Colombia",700,6,4,4,4,0,2
"Spain",705,3,6,4,2,2,2
"Poland",705,3,6,6,4,2,1
"Australia",707,4,6,4,2,2,1
"Argentina",707,4,4,5,5,0,2
"Poland",709,1,4,3,2,1,2
"Nigeria",709,1,4,4,3,1,1
"France",715,5,6,3,1,2,2
"Netherlands",715,5,6,4,2,2,1
"Portugal",716,8,6,4,2,2,1
"Germany",716,8,6,6,5,1,2
"Argentina",722,4,7,4,2,2,1
"Mexico",722,4,7,3,1,2,2
"Portugal",722,5,6,3,2,1,1
"Italy",722,5,4,3,3,0,2
"Germany",732,1,6,6,4,2,1
"Qatar",732,1,4,5,5,0,2
"Argentina",738,7,7,7,3,4,2
"Poland",738,7,7,8,4,4,1
"England",739,2,6,6,2,4,1
"Japan",739,2,6,7,5,2,2
"Portugal",740,8,5,5,3,2,2
"Uruguay",740,8,5,6,4,2,1
"France",741,2,7,9,5,4,1
"Senegal",741,2,7,8,4,4,2
"Argentina",742,2,4,5,3,2,1
"Croatia",742,2,4,4,4,0,2
"Brazil",742,5,9,5,0,5,1
"Italy",742,5,2,3,4,-1,2
"Belgium",744,7,6,3,1,2,2
"Costa Rica",744,7,6,5,3,2,1
"Argentina",745,3,6,4,3,1,1
"United States",745,3,6,3,2,1,2
"Portugal",747,3,9,5,1,4,1
"Uruguay",747,3,2,2,3,-1,2
"England",749,3,6,6,3,3,1
"Germany",749,3,6,5,2,3,2
"Uruguay",750,1,5,4,2,2,2
"Costa Rica",750,1,5,5,3,2,1
"England",750,4,7,7,1,6,2
"Chile",750,4,7,9,3,6,1
"Portugal",753,8,5,3,2,1,2
"Wales",753,8,5,5,4,1,1
"Brazil",754,5,7,4,2,2,1
"Switzerland",754,5,4,5,4,1,2
"Portugal",754,8,9,8,1,7,1
"United States",754,8,3,3,5,-2,2
"France",757,3,6,5,3,2,1
"Poland",757,3,6,6,5,1,2
"Chile",758,4,5,7,5,2,1
"France",758,4,4,4,4,0,2
"Belgium",759,6,5,6,4,2,1
"Germany",759,6,5,3,1,2,2
"France",760,6,6,5,2,3,1
"Senegal",760,6,6,4,1,3,2
"Belgium",761,4,6,8,5,3,1
"Poland",761,4,6,9,7,2,2
"Switzerland",764,2,6,2,1,1,1
"Iran",764,2,4,3,3,0,2
"Italy",768,2,5,2,1,1,1
"Poland",768,2,4,2,2,0,2
"Brazil",768,4,9,9,2,7,1
"Japan",768,4,3,3,5,-2,2
"United States",770,6,5,4,2,2,1
"Australia",770,6,4,6,6,0,2
"France",771,3,5,2,0,2,2
"Korea Republic",771,3,5,3,1,2,1
"Netherlands",772,1,7,6,3,3,1
"Switzerland",772,1,7,5,2,3,2
"Japan",772,2,5,2,1,1,1
"Brazil",772,2,4,4,4,0,2
"Netherlands",773,2,5,5,4,1,1
"United States",773,2,5,2,1,1,2
"Qatar",774,1,5,4,3,1,1
"Uruguay",774,1,4,3,3,0,2
"England",775,7,5,3,2,1,1
"Algeria",775,7,5,2,1,1,2
"Qatar",778,1,6,4,2,2,1
"Croatia",778,1,6,3,1,2,2
"Colombia",782,7,5,2,1,1,1
"United States",782,7,4,3,4,-1,2
"Colombia",783,1,6,7,3,4,1
"Wales",783,1,6,6,5,1,2
"Brazil",783,7,6,4,2,2,2
"Switzerland",783,7,6,5,3,2,1
"Spain",789,5,9,10,1,9,1
"Nigeria",789,5,4,4,5,-1,2
"Portugal",793,2,6,4,4,0,1
"Chile",793,2,6,2,2,0,2
"Belgium",794,8,7,5,1,4,1
"Mexico",794,8,7,4,0,4,2
"Belgium",795,8,6,3,1,2,2
"Switzerland",795,8,6,5,3,2,1
"Brazil",798,7,9,8,3,5,1
"Italy",798,7,4,5,4,1,2
"Brazil",799,5,5,5,3,2,2
"Croatia",799,5,5,6,4,2,1
"France",799,7,9,7,0,7,1
"Japan",799,7,3,4,5,-1,2
"England",799,8,5,2,1,1,2
"Korea Republic",799,8,5,3,2,1,1
"France",801,8,9,8,1,7,1
"Switzerland",801,8,3,4,6,-2,2
"Croatia",804,1,6,4,3,1,1
"Switzerland",804,1,4,4,4,0,2
"Mexico",805,1,6,3,1,2,1
"Morocco",805,1,4,2,2,0,2
"Spain",805,4,9,9,1,8,1
"Denmark",805,4,3,4,5,-1,2
"Qatar",806,1,9,4,0,4,1
"Wales",806,1,4,5,4,1,2
"Netherlands",809,3,9,5,2,3,1
"Spain",809,3,3,4,4,0,2
"France",809,4,7,3,1,2,1
"Switzerland",809,4,4,7,6,1,2
"Colombia",810,1,5,4,2,2,2
"Wales",810,1,5,5,3,2,1
"Italy",812,2,5,5,3,2,1
"Australia",812,2,4,4,4,0,2
"Argentina",812,7,7,6,2,4,1
"Tunisia",812,7,4,5,6,-1,2
"France",816,3,7,6,1,5,1
"United States",816,3,4,3,4,-1,2
"Brazil",816,6,6,2,1,1,2
"Poland",816,6,6,4,3,1,1
"Switzerland",820,1,7,5,2,3,1
"Croatia",820,1,4,4,4,0,2
"Switzerland",821,6,6,3,2,1,1
"England",821,6,4,2,2,0,2
"Japan",822,2,6,5,3,2,1
"Germany",822,2,4,5,4,1,2
"Switzerland",828,7,7,6,2,4,1
"Portugal",828,7,4,4,5,-1,2
"Qatar",831,1,7,3,1,2,1
"Algeria",831,1,4,4,4,0,2
"Netherlands",832,6,6,8,7,1,1
"Belgium",832,6,4,4,4,0,2
"Senegal",836,1,5,2,1,1,1
"Qatar",836,1,4,2,2,0,2
"Mexico",837,5,6,5,1,4,1
"Korea Republic",837,5,4,2,2,0,2
"France",842,6,7,8,3,5,1
"Australia",842,6,7,6,1,5,2
"Uruguay",843,1,6,4,3,1,1
"Qatar",843,1,4,5,5,0,2
"Spain",843,7,7,6,2,4,1
"Australia",843,7,4,4,4,0,2
"Netherlands",844,7,4,3,2,1,1
"Costa Rica",844,7,4,2,2,0,2
"Brazil",845,2,9,6,1,5,1
"Australia",845,2,4,3,4,-1,2
"Colombia",845,7,7,5,1,4,1
"Spain",845,7,4,3,4,-1,2
"England",847,7,5,6,5,1,1
"United States",847,7,4,3,3,0,2
"Croatia",849,1,7,4,2,2,1
"Chile",849,1,7,2,0,2,2
"Argentina",849,4,6,4,3,1,2
"Poland",849,4,6,5,3,2,1
"Brazil",850,8,6,6,5,1,1
"Mexico",850,8,6,5,4,1,2
"Portugal",854,5,5,7,5,2,1
"Germany",854,5,5,6,4,2,2
"France",855,2,7,5,2,3,1
"Denmark",855,2,7,4,1,3,2
"Brazil",856,7,9,5,1,4,1
"Denmark",856,7,4,4,4,0,2
"Denmark",857,8,9,8,2,6,1
"Switzerland",857,8,4,3,4,-1,2
"England",861,6,6,7,5,2,1
"Uruguay",861,6,6,4,2,2,2
"Argentina",865,2,6,7,4,3,1
"Netherlands",865,2,6,6,3,3,2
"Uruguay",868,3,5,3,2,1,1
"Poland",868,3,5,2,1,1,2
"Poland",869,4,6,3,2,1,1
"Netherlands",869,4,4,3,3,0,2
"France",873,2,6,7,4,3,1
"Iran",873,2,6,5,2,3,2
"Denmark",877,1,9,5,0,5,1
"United States",877,1,3,4,5,-1,2
"Qatar",878,1,5,5,3,2,1
"Croatia",878,1,5,4,2,2,2
"Uruguay",878,2,5,3,2,1,1
"Japan",878,2,4,2,2,0,2
"England",878,5,7,6,1,5,1
"Colombia",878,5,7,5,0,5,2
"Argentina",879,5,9,5,1,4,1
"Nigeria",879,5,3,2,3,-1,2
"Portugal",879,8,7,3,1,2,1
"Poland",879,8,4,5,5,0,2
"Portugal",880,4,9,4,0,4,1
"Netherlands",880,4,4,3,2,1,2
"Netherlands",882,1,7,5,3,2,1
"Senegal",882,1,7,4,2,2,2
"Chile",883,1,9,7,2,5,1
"Qatar",883,1,3,3,4,-1,2
"Argentina",884,3,5,4,3,1,1
"United States",884,3,4,4,4,0,2
"Brazil",885,3,6,5,2,3,1
"Mexico",885,3,6,5,3,2,2
"Spain",889,3,5,4,2,2,1
"Iran",889,3,3,3,3,0,2
"Germany",890,7,5,5,2,3,1
"Iran",890,7,5,4,3,1,2
"France",890,8,6,4,2,2,1
"United States",890,8,4,4,4,0,2
"Nigeria",893,1,5,2,1,1,1
"Uruguay",893,1,4,4,3,1,2
"Portugal",894,8,9,7,0,7,1
"Colombia",894,8,4,6,6,0,2
"Argentina",895,3,7,9,5,4,1
"Mexico",895,3,7,8,4,4,2
"Netherlands",895,6,6,4,2,2,1
"Poland",895,6,6,4,3,1,2
"United States",896,4,6,5,4,1,1
"Netherlands",896,4,4,3,3,0,2
"Portugal",897,6,6,4,2,2,1
"Korea Republic",897,6,4,6,6,0,2
"Belgium",900,8,6,4,2,2,1
"Croatia",900,8,6,3,1,2,2
"Argentina",902,5,6,4,2,2,1
"Mexico",902,5,6,4,3,1,2
"England",905,6,5,4,3,1,1
"Uruguay",905,6,5,3,2,1,2
"Argentina",905,7,5,4,3,1,2
"Mexico",905,7,5,5,4,1,1
"Portugal",906,3,9,5,0,5,1
"Nigeria",906,3,3,3,4,-1,2
"Uruguay",912,5,6,2,1,1,1
"Japan",912,5,4,3,3,0,2
"Belgium",913,7,7,7,2,5,1
"Uruguay",913,7,7,6,1,5,2
"Italy",917,2,6,5,3,2,1
"Chile",917,2,6,8,7,1,2
"Brazil",917,6,5,3,2,1,1
"Korea Republic",917,6,5,2,1,1,2
"Uruguay",922,1,7,2,0,2,1
"Qatar",922,1,4,4,4,0,2
"Portugal",925,7,5,5,4,1,1
"Poland",925,7,5,3,2,1,2
"Qatar",926,1,4,5,3,2,1
"Wales",926,1,4,6,6,0,2
"France",926,8,5,2,1,1,2
"Mexico",926,8,5,3,2,1,1
"Belgium",927,2,7,4,1,3,1
"Italy",927,2,7,3,0,3,2
"France",927,6,5,4,2,2,1
"Senegal",927,6,5,3,1,2,2
"Argentina",930,4,6,4,4,0,1
"Mexico",930,4,4,4,3,1,2
"Belgium",930,8,5,5,2,3,1
"Switzerland",930,8,3,3,3,0,2
"France",931,2,5,5,4,1,1
"Chile",931,2,3,2,2,0,2
"Portugal",931,6,6,4,3,1,2
"Croatia",931,6,6,4,2,2,1
"Brazil",932,3,5,7,3,4,1
"Croatia",932,3,3,3,3,0,2
"France",933,8,6,3,1,2,1
"Netherlands",933,8,4,3,3,0,2
"England",934,7,5,3,2,1,1
"Switzerland",934,7,5,1,0,1,2
"Costa Rica",936,1,9,8,3,5,1
"Germany",936,1,3,3,4,-1,2
"France",936,3,5,3,1,2,2
"Italy",936,3,5,4,2,2,1
"France",939,6,6,6,4,2,2
"Colombia",939,6,6,7,4,3,1
"England",944,5,7,3,0,3,2
"Uruguay",944,5,7,5,2,3,1
"Netherlands",945,4,9,5,2,3,1
"Australia",945,4,2,5,6,-1,2
"Wales",945,7,6,3,2,1,1
"Brazil",945,7,4,3,3,0,2
"Uruguay",947,1,9,7,3,4,1
"Algeria",947,1,3,6,5,1,2
"Argentina",949,5,6,5,2,3,1
"Wales",949,5,4,3,5,-2,2
"Netherlands",951,1,6,3,1,2,1
"Qatar",951,1,4,4,4,0,2
"Spain",952,8,6,2,1,1,2
"Algeria",952,8,6,3,2,1,1
"Argentina",953,2,7,4,2,2,2
"Germany",953,2,7,6,4,2,1
"Brazil",953,8,6,4,2,2,2
"Jamaica",953,8,6,5,3,2,1
"Uruguay",954,1,5,5,4,1,1
"Nigeria",954,1,5,4,3,1,2
"Belgium",954,6,5,4,1,3,1
"Mexico",954,6,4,2,2,0,2
"Argentina",955,3,7,4,1,3,2
"United States",955,3,7,5,2,3,1
"Uruguay",955,4,9,4,1,3,1
"England",955,4,4,2,2,0,2
"Brazil",958,5,9,10,4,6,1
"Mexico",958,5,4,4,4,0,2
"France",960,2,7,6,1,5,1
"Italy",960,2,4,5,5,0,2
"Italy",961,8,5,4,2,2,1
"Wales",961,8,5,3,1,2,2
"Jamaica",964,1,6,5,3,2,1
"Uruguay",964,1,4,2,2,0,2
"Belgium",967,8,9,6,2,4,1
"Croatia",967,8,4,5,5,0,2
"Qatar",970,1,5,4,3,1,1
"Netherlands",970,1,5,2,1,1,2
"Mexico",970,4,5,3,2,1,2
"Chile",970,4,5,4,3,1,1
"Portugal",971,7,7,3,1,2,2
"Iran",971,7,7,4,2,2,1
"Qatar",974,1,7,5,2,3,1
"Germany",974,1,4,4,4,0,2
"Brazil",974,2,4,4,2,2,1
"Nigeria",974,2,4,5,5,0,2
"Italy",974,4,6,4,2,2,1
"Chile",974,4,6,5,4,1,2
"Croatia",975,2,6,5,3,2,1
"Iran",975,2,6,3,1,2,2
"Spain",977,7,7,3,0,3,2
"Wales",977,7,7,4,1,3,1
"Mexico",979,8,7,7,1,6,1
"Australia",979,8,4,4,5,-1,2
"Spain",980,4,5,3,2,1,2
"Uruguay",980,4,5,4,3,1,1
"Belgium",983,7,6,4,2,2,1
"Netherlands",983,7,4,4,5,-1,2
"Germany",984,3,6,3,2,1,2
"Poland",984,3,6,4,3,1,1
"Belgium",984,6,9,7,1,6,1
"Uruguay",984,6,2,3,4,-1,2
"Germany",985,1,5,5,4,1,1
"Algeria",985,1,5,4,3,1,2
"Qatar",986,1,5,2,1,1,2
"United States",986,1,5,3,2,1,1
"Algeria",987,4,5,3,2,1,1
"Wales",987,4,4,4,4,0,2
"Denmark",988,1,5,2,1,1,1
"Wales",988,1,4,6,5,1,2
"Belgium",992,6,6,8,5,3,1
"Germany",992,6,6,7,4,3,2
"Portugal",996,8,7,3,0,3,2
"Croatia",996,8,7,4,1,3,1
"Germany",998,1,5,4,3,1,1
"Chile",998,1,5,3,2,1,2
"Wales",1000,7,6,5,4,1,1
"Korea Republic",1000,7,6,4,3,1,2
"Colombia",8,1,6,5,3,2,1
"Qatar",8,1,6,5,3,2,2
"England",8,7,4,4,4,0,2
"Iran",8,7,5,4,3,1,1
"Colombia",9,4,5,3,2,1,1
"England",9,4,5,3,2,1,2
"Australia",27,4,3,2,2,0,1
"Croatia",27,4,3,1,1,0,2
"Denmark",30,4,6,7,3,4,1
"Wales",30,4,6,7,3,4,2
"Qatar",32,1,4,2,2,0,2
"Uruguay",32,1,7,4,2,2,1
"England",42,4,4,3,2,1,2
"Italy",42,4,5,3,1,2,1
"Australia",45,5,4,4,3,1,2
"United States",45,5,9,5,2,3,1
"Belgium",46,7,3,2,3,-1,2
"Germany",46,7,9,5,1,4,1
"Argentina",47,6,4,4,3,1,2
"Costa Rica",47,6,7,5,3,2,1
"Qatar",48,1,6,2,1,1,1
"Senegal",48,1,4,2,2,0,2
"Denmark",48,8,4,5,5,0,1
"England",48,8,4,5,5,0,2
"Netherlands",53,6,9,6,1,5,1
"Nigeria",53,6,3,2,3,-1,2
"Colombia",54,2,4,4,4,0,2
"France",54,2,9,8,3,5,1
"Denmark",56,3,6,4,4,0,1
"Senegal",56,3,6,4,4,0,2
"Argentina",57,3,5,5,4,1,1
"Mexico",57,3,5,5,4,1,2
"Croatia",63,6,6,3,2,1,1
"Jamaica",63,6,6,3,2,1,2
"Qatar",65,1,7,4,2,2,1
"United States",65,1,4,2,2,0,2
"Denmark",68,2,4,3,4,-1,2
"Portugal",68,2,9,5,0,5,1
"Italy",69,4,3,2,2,0,2
"United States",69,4,5,4,3,1,1
"Chile",70,8,6,4,2,2,1
"Portugal",70,8,6,4,2,2,2
"Germany",84,1,9,5,1,4,1
"Nigeria",84,1,2,2,3,-1,2
"Brazil",85,5,5,4,2,2,1
"Denmark",85,5,3,1,1,0,2
"Argentina",97,2,7,5,2,3,1
"Nigeria",97,2,7,5,2,3,2
"Belgium",102,7,6,5,2,3,1
"Colombia",102,7,6,5,2,3,2
"France",104,3,4,4,3,1,2
"Japan",104,3,6,5,5,0,1
"Brazil",105,3,9,7,1,6,1
"Croatia",105,3,3,2,3,-1,2
"England",106,7,7,3,0,3,1
"Germany",106,7,7,3,0,3,2
"Croatia",108,8,4,2,3,-1,2
"England",108,8,9,7,2,5,1
"Costa Rica",110,7,6,3,4,-1,1
"England",110,7,4,2,2,0,2
"Japan",112,2,4,3,3,0,1
"Nigeria",112,2,4,3,3,0,2
"Algeria",115,2,4,2,3,-1,2
"Brazil",115,2,9,8,2,6,1
"Algeria",117,2,4,3,3,0,2
"Belgium",117,2,9,6,0,6,1
"Chile",120,7,5,4,2,2,2
"France",120,7,5,5,3,2,1
"Argentina",120,8,5,5,2,3,1
"Japan",120,8,4,3,3,0,2
"Mexico",125,1,7,5,1,4,1
"Morocco",125,1,7,5,1,4,2
"Colombia",126,7,6,7,7,0,2
"Spain",126,7,6,10,4,6,1
"Belgium",135,3,3,0,0,0,2
"Netherlands",135,3,5,3,2,1,1
"Belgium",137,5,4,1,1,0,2
"Italy",137,5,6,2,1,1,1
"Algeria",143,7,7,4,2,2,1
"Spain",143,7,7,4,2,2,2
"Colombia",144,5,2,0,1,-1,2
"Spain",144,5,9,7,0,7,1
"Australia",154,5,6,4,3,1,1
"Italy",154,5,6,4,3,1,2
"Denmark",156,1,5,4,3,1,1
"Qatar",156,1,5,4,3,1,2
"Croatia",159,3,5,3,2,1,1
"Japan",159,3,5,3,2,1,2
"Costa Rica",160,5,4,4,4,0,2
"Uruguay",160,5,7,4,1,3,1
"France",161,7,7,6,2,4,1
"Japan",161,7,4,3,4,-1,2
"France",162,8,7,5,1,4,1
"Uruguay",162,8,7,5,1,4,2
"Brazil",165,4,7,4,0,4,1
"Korea Republic",165,4,4,2,2,0,2
"Germany",165,8,5,3,2,1,1
"Portugal",165,8,5,3,2,1,2
"Argentina",166,7,6,3,1,2,1
"Germany",166,7,4,1,2,-1,2
"England",167,8,6,5,4,1,1
"Germany",167,8,4,6,5,1,2
"Croatia",168,3,3,2,3,-1,2
"Japan",168,3,9,4,0,4,1
"Australia",168,8,5,2,1,1,1
"Portugal",168,8,5,2,1,1,2
"Australia",170,3,4,1,1,0,2
"Brazil",170,3,5,4,2,2,1
"England",180,2,5,5,2,3,1
"Italy",180,2,5,5,2,3,2
"Croatia",181,7,4,5,2,3,2
"Jamaica",181,7,6,5,6,-1,1
"Denmark",184,5,7,7,2,5,1
"France",184,5,7,7,2,5,2
"Costa Rica",185,3,5,4,2,2,1
"Italy",185,3,5,4,2,2,2
"Colombia",190,3,6,4,4,0,1
"Poland",190,3,6,4,4,0,2
"Algeria",201,8,4,2,2,0,2
"Belgium",201,8,7,5,2,3,1
"Colombia",211,8,6,5,3,2,1
"United States",211,8,6,5,3,2,2
"Chile",213,6,4,4,4,0,2
"Germany",213,6,6,3,2,1,1
"Belgium",218,6,7,5,3,2,1
"Netherlands",218,6,4,4,4,0,2
"Australia",219,6,6,3,2,1,1
"Poland",219,6,6,3,2,1,2
"Brazil",239,2,5,2,1,1,2
"Germany",239,2,5,5,2,3,1
"Australia",244,4,4,1,1,0,2
"Colombia",244,4,5,3,0,3,1
"Korea Republic",246,2,4,4,2,2,2
"Wales",246,2,7,5,3,2,1
"England",253,4,3,5,7,-2,2
"Italy",253,4,9,7,0,7,1
"Portugal",260,2,7,2,0,2,1
"Senegal",260,2,7,2,0,2,2
"Australia",279,3,7,5,2,3,1
"England",279,3,4,4,4,0,2
"England",291,2,4,3,3,0,2
"United States",291,2,7,4,1,3,1
"Germany",293,4,3,3,4,-1,2
"Portugal",293,4,9,6,0,6,1
"England",297,3,4,1,1,0,2
"Iran",297,3,5,2,1,1,1
"Brazil",300,3,7,3,0,3,1
"Switzerland",300,3,7,3,0,3,2
"Colombia",300,8,6,3,2,1,1
"England",300,8,4,3,3,0,2
"Algeria",303,5,6,2,4,-2,1
"Netherlands",303,5,4,2,2,0,2
"Australia",304,6,4,2,2,0,2
"Belgium",304,6,7,5,2,3,1
"Japan",310,2,9,7,4,3,1
"Mexico",310,2,2,3,4,-1,2
"Brazil",312,3,5,3,1,2,1
"Italy",312,3,3,2,2,0,2
"Argentina",312,4,4,6,4,2,1
"Netherlands",312,4,4,5,3,2,2
"Algeria",312,6,4,3,3,0,2
"Switzerland",312,6,4,2,1,1,1
"Qatar",313,1,4,3,3,0,2
"Tunisia",313,1,7,4,2,2,1
"Colombia",315,6,6,4,1,3,1
"Morocco",315,6,4,2,3,-1,2
"Australia",322,3,5,3,2,1,1
"Senegal",322,3,5,3,2,1,2
"Mexico",323,7,4,5,5,0,1
"Switzerland",323,7,4,5,5,0,2
"Belgium",327,7,6,2,1,1,2
"Wales",327,7,6,4,1,3,1
"Australia",328,2,5,3,2,1,1
"Germany",328,2,5,3,2,1,2
"England",341,4,4,3,3,0,1
"Poland",341,4,4,3,3,0,2
"Colombia",342,1,6,4,2,2,1
"Qatar",342,1,6,4,2,2,2
"Australia",347,6,2,2,4,-2,2
"Denmark",347,6,9,7,1,6,1
"Belgium",354,4,7,6,2,4,1
"Japan",354,4,7,6,2,4,2
"Brazil",355,3,7,4,1,3,1
"Mexico",355,3,7,4,1,3,2
"Belgium",359,8,7,7,3,4,1
"Uruguay",359,8,7,7,3,4,2
"Mexico",362,5,7,4,1,3,1
"Spain",362,5,7,4,1,3,2
"England",362,7,4,5,4,1,2
"Netherlands",362,7,9,5,2,3,1
"Switzerland",363,1,6,5,3,2,1
"Uruguay",363,1,6,5,3,2,2
"Colombia",367,6,2,4,5,-1,2
"England",367,6,9,5,1,4,1
"Iran",370,6,5,4,1,3,1
"Spain",370,6,5,4,1,3,2
"Australia",372,6,4,3,3,0,2
"England",372,6,6,6,5,1,1
"England",378,8,3,4,4,0,1
"Poland",378,8,3,4,4,0,2
"Algeria",380,7,3,2,3,-1,2
"Netherlands",380,7,9,6,0,6,1
"Australia",384,5,4,3,3,0,2
"Belgium",384,5,5,4,2,2,1
"Chile",387,7,4,3,2,1,1
"France",387,7,4,5,4,1,2
"Italy",406,1,4,3,3,0,2
"Qatar",406,1,7,5,3,2,1
"Chile",407,5,4,4,3,1,1
"Netherlands",407,5,4,4,3,1,2
"Brazil",413,8,5,5,3,2,1
"Wales",413,8,5,5,3,2,2
"Argentina",415,3,5,2,1,1,1
"Jamaica",415,3,5,2,1,1,2
"Argentina",417,6,7,3,0,3,1
"Germany",417,6,7,3,0,3,2
"Italy",418,2,6,4,2,2,1
"Switzerland",418,2,6,4,2,2,2
"Belgium",422,4,6,4,1,3,1
"Germany",422,4,6,3,1,2,2
"Chile",424,8,5,4,2,2,2
"France",424,8,5,5,2,3,1
"Australia",425,6,6,3,2,1,1
"Germany",425,6,6,3,2,1,2
"Argentina",427,3,9,6,0,6,1
"Korea Republic",427,3,3,5,6,-1,2
"England",430,5,7,5,2,3,1
"Iran",430,5,4,3,3,0,2
"France",431,8,5,3,2,1,1
"Switzerland",431,8,5,3,2,1,2
"Chile",433,4,6,4,3,1,2
"France",433,4,6,6,5,1,1
"Colombia",436,2,5,4,1,3,1
"Portugal",436,2,5,4,1,3,2
"Spain",452,7,6,4,3,1,1
"Tunisia",452,7,6,4,3,1,2
"England",462,3,6,5,3,2,1
"Uruguay",462,3,6,5,3,2,2
"Netherlands",464,7,7,7,4,3,1
"Portugal",464,7,7,7,4,3,2
"Portugal",468,3,4,4,4,0,2
"Uruguay",468,3,9,9,4,5,1
"Netherlands",469,2,4,3,3,0,1
"Senegal",469,2,4,3,3,0,2
"Denmark",473,5,2,2,3,-1,2
"Spain",473,5,9,10,3,7,1
"Argentina",475,7,4,5,5,0,2
"Croatia",475,7,4,6,6,0,1
"Costa Rica",476,4,4,2,2,0,2
"England",476,4,7,3,1,2,1
"Netherlands",478,7,6,6,3,3,1
"Senegal",478,7,6,6,3,3,2
"Argentina",481,4,6,5,2,3,1
"Germany",481,4,6,6,5,1,2
"Argentina",484,5,5,2,1,1,1
"Korea Republic",484,5,5,2,1,1,2
"Argentina",493,7,4,3,3,0,2
"Wales",493,7,5,4,3,1,1
"Colombia",501,5,6,3,2,1,1
"England",501,5,6,3,2,1,2
"Brazil",504,3,6,6,5,1,2
"Japan",504,3,6,7,3,4,1
"Algeria",506,8,5,2,1,1,1
"France",506,8,4,3,3,0,2
"Chile",509,8,5,3,1,2,1
"Mexico",509,8,5,3,1,2,2
"Argentina",527,5,3,3,3,0,2
"Italy",527,5,5,6,4,2,1
"Chile",528,4,5,5,4,1,1
"Mexico",528,4,5,5,4,1,2
"Germany",531,1,5,2,1,1,1
"Qatar",531,1,5,2,1,1,2
"Belgium",535,6,5,3,2,1,1
"Nigeria",535,6,4,3,3,0,2
"England",537,7,4,4,4,0,2
"Germany",537,7,7,4,1,3,1
"France",538,3,9,5,1,4,1
"Mexico",538,3,3,3,4,-1,2
"Belgium",542,7,4,5,5,0,2
"Germany",542,7,9,8,2,6,1
"Chile",553,7,6,5,2,3,1
"England",553,7,6,3,2,1,2
"Brazil",556,3,9,7,1,6,1
"Croatia",556,3,3,4,6,-2,2
"Belgium",557,7,6,6,4,2,1
"Morocco",557,7,6,6,4,2,2
"Brazil",563,7,9,6,3,3,1
"Denmark",563,7,4,4,4,0,2
"Croatia",564,2,4,5,5,0,2
"France",564,2,9,5,1,4,1
"England",572,5,5,5,2,3,1
"Germany",572,5,3,1,1,0,2
"Nigeria",574,1,4,4,3,1,1
"Poland",574,1,4,2,2,0,2
"England",576,4,5,2,1,1,1
"Morocco",576,4,5,2,1,1,2
"England",586,6,4,3,2,1,2
"Japan",586,6,9,4,0,4,1
"England",593,2,6,3,1,2,1
"Uruguay",593,2,6,3,1,2,2
"England",599,8,4,4,5,-1,2
"Uruguay",599,8,4,6,2,4,1
"Spain",600,6,6,6,2,4,1
"Uruguay",600,6,6,2,1,1,2
"Argentina",604,6,4,3,3,0,1
"Senegal",604,6,4,3,3,0,2
"England",610,2,6,5,4,1,2
"Netherlands",610,2,6,6,2,4,1
"Croatia",612,7,6,4,3,1,1
"Morocco",612,7,6,4,3,1,2
"Mexico",614,1,4,2,2,0,2
"Nigeria",614,1,4,3,2,1,1
"Belgium",616,2,4,3,2,1,2
"Korea Republic",616,2,6,4,2,2,1
"Japan",625,3,4,4,4,0,2
"Spain",625,3,5,4,2,2,1
"Colombia",627,3,6,5,3,2,1
"France",627,3,6,5,3,2,2
"Argentina",627,7,7,4,1,3,1
"Netherlands",627,7,7,4,1,3,2
"Denmark",632,6,4,4,4,0,2
"Portugal",632,6,7,5,1,4,1
"Algeria",634,1,6,5,4,1,1
"Poland",634,1,6,5,4,1,2
"Chile",636,6,6,4,3,1,1
"Denmark",636,6,4,4,4,0,2
"Croatia",637,1,4,4,4,0,1
"Poland",637,1,4,4,4,0,2
"Australia",644,5,3,2,3,-1,2
"France",644,5,9,7,1,6,1
"France",647,3,5,3,2,1,1
"Netherlands",647,3,5,3,2,1,2
"Germany",650,6,7,7,3,4,1
"Portugal",650,6,7,7,3,4,2
"Spain",660,6,5,4,2,2,1
"Uruguay",660,6,5,4,2,2,2
"Qatar",661,1,6,3,1,2,1
"Uruguay",661,1,6,3,1,2,2
"Brazil",661,7,6,3,1,2,1
"Mexico",661,7,4,3,3,0,2
"England",663,2,6,2,1,1,2
"Germany",663,2,6,4,1,3,1
"Argentina",664,4,6,5,3,2,1
"Mexico",664,4,4,3,3,0,2
"Chile",668,1,7,4,1,3,1
"Croatia",668,1,4,2,2,0,2
"Algeria",669,1,5,3,2,1,2
"Croatia",669,1,5,4,1,3,1
"Argentina",671,3,3,2,3,-1,2
"Japan",671,3,9,5,1,4,1
"Algeria",671,8,4,4,4,0,2
"Portugal",671,8,7,7,3,4,1
"Brazil",680,7,6,3,2,1,1
"Netherlands",680,7,6,3,2,1,2
"Australia",692,5,4,3,3,0,2
"Colombia",692,5,6,5,2,3,1
"Belgium",693,8,9,6,1,5,1
"Italy",693,8,4,3,3,0,2
"Algeria",702,3,6,5,4,1,1
"Argentina",702,3,6,5,4,1,2
"Italy",707,6,4,2,2,0,2
"Portugal",707,6,7,5,2,3,1
"Chile",711,7,3,4,6,-2,2
"Spain",711,7,9,7,1,6,1
"Argentina",714,3,2,3,4,-1,2
"Australia",714,3,9,6,2,4,1
"Australia",715,3,5,7,3,4,1
"Brazil",715,3,5,7,3,4,2
"Belgium",716,2,9,8,0,8,1
"Iran",716,2,3,2,4,-2,2
"Japan",716,3,4,4,5,-1,2
"Nigeria",716,3,5,6,3,3,1
"Algeria",722,1,4,2,3,-1,2
"Switzerland",722,1,9,6,1,5,1
"Algeria",723,1,7,3,1,2,1
"Chile",723,1,4,3,3,0,2
"Argentina",723,2,4,2,2,0,2
"Senegal",723,2,6,5,4,1,1
"Brazil",723,5,5,3,1,2,1
"Tunisia",723,5,5,3,1,2,2
"Belgium",723,7,4,2,1,1,1
"Netherlands",723,7,4,2,2,0,2
"Belgium",726,7,5,2,1,1,1
"Netherlands",726,7,5,2,1,1,2
"Croatia",727,3,4,4,3,1,1
"England",727,3,4,3,3,0,2
"England",731,2,5,2,1,1,1
"Morocco",731,2,5,2,1,1,2
"Australia",731,7,6,4,3,1,1
"Mexico",731,7,6,4,3,1,2
"Colombia",733,5,4,3,3,0,2
"Switzerland",733,5,6,3,3,0,1
"Colombia",734,5,5,1,0,1,1
"Portugal",734,5,3,1,1,0,2
"Algeria",735,2,5,3,2,1,1
"England",735,2,4,3,3,0,2
"France",735,6,6,5,3,2,1
"Mexico",735,6,6,5,3,2,2
"France",738,8,4,2,2,0,2
"Uruguay",738,8,6,7,1,6,1
"France",744,3,5,2,0,2,1
"Germany",744,3,3,1,1,0,2
"Nigeria",749,8,4,3,3,0,2
"Uruguay",749,8,4,4,3,1,1
"Denmark",750,2,4,3,3,0,2
"United States",750,2,7,5,3,2,1
"Italy",753,7,7,3,0,3,1
"Spain",753,7,7,3,0,3,2
"France",755,4,6,9,4,5,1
"Netherlands",755,4,6,9,4,5,2
"Brazil",769,5,5,5,2,3,1
"Italy",769,5,5,4,3,1,2
"Iran",769,8,3,3,3,0,2
"Portugal",769,8,5,2,1,1,1
"Croatia",782,1,6,4,2,2,1
"Jamaica",782,1,6,2,1,1,2
"Belgium",784,4,6,6,4,2,1
"Italy",784,4,6,6,4,2,2
"Korea Republic",792,5,4,4,4,0,1
"Mexico",792,5,4,4,4,0,2
"Brazil",793,4,6,8,3,5,1
"Netherlands",793,4,6,8,3,5,2
"Germany",795,1,4,6,4,2,1
"Senegal",795,1,4,6,4,2,2
"Costa Rica",797,2,4,3,3,0,2
"Italy",797,2,6,5,4,1,1
"Algeria",801,3,4,4,5,-1,2
"Spain",801,3,9,9,2,7,1
"Colombia",802,1,4,3,3,0,2
"Costa Rica",802,1,5,4,3,1,1
"Australia",814,4,6,3,1,2,1
"France",814,4,6,3,1,2,2
"Brazil",817,6,6,4,3,1,1
"Costa Rica",817,6,6,4,3,1,2
"Argentina",818,3,5,4,3,1,1
"Italy",818,3,5,4,3,1,2
"Brazil",825,5,4,2,1,1,2
"Korea Republic",825,5,9,4,0,4,1
"France",825,8,7,5,1,4,1
"Netherlands",825,8,7,5,1,4,2
"Argentina",826,3,5,1,0,1,1
"Denmark",826,3,5,1,0,1,2
"Morocco",829,3,6,6,5,1,1
"Switzerland",829,3,6,6,5,1,2
"Chile",837,8,3,5,6,-1,2
"Spain",837,8,9,7,3,4,1
"Costa Rica",838,7,4,5,5,0,2
"Denmark",838,7,6,5,4,1,1
"Denmark",841,2,6,4,3,1,1
"United States",841,2,6,4,3,1,2
"Australia",841,8,2,1,3,-2,2
"Portugal",841,8,9,6,0,6,1
"Costa Rica",843,8,4,3,3,0,2
"England",843,8,6,6,5,1,1
"Argentina",845,5,5,7,4,3,1
"Croatia",845,5,5,4,2,2,2
"Argentina",850,4,3,2,3,-1,2
"Denmark",850,4,9,5,1,4,1
"Germany",855,7,6,8,4,4,1
"Spain",855,7,4,5,6,-1,2
"Denmark",858,1,6,5,3,2,1
"Qatar",858,1,6,5,3,2,2
"England",862,7,4,4,2,2,1
"United States",862,7,4,4,5,-1,2
"Algeria",866,3,4,2,2,0,2
"Brazil",866,3,6,4,3,1,1
"Algeria",869,1,3,3,4,-1,2
"Italy",869,1,9,4,1,3,1
"Brazil",869,7,9,6,3,3,1
"Mexico",869,7,2,4,5,-1,2
"Nigeria",870,1,7,6,3,3,1
"Poland",870,1,7,6,3,3,2
"Colombia",872,8,5,4,3,1,1
"Wales",872,8,5,4,3,1,2
"Australia",873,8,4,4,3,1,2
"Netherlands",873,8,7,3,1,2,1
"Brazil",876,4,6,4,1,3,1
"Denmark",876,4,4,2,2,0,2
"Korea Republic",880,5,7,2,0,2,1
"Mexico",880,5,7,2,0,2,2
"Brazil",881,4,4,4,4,0,2
"Wales",881,4,4,6,6,0,1
"Argentina",883,3,4,3,3,0,2
"Netherlands",883,3,9,5,1,4,1
"Iran",904,8,4,3,2,1,1
"Italy",904,8,4,3,3,0,2
"Morocco",912,1,5,5,2,3,1
"United States",912,1,5,5,2,3,2
"Argentina",922,7,6,7,4,3,1
"Croatia",922,7,6,7,4,3,2
"Germany",926,4,5,2,1,1,1
"Poland",926,4,4,2,2,0,2
"Colombia",929,1,6,5,5,0,2
"Qatar",929,1,6,9,3,6,1
"Chile",930,5,4,4,5,-1,2
"Netherlands",930,5,7,5,1,4,1
"Argentina",936,7,4,3,2,1,2
"Korea Republic",936,7,9,4,1,3,1
"Brazil",948,5,4,2,2,0,2
"Italy",948,5,5,2,1,1,1
"Algeria",954,5,6,4,1,3,1
"Spain",954,5,6,4,1,3,2
"Germany",963,4,4,3,3,0,2
"United States",963,4,6,3,2,1,1
"Japan",969,6,5,4,2,2,1
"Netherlands",969,6,5,4,2,2,2
"Brazil",971,4,5,4,2,2,1
"Denmark",971,4,5,4,2,2,2
"Belgium",975,8,6,4,1,3,1
"Uruguay",975,8,6,4,1,3,2
"Australia",976,2,6,3,3,0,2
"Portugal",976,2,6,8,2,6,1
"Belgium",977,6,5,2,1,1,1
"Colombia",977,6,5,2,1,1,2
"Spain",978,5,5,4,3,1,2
"Uruguay",978,5,5,10,4,6,1
"Belgium",979,6,5,1,0,1,1
"Denmark",979,6,4,3,2,1,2
"Colombia",982,1,5,2,1,1,1
"Senegal",982,1,5,2,1,1,2
"Argentina",987,7,5,4,3,1,1
"Iran",987,7,5,4,3,1,2
"France",989,3,9,4,1,3,1
"Germany",989,3,2,3,4,-1,2
"Argentina",991,3,6,3,1,2,1
"Denmark",991,3,4,4,4,0,2
"Belgium",991,5,6,5,4,1,1
"Chile",991,5,6,5,4,1,2
"Argentina",994,5,5,4,3,1,2
"Switzerland",994,5,5,5,3,2,1
"Morocco",998,8,4,3,3,0,2
"Uruguay",998,8,6,4,3,1,1
"Argentina",1000,3,3,2,3,-1,2
"Croatia",1000,3,9,9,0,9,1
