"country","simulation","group","points","goals_scored","goals_taken","diff_goals","rank"
"Uruguay",1,1,7,5,2,3,1
"Saudi Arabia",1,1,4,5,5,0,2
"Denmark",1,3,9,4,1,3,1
"Peru",1,3,4,5,5,0,2
"Argentina",1,4,9,4,0,4,1
"Croatia",1,4,4,3,3,0,2
"Germany",1,6,7,6,1,5,1
"Mexico",1,6,5,8,3,5,2
"England",1,7,9,7,2,5,1
"Belgium",1,7,6,6,5,1,2
"Japan",1,8,7,8,0,8,1
"Poland",1,8,4,3,3,0,2
"Uruguay",2,1,9,6,1,5,1
"Russia",2,1,6,3,2,1,2
"Portugal",2,2,7,7,1,6,1
"Iran",2,2,6,4,5,-1,2
"Argentina",2,4,9,7,1,6,1
"Nigeria",2,4,4,1,2,-1,2
"Germany",2,6,9,5,1,4,1
"South Korea",2,6,6,5,3,2,2
"England",2,7,9,8,2,6,1
"Belgium",2,7,6,6,3,3,2
"Colombia",2,8,7,3,1,2,1
"Poland",2,8,4,3,3,0,2
"Portugal",3,2,7,7,1,6,1
"Spain",3,2,5,2,0,2,2
"France",3,3,9,7,2,5,1
"Denmark",3,3,4,5,4,1,2
"Argentina",3,4,9,9,1,8,1
"Iceland",3,4,6,3,1,2,2
"Brazil",3,5,9,6,2,4,1
"Costa Rica",3,5,4,1,1,0,2
"Colombia",3,8,7,5,1,4,1
"Poland",3,8,5,5,4,1,2
"Russia",4,1,7,5,1,4,1
"Uruguay",4,1,6,4,3,1,2
"Spain",4,2,9,9,1,8,1
"Iran",4,2,6,5,3,2,2
"France",4,3,9,7,0,7,1
"Peru",4,3,4,3,6,-3,2
"England",4,7,9,8,3,5,1
"Belgium",4,7,6,4,3,1,2
"Peru",5,3,5,2,1,1,1
"Australia",5,3,4,8,6,2,2
"Switzerland",5,5,7,2,0,2,1
"Brazil",5,5,5,1,0,1,2
"Colombia",5,8,7,4,0,4,1
"Poland",5,8,6,4,4,0,2
"Peru",6,3,9,6,1,5,1
"France",6,3,6,9,3,6,2
"Iceland",6,4,7,3,0,3,1
"Croatia",6,4,6,6,3,3,2
"England",6,7,9,9,0,9,1
"Belgium",6,7,6,2,2,0,2
"Poland",6,8,7,4,1,3,1
"Colombia",6,8,6,5,5,0,2
"Uruguay",7,1,7,5,1,4,1
"Russia",7,1,4,2,1,1,2
"France",7,3,9,9,2,7,1
"Peru",7,3,4,5,4,1,2
"Argentina",7,4,9,7,1,6,1
"Croatia",7,4,6,7,2,5,2
"Costa Rica",7,5,7,5,2,3,1
"Brazil",7,5,5,3,2,1,2
"Germany",7,6,9,6,0,6,1
"Mexico",7,6,6,5,4,1,2
"England",7,7,7,5,2,3,1
"Belgium",7,7,5,5,3,2,2
"Japan",7,8,7,5,3,2,1
"Colombia",7,8,6,4,3,1,2
"Russia",8,1,9,5,2,3,1
"Egypt",8,1,4,3,3,0,2
"France",8,3,9,6,1,5,1
"Australia",8,3,6,6,5,1,2
"Switzerland",8,5,7,8,2,6,1
"Brazil",8,5,5,4,1,3,2
"Germany",8,6,6,5,3,2,1
"South Korea",8,6,5,5,4,1,2
"Belgium",8,7,7,5,1,4,1
"England",8,7,6,8,2,6,2
"Poland",8,8,7,3,0,3,1
"Japan",8,8,4,3,2,1,2
"Russia",9,1,7,4,1,3,1
"Uruguay",9,1,5,5,2,3,2
"Portugal",9,2,9,5,0,5,1
"Spain",9,2,4,3,2,1,2
"France",9,3,9,4,0,4,1
"Peru",9,3,6,6,1,5,2
"Mexico",9,6,7,6,2,4,1
"Germany",9,6,6,4,4,0,2
"Uruguay",10,1,9,10,2,8,1
"Saudi Arabia",10,1,6,3,5,-2,2
"Portugal",10,2,9,7,0,7,1
"Iran",10,2,6,5,2,3,2
"Australia",10,3,7,3,0,3,1
"Denmark",10,3,6,3,3,0,2
"Croatia",10,4,7,7,2,5,1
"Iceland",10,4,6,3,2,1,2
"Brazil",10,5,7,6,1,5,1
"Costa Rica",10,5,6,4,3,1,2
"Germany",10,6,9,11,3,8,1
"Mexico",10,6,4,2,2,0,2
"Belgium",10,7,9,7,2,5,1
"Panama",10,7,6,6,4,2,2
"Colombia",10,8,5,4,1,3,1
"Senegal",10,8,4,2,4,-2,2
"Egypt",11,1,7,3,1,2,1
"Saudi Arabia",11,1,4,4,4,0,2
"Peru",11,3,9,5,2,3,1
"Australia",11,3,4,4,4,0,2
"Argentina",11,4,9,7,2,5,1
"Croatia",11,4,6,3,2,1,2
"Mexico",11,6,7,4,1,3,1
"Germany",11,6,5,5,1,4,2
"Poland",11,8,7,5,0,5,1
"Japan",11,8,6,3,2,1,2
"Uruguay",12,1,7,6,3,3,1
"Saudi Arabia",12,1,4,4,4,0,2
"Portugal",12,2,9,8,0,8,1
"Spain",12,2,6,2,1,1,2
"Brazil",12,5,7,3,0,3,1
"Switzerland",12,5,5,4,1,3,2
"Colombia",12,8,7,3,0,3,1
"Poland",12,8,4,1,1,0,2
"France",13,3,7,8,2,6,1
"Peru",13,3,5,2,1,1,2
"Argentina",13,4,9,6,1,5,1
"Iceland",13,4,4,2,2,0,2
"Brazil",13,5,7,6,3,3,1
"Switzerland",13,5,4,2,3,-1,2
"Uruguay",14,1,7,10,4,6,1
"Egypt",14,1,6,2,4,-2,2
"Brazil",14,5,9,7,3,4,1
"Costa Rica",14,5,6,5,2,3,2
"Germany",14,6,7,10,5,5,1
"Sweden",14,6,4,7,6,1,2
"England",14,7,7,6,4,2,1
"Belgium",14,7,5,5,4,1,2
"Portugal",15,2,6,4,3,1,1
"Iran",15,2,5,4,2,2,2
"France",15,3,7,4,2,2,1
"Peru",15,3,6,6,3,3,2
"Germany",15,6,9,5,1,4,1
"Mexico",15,6,6,3,2,1,2
"Belgium",15,7,9,5,0,5,1
"Tunisia",15,7,4,3,3,0,2
"Senegal",15,8,7,2,0,2,1
"Colombia",15,8,5,2,1,1,2
"Egypt",16,1,7,4,2,2,1
"Uruguay",16,1,6,4,2,2,2
"Spain",16,2,9,6,0,6,1
"Iran",16,2,4,5,4,1,2
"France",16,3,9,5,2,3,1
"Peru",16,3,4,6,5,1,2
"Iceland",16,4,6,4,1,3,1
"Argentina",16,4,5,2,1,1,2
"Brazil",16,5,9,8,3,5,1
"Switzerland",16,5,6,5,5,0,2
"England",16,7,5,3,1,2,1
"Panama",16,7,4,3,4,-1,2
"Japan",16,8,7,3,0,3,1
"Poland",16,8,6,5,2,3,2
"Portugal",17,2,7,5,2,3,1
"Spain",17,2,6,5,2,3,2
"Croatia",17,4,9,7,1,6,1
"Argentina",17,4,4,6,6,0,2
"Brazil",17,5,9,5,1,4,1
"Switzerland",17,5,6,2,2,0,2
"Uruguay",18,1,9,4,0,4,1
"Russia",18,1,4,2,3,-1,2
"Spain",18,2,7,8,1,7,1
"Portugal",18,2,6,7,4,3,2
"France",18,3,7,5,1,4,1
"Denmark",18,3,5,4,3,1,2
"Argentina",18,4,7,4,2,2,1
"Croatia",18,4,4,2,2,0,2
"Brazil",18,5,7,6,2,4,1
"Costa Rica",18,5,4,4,2,2,2
"Panama",18,7,7,5,1,4,1
"Belgium",18,7,4,2,2,0,2
"Uruguay",19,1,9,5,0,5,1
"Egypt",19,1,6,4,1,3,2
"Iran",19,2,9,7,2,5,1
"Portugal",19,2,6,6,1,5,2
"France",19,3,7,6,1,5,1
"Peru",19,3,6,5,3,2,2
"Croatia",19,4,7,5,1,4,1
"Argentina",19,4,5,3,2,1,2
"Switzerland",19,5,9,5,0,5,1
"Brazil",19,5,6,2,1,1,2
"Germany",19,6,9,8,1,7,1
"South Korea",19,6,6,5,4,1,2
"Panama",19,7,7,4,1,3,1
"Belgium",19,7,5,3,1,2,2
"Japan",19,8,9,6,3,3,1
"Poland",19,8,4,4,3,1,2
"Spain",20,2,7,8,2,6,1
"Portugal",20,2,5,3,2,1,2
"France",20,3,9,7,1,6,1
"Peru",20,3,6,5,4,1,2
"Argentina",20,4,7,4,0,4,1
"Croatia",20,4,4,4,2,2,2
"Costa Rica",20,5,7,4,2,2,1
"Switzerland",20,5,4,6,6,0,2
"Colombia",20,8,7,5,3,2,1
"Poland",20,8,4,4,3,1,2
"Uruguay",21,1,9,7,4,3,1
"Russia",21,1,4,3,3,0,2
"Portugal",21,2,7,4,1,3,1
"Spain",21,2,6,3,2,1,2
"France",21,3,7,5,3,2,1
"Denmark",21,3,5,3,1,2,2
"Croatia",21,4,7,4,0,4,1
"Argentina",21,4,6,9,5,4,2
"Brazil",21,5,7,8,5,3,1
"Switzerland",21,5,3,5,5,0,2
"South Korea",21,6,9,4,1,3,1
"Sweden",21,6,6,4,2,2,2
"Belgium",21,7,7,4,1,3,1
"Panama",21,7,5,4,3,1,2
"Uruguay",22,1,7,5,2,3,1
"Russia",22,1,6,5,3,2,2
"Spain",22,2,7,6,2,4,1
"Portugal",22,2,4,3,3,0,2
"Costa Rica",22,5,7,5,2,3,1
"Brazil",22,5,6,7,3,4,2
"England",22,7,7,8,3,5,1
"Panama",22,7,6,4,3,1,2
"Japan",22,8,7,4,1,3,1
"Colombia",22,8,4,2,3,-1,2
"Russia",23,1,7,3,1,2,1
"Egypt",23,1,4,2,2,0,2
"Iceland",23,4,6,5,4,1,1
"Croatia",23,4,5,4,3,1,2
"Brazil",23,5,9,10,2,8,1
"Switzerland",23,5,6,6,3,3,2
"Senegal",23,8,7,5,2,3,1
"Japan",23,8,6,6,3,3,2
"Uruguay",24,1,7,3,0,3,1
"Egypt",24,1,4,4,4,0,2
"Australia",24,3,7,3,0,3,1
"France",24,3,6,6,3,3,2
"Argentina",24,4,9,8,2,6,1
"Croatia",24,4,6,8,7,1,2
"Brazil",24,5,7,5,3,2,1
"Switzerland",24,5,4,4,3,1,2
"France",25,3,7,4,1,3,1
"Australia",25,3,6,5,4,1,2
"Argentina",25,4,9,3,0,3,1
"Nigeria",25,4,4,3,3,0,2
"England",25,7,9,12,2,10,1
"Belgium",25,7,6,3,4,-1,2
"Japan",25,8,7,4,0,4,1
"Colombia",25,8,5,1,0,1,2
"Argentina",26,4,9,9,0,9,1
"Croatia",26,4,4,3,2,1,2
"Brazil",26,5,7,6,1,5,1
"Costa Rica",26,5,4,3,3,0,2
"Germany",26,6,9,7,2,5,1
"Mexico",26,6,6,2,1,1,2
"England",26,7,7,3,1,2,1
"Panama",26,7,6,3,1,2,2
"Poland",26,8,5,5,2,3,1
"Colombia",26,8,4,5,7,-2,2
"Iran",27,2,9,9,2,7,1
"Portugal",27,2,6,8,7,1,2
"Brazil",27,5,9,7,2,5,1
"Switzerland",27,5,4,4,3,1,2
"Germany",27,6,7,7,2,5,1
"South Korea",27,6,6,5,2,3,2
"France",28,3,7,5,2,3,1
"Australia",28,3,4,3,3,0,2
"Argentina",28,4,9,7,1,6,1
"Croatia",28,4,6,6,2,4,2
"South Korea",28,6,7,6,3,3,1
"Mexico",28,6,4,4,4,0,2
"England",28,7,9,6,2,4,1
"Belgium",28,7,6,5,2,3,2
"Poland",28,8,7,5,3,2,1
"Colombia",28,8,5,4,1,3,2
"Uruguay",29,1,9,6,1,5,1
"Russia",29,1,6,7,5,2,2
"France",29,3,7,9,1,8,1
"Peru",29,3,5,4,3,1,2
"Argentina",29,4,9,8,1,7,1
"Iceland",29,4,6,5,2,3,2
"Switzerland",29,5,9,7,1,6,1
"Brazil",29,5,6,5,3,2,2
"Uruguay",30,1,7,5,1,4,1
"Russia",30,1,5,4,2,2,2
"Croatia",30,4,9,6,1,5,1
"Argentina",30,4,6,4,3,1,2
"Brazil",30,5,7,8,2,6,1
"Switzerland",30,5,5,5,3,2,2
"Mexico",30,6,7,6,3,3,1
"Germany",30,6,5,6,2,4,2
"Belgium",30,7,9,10,2,8,1
"England",30,7,4,7,4,3,2
"Japan",30,8,6,6,3,3,1
"Poland",30,8,5,5,3,2,2
"Egypt",31,1,7,8,3,5,1
"Saudi Arabia",31,1,5,7,5,2,2
"Portugal",31,2,9,5,1,4,1
"Spain",31,2,4,5,5,0,2
"Peru",31,3,7,3,1,2,1
"France",31,3,5,7,3,4,2
"Croatia",31,4,9,3,0,3,1
"Argentina",31,4,6,5,1,4,2
"Brazil",31,5,7,6,2,4,1
"Costa Rica",31,5,5,3,2,1,2
"Germany",31,6,9,6,2,4,1
"South Korea",31,6,6,3,2,1,2
"England",31,7,7,4,2,2,1
"Panama",31,7,5,4,3,1,2
"Iran",32,2,9,4,1,3,1
"Portugal",32,2,6,4,1,3,2
"France",32,3,7,7,2,5,1
"Australia",32,3,4,6,4,2,2
"Brazil",32,5,9,7,0,7,1
"Switzerland",32,5,4,3,5,-2,2
"Germany",32,6,9,6,1,5,1
"Mexico",32,6,6,5,2,3,2
"Uruguay",33,1,9,10,1,9,1
"Saudi Arabia",33,1,6,4,3,1,2
"Portugal",33,2,9,6,2,4,1
"Spain",33,2,6,5,3,2,2
"France",33,3,9,4,0,4,1
"Peru",33,3,6,3,1,2,2
"Argentina",33,4,9,7,1,6,1
"Croatia",33,4,6,7,2,5,2
"Brazil",33,5,6,4,3,1,1
"Switzerland",33,5,5,3,2,1,2
"South Korea",33,6,6,3,3,0,1
"Germany",33,6,5,5,2,3,2
"Belgium",33,7,7,3,1,2,1
"England",33,7,6,4,1,3,2
"Colombia",33,8,7,7,2,5,1
"Poland",33,8,5,3,1,2,2
"Russia",34,1,9,7,2,5,1
"Uruguay",34,1,4,3,5,-2,2
"Iran",34,2,6,4,3,1,1
"Spain",34,2,5,2,1,1,2
"Denmark",34,3,7,3,1,2,1
"Peru",34,3,5,3,2,1,2
"Germany",34,6,7,6,3,3,1
"South Korea",34,6,4,3,4,-1,2
"England",34,7,7,3,1,2,1
"Belgium",34,7,6,6,2,4,2
"Russia",35,1,7,8,0,8,1
"Uruguay",35,1,4,2,4,-2,2
"France",35,3,7,7,0,7,1
"Denmark",35,3,6,2,3,-1,2
"Argentina",35,4,9,9,1,8,1
"Croatia",35,4,4,6,3,3,2
"Brazil",35,5,7,12,2,10,1
"Costa Rica",35,5,6,6,9,-3,2
"Germany",35,6,9,10,0,10,1
"South Korea",35,6,4,4,6,-2,2
"Belgium",35,7,5,3,2,1,1
"England",35,7,4,4,2,2,2
"Poland",35,8,9,4,1,3,1
"Colombia",35,8,6,6,2,4,2
"Russia",36,1,9,5,1,4,1
"Uruguay",36,1,6,9,3,6,2
"Iceland",36,4,7,6,2,4,1
"Croatia",36,4,6,5,6,-1,2
"Brazil",36,5,9,7,0,7,1
"Costa Rica",36,5,6,3,4,-1,2
"Senegal",36,8,5,4,1,3,1
"Colombia",36,8,4,3,3,0,2
"Uruguay",37,1,7,5,1,4,1
"Saudi Arabia",37,1,5,4,1,3,2
"France",37,3,7,4,2,2,1
"Peru",37,3,5,6,4,2,2
"Brazil",37,5,7,5,1,4,1
"Costa Rica",37,5,4,3,2,1,2
"Mexico",37,6,7,6,1,5,1
"Sweden",37,6,3,4,4,0,2
"Panama",37,7,7,5,2,3,1
"Belgium",37,7,4,4,4,0,2
"Colombia",37,8,7,6,1,5,1
"Japan",37,8,6,5,3,2,2
"Spain",38,2,9,8,0,8,1
"Portugal",38,2,4,4,3,1,2
"Peru",38,3,7,3,1,2,1
"France",38,3,6,4,3,1,2
"Argentina",38,4,7,9,1,8,1
"Croatia",38,4,5,3,2,1,2
"Tunisia",38,7,7,3,1,2,1
"England",38,7,5,4,2,2,2
"Senegal",38,8,5,3,1,2,1
"Japan",38,8,4,1,2,-1,2
"France",39,3,7,5,2,3,1
"Peru",39,3,6,4,2,2,2
"Argentina",39,4,7,2,0,2,1
"Croatia",39,4,4,3,3,0,2
"England",39,7,7,6,2,4,1
"Belgium",39,7,4,8,6,2,2
"Poland",39,8,7,4,2,2,1
"Senegal",39,8,4,3,3,0,2
"Uruguay",40,1,9,8,2,6,1
"Egypt",40,1,4,3,4,-1,2
"Argentina",40,4,7,7,1,6,1
"Iceland",40,4,5,2,1,1,2
"Belgium",40,7,7,3,0,3,1
"England",40,7,3,1,1,0,2
"Spain",41,2,9,8,2,6,1
"Portugal",41,2,4,4,3,1,2
"Australia",41,3,6,9,5,4,1
"Peru",41,3,5,7,4,3,2
"Costa Rica",41,5,7,5,2,3,1
"Switzerland",41,5,6,3,2,1,2
"Germany",41,6,7,4,1,3,1
"Mexico",41,6,6,4,4,0,2
"England",41,7,5,2,1,1,1
"Belgium",41,7,4,3,1,2,2
"Colombia",41,8,9,5,0,5,1
"Poland",41,8,4,2,3,-1,2
"Spain",42,2,9,7,2,5,1
"Iran",42,2,6,5,3,2,2
"Peru",42,3,6,3,1,2,1
"France",42,3,5,1,0,1,2
"Croatia",42,4,7,4,0,4,1
"Argentina",42,4,5,2,1,1,2
"Uruguay",43,1,7,5,1,4,1
"Russia",43,1,5,4,1,3,2
"Spain",43,2,9,8,0,8,1
"Iran",43,2,4,2,5,-3,2
"Denmark",43,3,7,5,2,3,1
"France",43,3,6,7,4,3,2
"Mexico",43,6,9,3,0,3,1
"Germany",43,6,4,2,2,0,2
"Tunisia",43,7,5,2,1,1,1
"England",43,7,4,3,3,0,2
"Portugal",44,2,7,7,3,4,1
"Spain",44,2,6,6,4,2,2
"France",44,3,9,8,1,7,1
"Australia",44,3,4,3,5,-2,2
"Argentina",44,4,7,3,0,3,1
"Croatia",44,4,6,3,1,2,2
"Serbia",44,5,7,6,2,4,1
"Brazil",44,5,5,4,3,1,2
"South Korea",44,6,7,5,3,2,1
"Germany",44,6,6,4,3,1,2
"England",44,7,7,6,1,5,1
"Panama",44,7,6,5,5,0,2
"Germany",45,6,7,5,0,5,1
"Mexico",45,6,4,1,2,-1,2
"Poland",45,8,7,4,0,4,1
"Japan",45,8,5,1,0,1,2
"Portugal",46,2,7,3,0,3,1
"Iran",46,2,6,4,3,1,2
"France",46,3,7,7,4,3,1
"Peru",46,3,4,4,5,-1,2
"Croatia",46,4,7,4,0,4,1
"Argentina",46,4,5,2,1,1,2
"Brazil",46,5,9,12,1,11,1
"Costa Rica",46,5,6,3,5,-2,2
"Germany",46,6,7,2,0,2,1
"Sweden",46,6,5,4,1,3,2
"Tunisia",46,7,5,3,2,1,1
"Panama",46,7,4,2,2,0,2
"Poland",46,8,7,5,2,3,1
"Japan",46,8,4,4,5,-1,2
"Uruguay",47,1,7,8,2,6,1
"Russia",47,1,3,1,1,0,2
"Serbia",47,5,7,3,1,2,1
"Costa Rica",47,5,5,3,2,1,2
"Mexico",47,6,7,3,0,3,1
"Germany",47,6,6,4,2,2,2
"Belgium",47,7,7,9,3,6,1
"Tunisia",47,7,5,3,2,1,2
"Russia",48,1,7,6,2,4,1
"Uruguay",48,1,5,2,1,1,2
"Croatia",48,4,7,4,2,2,1
"Nigeria",48,4,4,1,2,-1,2
"Switzerland",48,5,7,7,3,4,1
"Brazil",48,5,6,8,2,6,2
"Mexico",48,6,7,3,1,2,1
"Sweden",48,6,4,4,4,0,2
"England",48,7,7,5,1,4,1
"Belgium",48,7,6,5,2,3,2
"Colombia",48,8,9,7,1,6,1
"Poland",48,8,4,4,2,2,2
"Egypt",50,1,7,3,1,2,1
"Uruguay",50,1,5,2,1,1,2
"Denmark",50,3,7,6,3,3,1
"France",50,3,5,6,1,5,2
"Argentina",50,4,7,6,1,5,1
"Croatia",50,4,4,2,3,-1,2
"Brazil",50,5,7,10,2,8,1
"Costa Rica",50,5,6,6,3,3,2
"Germany",50,6,7,5,2,3,1
"Mexico",50,6,5,4,2,2,2
"England",50,7,7,7,2,5,1
"Panama",50,7,6,4,3,1,2
"Portugal",51,2,9,5,1,4,1
"Iran",51,2,4,5,5,0,2
"France",51,3,9,7,0,7,1
"Peru",51,3,6,5,5,0,2
"Argentina",51,4,7,5,2,3,1
"Nigeria",51,4,4,2,3,-1,2
"Brazil",51,5,9,6,0,6,1
"Serbia",51,5,4,4,3,1,2
"Croatia",52,4,7,4,1,3,1
"Argentina",52,4,5,3,0,3,2
"Colombia",52,8,9,10,3,7,1
"Japan",52,8,6,2,3,-1,2
"Uruguay",53,1,7,5,2,3,1
"Russia",53,1,6,4,2,2,2
"Peru",53,3,9,9,3,6,1
"Denmark",53,3,4,3,3,0,2
"Argentina",53,4,9,6,1,5,1
"Nigeria",53,4,4,2,2,0,2
"Switzerland",53,5,7,5,2,3,1
"Serbia",53,5,5,5,4,1,2
"England",53,7,9,6,1,5,1
"Belgium",53,7,6,9,4,5,2
"Poland",53,8,7,3,1,2,1
"Colombia",53,8,5,4,3,1,2
"Russia",54,1,7,2,0,2,1
"Egypt",54,1,4,2,2,0,2
"Morocco",54,2,7,4,2,2,1
"Iran",54,2,5,1,0,1,2
"Peru",54,3,6,4,3,1,1
"Australia",54,3,5,5,4,1,2
"Iceland",54,4,9,8,2,6,1
"Argentina",54,4,6,2,4,-2,2
"England",54,7,7,6,2,4,1
"Belgium",54,7,3,4,4,0,2
"Peru",55,3,9,6,2,4,1
"France",55,3,4,3,2,1,2
"Argentina",55,4,7,9,1,8,1
"Nigeria",55,4,4,3,3,0,2
"Brazil",55,5,9,6,1,5,1
"Costa Rica",55,5,6,4,3,1,2
"Germany",55,6,6,4,3,1,1
"Mexico",55,6,5,5,4,1,2
"Belgium",55,7,7,5,2,3,1
"Panama",55,7,5,4,3,1,2
"Uruguay",56,1,9,7,1,6,1
"Russia",56,1,4,3,5,-2,2
"Denmark",56,3,7,5,2,3,1
"France",56,3,4,2,2,0,2
"Argentina",56,4,9,5,0,5,1
"Nigeria",56,4,4,2,2,0,2
"Brazil",56,5,7,8,4,4,1
"Costa Rica",56,5,6,5,3,2,2
"South Korea",56,6,9,5,1,4,1
"Germany",56,6,6,5,4,1,2
"Belgium",56,7,7,9,1,8,1
"England",56,7,5,2,1,1,2
"Russia",57,1,9,7,1,6,1
"Uruguay",57,1,6,5,2,3,2
"France",57,3,9,7,1,6,1
"Denmark",57,3,4,5,6,-1,2
"Argentina",57,4,7,4,2,2,1
"Nigeria",57,4,6,2,1,1,2
"Brazil",57,5,7,4,1,3,1
"Costa Rica",57,5,6,5,4,1,2
"Sweden",57,6,7,6,2,4,1
"Mexico",57,6,6,6,5,1,2
"England",57,7,7,7,1,6,1
"Belgium",57,7,6,5,5,0,2
"Uruguay",58,1,7,10,2,8,1
"Russia",58,1,5,3,2,1,2
"Australia",58,3,7,3,0,3,1
"France",58,3,4,3,2,1,2
"Brazil",58,5,9,5,1,4,1
"Serbia",58,5,4,3,3,0,2
"Mexico",58,6,9,5,1,4,1
"Germany",58,6,6,4,2,2,2
"England",58,7,7,6,3,3,1
"Belgium",58,7,4,2,2,0,2
"Japan",58,8,6,3,1,2,1
"Colombia",58,8,5,2,1,1,2
"Uruguay",59,1,9,12,3,9,1
"Russia",59,1,6,7,5,2,2
"Morocco",59,2,6,3,5,-2,1
"Portugal",59,2,5,7,3,4,2
"France",59,3,9,8,1,7,1
"Australia",59,3,6,3,4,-1,2
"England",59,7,9,6,1,5,1
"Panama",59,7,4,4,4,0,2
"Japan",59,8,7,2,0,2,1
"Poland",59,8,5,2,0,2,2
"Saudi Arabia",60,1,7,4,2,2,1
"Egypt",60,1,5,2,1,1,2
"Iran",60,2,9,7,1,6,1
"Spain",60,2,6,5,2,3,2
"Iceland",60,4,7,7,5,2,1
"Argentina",60,4,4,9,5,4,2
"Brazil",60,5,9,6,0,6,1
"Serbia",60,5,4,3,3,0,2
"Japan",60,8,9,6,0,6,1
"Poland",60,8,6,3,3,0,2
"Russia",61,1,9,8,2,6,1
"Uruguay",61,1,6,5,5,0,2
"Spain",61,2,7,5,3,2,1
"Portugal",61,2,4,6,5,1,2
"France",61,3,9,7,1,6,1
"Australia",61,3,4,3,3,0,2
"Argentina",61,4,9,6,1,5,1
"Croatia",61,4,4,2,2,0,2
"Colombia",61,8,6,4,2,2,1
"Poland",61,8,5,3,2,1,2
"Australia",62,3,7,6,2,4,1
"France",62,3,4,7,4,3,2
"Brazil",62,5,9,4,0,4,1
"Switzerland",62,5,4,2,2,0,2
"Colombia",62,8,7,5,2,3,1
"Japan",62,8,4,4,5,-1,2
"Uruguay",63,1,9,7,2,5,1
"Russia",63,1,4,5,5,0,2
"Portugal",63,2,9,7,0,7,1
"Spain",63,2,6,4,2,2,2
"Denmark",63,3,6,5,4,1,1
"France",63,3,5,5,2,3,2
"Croatia",63,4,9,7,1,6,1
"Nigeria",63,4,4,3,3,0,2
"Brazil",63,5,9,5,0,5,1
"Switzerland",63,5,6,4,2,2,2
"Germany",63,6,9,8,1,7,1
"Sweden",63,6,4,4,4,0,2
"Belgium",63,7,7,9,5,4,1
"Panama",63,7,4,2,3,-1,2
"Poland",63,8,9,9,2,7,1
"Colombia",63,8,6,8,8,0,2
"Japan",64,8,7,3,0,3,1
"Colombia",64,8,6,4,3,1,2
"Uruguay",65,1,9,9,2,7,1
"Russia",65,1,4,3,2,1,2
"Peru",65,3,9,9,1,8,1
"France",65,3,6,7,3,4,2
"Argentina",65,4,7,6,1,5,1
"Nigeria",65,4,4,3,3,0,2
"Uruguay",66,1,7,6,1,5,1
"Russia",66,1,5,5,4,1,2
"Portugal",66,2,7,8,3,5,1
"Iran",66,2,5,5,4,1,2
"Peru",66,3,9,10,2,8,1
"Australia",66,3,6,3,3,0,2
"Nigeria",66,4,6,4,2,2,1
"Argentina",66,4,5,5,3,2,2
"Colombia",66,8,7,6,1,5,1
"Japan",66,8,6,4,3,1,2
"Spain",67,2,7,6,2,4,1
"Iran",67,2,5,4,3,1,2
"Argentina",67,4,9,7,2,5,1
"Iceland",67,4,4,3,4,-1,2
"Costa Rica",67,5,7,4,1,3,1
"Brazil",67,5,4,5,4,1,2
"England",67,7,9,7,1,6,1
"Panama",67,7,4,2,3,-1,2
"Spain",68,2,9,9,2,7,1
"Portugal",68,2,6,6,6,0,2
"Australia",68,3,7,4,0,4,1
"France",68,3,5,3,1,2,2
"Brazil",68,5,6,6,4,2,1
"Serbia",68,5,5,3,2,1,2
"Mexico",68,6,7,10,4,6,1
"Sweden",68,6,4,5,8,-3,2
"Colombia",68,8,7,5,3,2,1
"Poland",68,8,6,3,2,1,2
"Croatia",69,4,9,7,1,6,1
"Argentina",69,4,6,9,3,6,2
"Brazil",69,5,7,9,3,6,1
"Serbia",69,5,5,4,3,1,2
"England",69,7,7,4,1,3,1
"Belgium",69,7,6,4,2,2,2
"Colombia",69,8,7,2,0,2,1
"Poland",69,8,5,1,0,1,2
"Portugal",70,2,9,6,1,5,1
"Iran",70,2,4,3,4,-1,2
"Croatia",70,4,7,6,2,4,1
"Argentina",70,4,6,8,2,6,2
"England",70,7,9,7,1,6,1
"Belgium",70,7,6,5,4,1,2
"Uruguay",71,1,7,8,3,5,1
"Russia",71,1,4,4,4,0,2
"France",71,3,5,6,2,4,1
"Australia",71,3,4,3,5,-2,2
"Argentina",71,4,9,6,0,6,1
"Croatia",71,4,6,2,1,1,2
"Mexico",71,6,7,4,1,3,1
"Sweden",71,6,4,4,3,1,2
"Belgium",71,7,9,6,0,6,1
"England",71,7,4,5,5,0,2
"Colombia",71,8,7,6,3,3,1
"Japan",71,8,5,4,2,2,2
"Uruguay",72,1,9,6,1,5,1
"Egypt",72,1,6,9,2,7,2
"France",72,3,9,6,0,6,1
"Peru",72,3,4,1,1,0,2
"Brazil",72,5,9,7,1,6,1
"Switzerland",72,5,4,3,3,0,2
"England",72,7,7,5,3,2,1
"Belgium",72,7,5,5,2,3,2
"Uruguay",73,1,7,7,4,3,1
"Russia",73,1,4,4,4,0,2
"Portugal",73,2,7,6,4,2,1
"Spain",73,2,5,6,1,5,2
"Iceland",73,4,9,5,2,3,1
"Argentina",73,4,6,6,2,4,2
"Germany",73,6,9,5,0,5,1
"South Korea",73,6,4,1,3,-2,2
"Belgium",73,7,9,6,2,4,1
"Panama",73,7,4,3,3,0,2
"Poland",73,8,7,6,2,4,1
"Japan",73,8,5,3,2,1,2
"Uruguay",74,1,9,5,1,4,1
"Russia",74,1,6,4,4,0,2
"Portugal",74,2,7,6,3,3,1
"Spain",74,2,5,5,4,1,2
"Peru",74,3,7,6,3,3,1
"Denmark",74,3,6,6,3,3,2
"Brazil",74,5,9,11,0,11,1
"Costa Rica",74,5,6,8,5,3,2
"Germany",74,6,7,5,1,4,1
"South Korea",74,6,4,2,2,0,2
"Poland",74,8,7,3,1,2,1
"Colombia",74,8,5,5,1,4,2
"Spain",75,2,7,6,4,2,1
"Iran",75,2,4,2,2,0,2
"France",75,3,9,7,2,5,1
"Australia",75,3,4,4,3,1,2
"Argentina",75,4,9,6,2,4,1
"Iceland",75,4,4,2,3,-1,2
"Germany",75,6,9,4,1,3,1
"Mexico",75,6,4,3,2,1,2
"Belgium",75,7,7,7,1,6,1
"England",75,7,5,7,5,2,2
"Uruguay",76,1,9,10,0,10,1
"Egypt",76,1,4,1,5,-4,2
"Spain",76,2,6,6,2,4,1
"Iran",76,2,5,2,1,1,2
"France",76,3,9,6,1,5,1
"Denmark",76,3,4,3,3,0,2
"England",76,7,9,3,0,3,1
"Belgium",76,7,6,5,3,2,2
"Poland",76,8,7,5,2,3,1
"Senegal",76,8,4,3,3,0,2
"Portugal",77,2,9,8,1,7,1
"Spain",77,2,6,3,1,2,2
"Brazil",77,5,7,9,4,5,1
"Switzerland",77,5,4,5,6,-1,2
"Germany",77,6,7,4,1,3,1
"Mexico",77,6,5,3,2,1,2
"Belgium",77,7,7,5,2,3,1
"England",77,7,6,5,4,1,2
"Colombia",77,8,9,10,3,7,1
"Senegal",77,8,4,4,7,-3,2
"Russia",78,1,7,7,1,6,1
"Uruguay",78,1,5,3,0,3,2
"Portugal",78,2,7,4,1,3,1
"Spain",78,2,5,6,2,4,2
"Argentina",78,4,9,9,2,7,1
"Iceland",78,4,6,4,2,2,2
"Serbia",78,5,5,1,0,1,1
"Brazil",78,5,4,5,3,2,2
"Germany",78,6,7,4,2,2,1
"Mexico",78,6,6,3,2,1,2
"Brazil",79,5,9,7,1,6,1
"Costa Rica",79,5,4,4,4,0,2
"South Korea",79,6,7,5,1,4,1
"Mexico",79,6,5,2,1,1,2
"Poland",79,8,7,3,0,3,1
"Japan",79,8,5,3,0,3,2
"Spain",80,2,7,10,4,6,1
"Iran",80,2,5,4,3,1,2
"France",80,3,9,4,1,3,1
"Australia",80,3,6,6,3,3,2
"Brazil",80,5,7,6,1,5,1
"Switzerland",80,5,6,5,7,-2,2
"South Korea",80,6,7,5,1,4,1
"Germany",80,6,5,3,1,2,2
"Belgium",80,7,7,5,2,3,1
"England",80,7,4,3,3,0,2
"Egypt",81,1,9,6,1,5,1
"Russia",81,1,6,4,3,1,2
"France",81,3,9,8,1,7,1
"Denmark",81,3,4,4,4,0,2
"Argentina",81,4,7,7,0,7,1
"Croatia",81,4,5,2,1,1,2
"Brazil",81,5,9,9,4,5,1
"Serbia",81,5,6,6,6,0,2
"Mexico",81,6,7,4,1,3,1
"Germany",81,6,4,2,3,-1,2
"Panama",81,7,7,4,1,3,1
"England",81,7,6,5,4,1,2
"Colombia",81,8,7,6,3,3,1
"Poland",81,8,6,4,3,1,2
"Spain",82,2,9,8,2,6,1
"Iran",82,2,4,3,4,-1,2
"France",82,3,7,8,1,7,1
"Peru",82,3,6,4,3,1,2
"South Korea",82,6,7,9,3,6,1
"Mexico",82,6,4,6,5,1,2
"Poland",82,8,9,5,0,5,1
"Senegal",82,8,4,3,4,-1,2
"Russia",83,1,7,3,1,2,1
"Uruguay",83,1,6,4,3,1,2
"Iran",83,2,7,4,1,3,1
"Portugal",83,2,6,3,2,1,2
"Croatia",83,4,7,4,1,3,1
"Argentina",83,4,5,2,1,1,2
"Costa Rica",83,5,7,5,3,2,1
"Brazil",83,5,5,5,3,2,2
"Mexico",83,6,9,10,3,7,1
"South Korea",83,6,6,5,7,-2,2
"Belgium",83,7,9,6,2,4,1
"England",83,7,6,5,3,2,2
"France",84,3,7,8,4,4,1
"Peru",84,3,5,4,3,1,2
"Switzerland",84,5,9,4,0,4,1
"Costa Rica",84,5,4,4,3,1,2
"Sweden",84,6,7,5,3,2,1
"Germany",84,6,5,4,1,3,2
"England",84,7,7,6,3,3,1
"Belgium",84,7,6,8,4,4,2
"Uruguay",85,1,7,4,2,2,1
"Russia",85,1,6,4,3,1,2
"Spain",85,2,7,6,3,3,1
"Iran",85,2,6,5,2,3,2
"France",85,3,7,7,2,5,1
"Denmark",85,3,5,3,2,1,2
"Brazil",85,5,9,5,2,3,1
"Costa Rica",85,5,4,5,3,2,2
"Mexico",85,6,7,9,0,9,1
"Germany",85,6,5,4,1,3,2
"England",85,7,9,8,0,8,1
"Belgium",85,7,6,3,2,1,2
"France",86,3,7,5,1,4,1
"Peru",86,3,6,3,3,0,2
"Argentina",86,4,7,6,3,3,1
"Croatia",86,4,6,4,2,2,2
"Brazil",86,5,9,6,2,4,1
"Switzerland",86,5,6,6,3,3,2
"Mexico",86,6,9,5,2,3,1
"South Korea",86,6,4,2,2,0,2
"France",87,3,7,6,2,4,1
"Denmark",87,3,6,3,4,-1,2
"Argentina",87,4,9,10,0,10,1
"Nigeria",87,4,4,5,6,-1,2
"Belgium",87,7,7,5,2,3,1
"Panama",87,7,6,7,2,5,2
"Colombia",87,8,7,4,2,2,1
"Japan",87,8,4,1,1,0,2
"Uruguay",88,1,9,5,0,5,1
"Russia",88,1,4,4,4,0,2
"Australia",88,3,7,5,3,2,1
"France",88,3,6,4,3,1,2
"Iceland",88,4,7,3,1,2,1
"Argentina",88,4,6,5,3,2,2
"Brazil",88,5,9,10,0,10,1
"Costa Rica",88,5,4,2,3,-1,2
"Germany",88,6,7,5,2,3,1
"Mexico",88,6,6,4,2,2,2
"Colombia",88,8,7,4,2,2,1
"Japan",88,8,6,4,3,1,2
"Russia",89,1,9,5,2,3,1
"Egypt",89,1,4,2,2,0,2
"France",89,3,9,4,0,4,1
"Peru",89,3,6,4,3,1,2
"Argentina",89,4,7,7,3,4,1
"Croatia",89,4,5,2,1,1,2
"Colombia",89,8,9,4,0,4,1
"Poland",89,8,4,4,5,-1,2
"Portugal",90,2,7,4,2,2,1
"Spain",90,2,6,5,3,2,2
"Denmark",90,3,6,4,4,0,1
"France",90,3,5,7,4,3,2
"Croatia",90,4,7,5,1,4,1
"Argentina",90,4,6,6,3,3,2
"Brazil",90,5,9,5,0,5,1
"Switzerland",90,5,6,5,4,1,2
"Mexico",90,6,7,7,2,5,1
"Germany",90,6,5,3,2,1,2
"England",90,7,9,7,2,5,1
"Belgium",90,7,6,3,3,0,2
"Japan",90,8,6,4,1,3,1
"Colombia",90,8,5,3,2,1,2
"Uruguay",91,1,7,6,3,3,1
"Saudi Arabia",91,1,6,4,1,3,2
"Portugal",91,2,9,4,0,4,1
"Iran",91,2,4,1,2,-1,2
"Brazil",91,5,9,6,0,6,1
"Serbia",91,5,4,2,3,-1,2
"Germany",91,6,9,9,1,8,1
"Mexico",91,6,6,4,5,-1,2
"Panama",91,7,7,5,2,3,1
"Belgium",91,7,5,3,2,1,2
"Senegal",91,8,7,4,1,3,1
"Poland",91,8,5,7,6,1,2
"Spain",92,2,7,4,2,2,1
"Iran",92,2,6,3,1,2,2
"Croatia",92,4,9,6,0,6,1
"Argentina",92,4,6,4,4,0,2
"Mexico",92,6,7,8,2,6,1
"South Korea",92,6,4,4,5,-1,2
"England",92,7,7,6,2,4,1
"Belgium",92,7,6,6,3,3,2
"Iran",93,2,7,7,4,3,1
"Portugal",93,2,4,3,2,1,2
"Argentina",93,4,7,4,0,4,1
"Croatia",93,4,3,1,1,0,2
"Germany",93,6,9,10,3,7,1
"South Korea",93,6,6,6,4,2,2
"Colombia",93,8,7,6,0,6,1
"Japan",93,8,4,2,4,-2,2
"Uruguay",94,1,9,6,3,3,1
"Saudi Arabia",94,1,4,5,2,3,2
"Iran",94,2,7,6,2,4,1
"Portugal",94,2,5,2,1,1,2
"Argentina",94,4,7,5,2,3,1
"Croatia",94,4,6,2,2,0,2
"Mexico",94,6,7,5,3,2,1
"Germany",94,6,4,3,3,0,2
"England",94,7,9,6,0,6,1
"Belgium",94,7,6,6,2,4,2
"Japan",94,8,7,6,2,4,1
"Poland",94,8,4,3,3,0,2
"Russia",95,1,7,3,0,3,1
"Uruguay",95,1,4,1,1,0,2
"Argentina",95,4,9,8,2,6,1
"Croatia",95,4,6,5,2,3,2
"Panama",95,7,7,8,4,4,1
"England",95,7,5,7,6,1,2
"Japan",95,8,7,5,3,2,1
"Colombia",95,8,6,7,4,3,2
"Uruguay",96,1,9,9,2,7,1
"Russia",96,1,6,4,1,3,2
"Morocco",96,2,7,5,3,2,1
"Spain",96,2,6,4,2,2,2
"France",96,3,9,6,0,6,1
"Peru",96,3,4,1,1,0,2
"Argentina",96,4,7,7,1,6,1
"Croatia",96,4,3,5,5,0,2
"Brazil",96,5,7,5,1,4,1
"Costa Rica",96,5,4,3,4,-1,2
"Belgium",96,7,7,4,1,3,1
"Panama",96,7,5,4,3,1,2
"Russia",97,1,7,6,4,2,1
"Egypt",97,1,5,2,1,1,2
"Australia",97,3,7,3,0,3,1
"Denmark",97,3,4,1,1,0,2
"Nigeria",97,4,7,4,2,2,1
"Iceland",97,4,6,3,2,1,2
"Poland",97,8,7,5,2,3,1
"Japan",97,8,5,5,2,3,2
"Uruguay",98,1,7,6,2,4,1
"Saudi Arabia",98,1,4,3,2,1,2
"Morocco",98,2,9,5,0,5,1
"Spain",98,2,6,2,2,0,2
"Argentina",98,4,7,7,4,3,1
"Iceland",98,4,4,6,3,3,2
"Brazil",98,5,9,5,1,4,1
"Costa Rica",98,5,6,6,3,3,2
"South Korea",98,6,6,4,3,1,1
"Germany",98,6,5,3,2,1,2
"England",98,7,9,9,2,7,1
"Belgium",98,7,6,7,2,5,2
"Poland",98,8,7,3,1,2,1
"Colombia",98,8,4,3,3,0,2
"Belgium",99,7,7,6,4,2,1
"Panama",99,7,5,4,3,1,2
"Poland",99,8,9,5,1,4,1
"Colombia",99,8,4,2,2,0,2
"Spain",100,2,9,5,0,5,1
"Portugal",100,2,6,6,2,4,2
"Argentina",100,4,7,5,2,3,1
"Croatia",100,4,6,5,2,3,2
"Brazil",100,5,7,4,2,2,1
"Switzerland",100,5,4,3,2,1,2
"Russia",101,1,7,5,0,5,1
"Egypt",101,1,6,4,2,2,2
"France",101,3,7,7,4,3,1
"Peru",101,3,4,4,3,1,2
"Argentina",101,4,9,7,1,6,1
"Nigeria",101,4,4,2,4,-2,2
"England",101,7,7,6,3,3,1
"Panama",101,7,5,3,1,2,2
"Russia",102,1,9,6,2,4,1
"Uruguay",102,1,6,3,2,1,2
"Argentina",102,4,9,5,0,5,1
"Croatia",102,4,4,3,4,-1,2
"Senegal",102,8,7,2,0,2,1
"Colombia",102,8,5,2,1,1,2
"Russia",103,1,9,7,2,5,1
"Uruguay",103,1,6,7,2,5,2
"Spain",103,2,7,4,1,3,1
"Iran",103,2,6,4,3,1,2
"France",103,3,9,9,0,9,1
"Australia",103,3,6,5,6,-1,2
"Argentina",103,4,7,6,3,3,1
"Croatia",103,4,6,6,2,4,2
"Brazil",103,5,5,7,3,4,1
"Serbia",103,5,4,4,6,-2,2
"Germany",103,6,9,8,1,7,1
"Mexico",103,6,4,7,3,4,2
"Colombia",103,8,7,3,1,2,1
"Japan",103,8,5,3,1,2,2
"Saudi Arabia",104,1,7,5,1,4,1
"Uruguay",104,1,6,4,2,2,2
"Spain",104,2,9,9,2,7,1
"Portugal",104,2,4,7,2,5,2
"Denmark",104,3,7,3,1,2,1
"France",104,3,4,2,2,0,2
"Argentina",104,4,9,7,0,7,1
"Nigeria",104,4,6,4,4,0,2
"Brazil",104,5,7,7,2,5,1
"Switzerland",104,5,6,5,7,-2,2
"Tunisia",104,7,5,3,2,1,1
"Panama",104,7,4,2,2,0,2
"Colombia",104,8,9,3,0,3,1
"Poland",104,8,4,3,1,2,2
"Spain",105,2,7,8,3,5,1
"Iran",105,2,4,2,4,-2,2
"Croatia",105,4,9,6,2,4,1
"Iceland",105,4,4,2,3,-1,2
"Costa Rica",105,5,7,4,1,3,1
"Brazil",105,5,6,5,2,3,2
"Argentina",106,4,7,3,1,2,1
"Iceland",106,4,3,2,2,0,2
"Brazil",106,5,9,5,1,4,1
"Serbia",106,5,4,3,2,1,2
"Germany",106,6,9,5,1,4,1
"Sweden",106,6,4,2,3,-1,2
"England",106,7,7,3,1,2,1
"Belgium",106,7,6,4,1,3,2
"Iran",107,2,7,3,1,2,1
"Spain",107,2,5,2,0,2,2
"Argentina",107,4,9,9,2,7,1
"Croatia",107,4,6,5,3,2,2
"Colombia",107,8,7,4,2,2,1
"Senegal",107,8,4,6,5,1,2
"Russia",108,1,9,7,0,7,1
"Uruguay",108,1,6,7,1,6,2
"Portugal",108,2,9,5,0,5,1
"Iran",108,2,6,5,2,3,2
"Argentina",108,4,7,6,2,4,1
"Iceland",108,4,5,6,3,3,2
"Spain",109,2,9,8,2,6,1
"Portugal",109,2,6,7,6,1,2
"Argentina",109,4,7,4,1,3,1
"Nigeria",109,4,6,6,3,3,2
"Brazil",109,5,7,9,0,9,1
"Serbia",109,5,5,2,1,1,2
"South Korea",109,6,7,4,2,2,1
"Germany",109,6,5,3,2,1,2
"England",109,7,7,5,1,4,1
"Panama",109,7,4,1,2,-1,2
"Uruguay",110,1,7,4,0,4,1
"Russia",110,1,5,3,0,3,2
"Spain",110,2,7,4,1,3,1
"Portugal",110,2,4,7,6,1,2
"Peru",110,3,9,5,2,3,1
"France",110,3,6,7,2,5,2
"Iceland",110,4,7,4,1,3,1
"Argentina",110,4,6,5,2,3,2
"South Korea",110,6,6,7,5,2,1
"Germany",110,6,5,5,2,3,2
"England",110,7,9,9,3,6,1
"Tunisia",110,7,4,2,3,-1,2
"Japan",110,8,9,6,2,4,1
"Colombia",110,8,4,3,4,-1,2
"Russia",111,1,7,6,2,4,1
"Uruguay",111,1,3,2,2,0,2
"Portugal",111,2,7,5,3,2,1
"Spain",111,2,4,5,4,1,2
"France",111,3,7,10,3,7,1
"Peru",111,3,5,4,3,1,2
"Argentina",111,4,7,5,2,3,1
"Iceland",111,4,4,2,2,0,2
"Brazil",111,5,9,4,1,3,1
"Costa Rica",111,5,6,5,2,3,2
"Mexico",111,6,9,4,1,3,1
"Germany",111,6,4,5,5,0,2
"England",111,7,7,3,0,3,1
"Belgium",111,7,4,5,4,1,2
"Colombia",111,8,7,4,1,3,1
"Japan",111,8,5,3,2,1,2
"Argentina",112,4,9,5,0,5,1
"Croatia",112,4,4,1,1,0,2
"Serbia",112,5,5,3,2,1,1
"Costa Rica",112,5,4,2,2,0,2
"Germany",112,6,7,7,2,5,1
"Mexico",112,6,6,6,3,3,2
"Colombia",112,8,9,8,3,5,1
"Poland",112,8,4,5,3,2,2
"Argentina",113,4,7,8,3,5,1
"Croatia",113,4,4,3,3,0,2
"Brazil",113,5,9,4,0,4,1
"Costa Rica",113,5,4,6,2,4,2
"Germany",113,6,9,11,3,8,1
"Sweden",113,6,4,6,6,0,2
"Colombia",113,8,9,6,0,6,1
"Japan",113,8,6,3,2,1,2
"Uruguay",114,1,7,4,0,4,1
"Egypt",114,1,4,1,2,-1,2
"Spain",114,2,6,2,1,1,1
"Morocco",114,2,5,3,2,1,2
"Argentina",114,4,7,5,0,5,1
"Croatia",114,4,4,4,2,2,2
"Costa Rica",114,5,7,3,0,3,1
"Brazil",114,5,5,3,0,3,2
"Mexico",114,6,9,7,1,6,1
"Germany",114,6,6,3,2,1,2
"Japan",114,8,7,3,1,2,1
"Colombia",114,8,4,2,1,1,2
"Spain",115,2,7,6,0,6,1
"Portugal",115,2,6,5,6,-1,2
"Argentina",115,4,9,7,1,6,1
"Nigeria",115,4,6,3,1,2,2
"Switzerland",115,5,7,4,1,3,1
"Brazil",115,5,6,3,3,0,2
"Germany",115,6,9,12,2,10,1
"Mexico",115,6,6,5,9,-4,2
"France",116,3,7,6,3,3,1
"Denmark",116,3,5,3,2,1,2
"Germany",116,6,7,3,1,2,1
"Sweden",116,6,4,1,1,0,2
"England",116,7,9,9,3,6,1
"Belgium",116,7,6,8,5,3,2
"Spain",117,2,5,4,1,3,1
"Morocco",117,2,4,2,4,-2,2
"France",117,3,7,6,1,5,1
"Australia",117,3,5,2,0,2,2
"Nigeria",117,4,7,3,1,2,1
"Argentina",117,4,4,4,4,0,2
"Germany",117,6,9,7,1,6,1
"Sweden",117,6,6,3,2,1,2
"Belgium",117,7,7,2,0,2,1
"England",117,7,5,2,1,1,2
"Colombia",117,8,7,6,2,4,1
"Poland",117,8,6,8,4,4,2
"Uruguay",118,1,9,6,1,5,1
"Saudi Arabia",118,1,4,2,4,-2,2
"France",118,3,7,8,0,8,1
"Peru",118,3,6,5,6,-1,2
"Brazil",118,5,9,5,1,4,1
"Serbia",118,5,6,6,4,2,2
"Uruguay",119,1,7,5,1,4,1
"Russia",119,1,6,5,3,2,2
"Spain",119,2,7,6,3,3,1
"Morocco",119,2,4,4,5,-1,2
"France",119,3,9,7,2,5,1
"Peru",119,3,6,5,3,2,2
"Argentina",119,4,7,8,2,6,1
"Iceland",119,4,6,4,4,0,2
"Costa Rica",119,5,7,5,3,2,1
"Brazil",119,5,6,8,2,6,2
"England",119,7,7,4,2,2,1
"Tunisia",119,7,6,4,3,1,2
"Poland",119,8,7,8,4,4,1
"Colombia",119,8,4,4,5,-1,2
"Spain",120,2,7,9,5,4,1
"Portugal",120,2,6,3,2,1,2
"France",120,3,9,8,2,6,1
"Australia",120,3,4,5,3,2,2
"Brazil",120,5,9,5,0,5,1
"Costa Rica",120,5,6,4,3,1,2
"Germany",120,6,5,3,2,1,1
"South Korea",120,6,4,4,4,0,2
"Portugal",121,2,9,8,1,7,1
"Spain",121,2,4,6,2,4,2
"Panama",121,7,7,6,3,3,1
"Belgium",121,7,6,6,3,3,2
"Spain",122,2,7,4,2,2,1
"Iran",122,2,5,3,2,1,2
"Nigeria",122,4,7,4,1,3,1
"Argentina",122,4,5,1,0,1,2
"Brazil",122,5,9,4,1,3,1
"Costa Rica",122,5,4,3,3,0,2
"Germany",122,6,9,8,1,7,1
"Mexico",122,6,6,5,4,1,2
"England",122,7,7,3,0,3,1
"Belgium",122,7,4,5,4,1,2
"Colombia",122,8,7,3,0,3,1
"Japan",122,8,4,4,3,1,2
"Saudi Arabia",123,1,9,10,0,10,1
"Uruguay",123,1,4,2,2,0,2
"Iran",123,2,7,5,2,3,1
"Spain",123,2,6,3,2,1,2
"France",123,3,9,6,1,5,1
"Peru",123,3,4,2,3,-1,2
"Mexico",123,6,7,3,1,2,1
"Germany",123,6,6,7,5,2,2
"Belgium",123,7,9,6,3,3,1
"England",123,7,6,5,3,2,2
"Uruguay",124,1,7,6,2,4,1
"Saudi Arabia",124,1,5,3,2,1,2
"France",124,3,7,10,0,10,1
"Denmark",124,3,4,2,7,-5,2
"Argentina",124,4,7,7,2,5,1
"Nigeria",124,4,5,4,3,1,2
"South Korea",124,6,7,6,3,3,1
"Mexico",124,6,6,4,3,1,2
"Belgium",124,7,6,3,3,0,1
"Tunisia",124,7,5,4,2,2,2
"Iran",125,2,9,12,3,9,1
"Spain",125,2,4,6,8,-2,2
"Argentina",125,4,7,6,0,6,1
"Croatia",125,4,5,2,0,2,2
"Costa Rica",125,5,9,3,0,3,1
"Brazil",125,5,4,2,2,0,2
"Germany",125,6,7,5,2,3,1
"Mexico",125,6,6,4,2,2,2
"Uruguay",126,1,7,8,3,5,1
"Egypt",126,1,4,5,7,-2,2
"Spain",126,2,7,5,1,4,1
"Iran",126,2,4,3,4,-1,2
"Australia",126,3,7,4,2,2,1
"France",126,3,5,3,2,1,2
"Croatia",126,4,9,11,3,8,1
"Argentina",126,4,4,3,3,0,2
"Sweden",126,6,7,3,0,3,1
"Germany",126,6,6,6,2,4,2
"Colombia",126,8,9,8,2,6,1
"Senegal",126,8,6,4,4,0,2
"Uruguay",127,1,7,3,0,3,1
"Russia",127,1,4,2,2,0,2
"Australia",127,3,7,5,3,2,1
"Peru",127,3,6,5,2,3,2
"Brazil",127,5,9,8,2,6,1
"Switzerland",127,5,6,6,5,1,2
"Germany",127,6,7,5,3,2,1
"Mexico",127,6,4,2,2,0,2
"Belgium",127,7,9,6,1,5,1
"England",127,7,6,3,2,1,2
"Poland",127,8,6,5,3,2,1
"Senegal",127,8,5,2,1,1,2
"Uruguay",128,1,7,5,3,2,1
"Russia",128,1,5,3,2,1,2
"Iran",128,2,7,3,1,2,1
"Spain",128,2,5,2,1,1,2
"Argentina",128,4,9,5,1,4,1
"Croatia",128,4,6,5,3,2,2
"Brazil",128,5,7,3,0,3,1
"Switzerland",128,5,5,2,1,1,2
"Belgium",128,7,9,7,4,3,1
"England",128,7,4,2,2,0,2
"Poland",128,8,7,6,2,4,1
"Japan",128,8,6,3,2,1,2
"France",129,3,9,10,2,8,1
"Australia",129,3,4,3,5,-2,2
"Iceland",129,4,9,6,2,4,1
"Croatia",129,4,6,6,3,3,2
"Brazil",129,5,7,7,2,5,1
"Serbia",129,5,5,4,3,1,2
"Germany",129,6,7,5,0,5,1
"South Korea",129,6,6,6,4,2,2
"Panama",129,7,9,5,1,4,1
"England",129,7,6,4,3,1,2
"Croatia",130,4,7,6,2,4,1
"Iceland",130,4,4,2,2,0,2
"Brazil",130,5,7,7,4,3,1
"Costa Rica",130,5,4,5,5,0,2
"Mexico",130,6,7,2,0,2,1
"South Korea",130,6,4,3,3,0,2
"Spain",131,2,7,3,1,2,1
"Iran",131,2,4,3,2,1,2
"Belgium",131,7,9,4,0,4,1
"Panama",131,7,6,2,2,0,2
"Poland",131,8,7,4,0,4,1
"Senegal",131,8,4,3,4,-1,2
"Spain",132,2,7,4,2,2,1
"Portugal",132,2,4,2,2,0,2
"Peru",132,3,7,6,3,3,1
"Australia",132,3,4,1,1,0,2
"Croatia",132,4,6,6,5,1,1
"Argentina",132,4,5,5,3,2,2
"Brazil",132,5,7,8,2,6,1
"Costa Rica",132,5,5,3,2,1,2
"Germany",132,6,9,12,2,10,1
"Mexico",132,6,6,5,4,1,2
"Colombia",132,8,9,7,2,5,1
"Japan",132,8,6,3,2,1,2
"Egypt",133,1,7,8,3,5,1
"Uruguay",133,1,3,3,3,0,2
"Spain",133,2,7,6,1,5,1
"Portugal",133,2,6,4,2,2,2
"France",133,3,9,7,0,7,1
"Denmark",133,3,4,2,4,-2,2
"Argentina",133,4,9,7,0,7,1
"Croatia",133,4,4,1,4,-3,2
"Brazil",133,5,7,5,2,3,1
"Serbia",133,5,6,5,2,3,2
"Germany",133,6,7,4,1,3,1
"South Korea",133,6,5,4,3,1,2
"England",133,7,7,3,1,2,1
"Tunisia",133,7,4,2,4,-2,2
"Spain",134,2,9,8,2,6,1
"Portugal",134,2,4,5,4,1,2
"France",134,3,9,8,0,8,1
"Peru",134,3,6,3,3,0,2
"Argentina",134,4,7,6,2,4,1
"Nigeria",134,4,4,5,4,1,2
"Poland",134,8,7,6,4,2,1
"Japan",134,8,6,6,2,4,2
"Russia",135,1,7,5,2,3,1
"Uruguay",135,1,4,5,4,1,2
"Portugal",135,2,7,6,2,4,1
"Spain",135,2,5,7,4,3,2
"Nigeria",135,4,7,5,2,3,1
"Croatia",135,4,5,4,3,1,2
"England",135,7,7,7,1,6,1
"Panama",135,7,5,4,2,2,2
"Poland",135,8,6,7,4,3,1
"Colombia",135,8,5,4,3,1,2
"Spain",136,2,9,8,2,6,1
"Portugal",136,2,6,6,4,2,2
"France",136,3,7,4,2,2,1
"Australia",136,3,4,3,2,1,2
"Argentina",136,4,9,4,0,4,1
"Iceland",136,4,6,3,1,2,2
"Brazil",136,5,7,6,2,4,1
"Costa Rica",136,5,5,3,2,1,2
"Germany",136,6,7,6,4,2,1
"Sweden",136,6,4,4,4,0,2
"Belgium",136,7,9,6,2,4,1
"England",136,7,6,4,2,2,2
"Russia",137,1,9,7,2,5,1
"Egypt",137,1,4,3,5,-2,2
"Peru",137,3,7,5,2,3,1
"France",137,3,6,6,3,3,2
"Argentina",137,4,9,7,1,6,1
"Croatia",137,4,6,5,5,0,2
"Belgium",137,7,7,6,1,5,1
"Tunisia",137,7,4,3,3,0,2
"France",138,3,7,6,1,5,1
"Denmark",138,3,5,2,1,1,2
"Argentina",138,4,9,10,1,9,1
"Croatia",138,4,4,4,5,-1,2
"Costa Rica",138,5,9,6,2,4,1
"Brazil",138,5,6,6,2,4,2
"Germany",138,6,7,4,1,3,1
"South Korea",138,6,6,4,3,1,2
"England",138,7,7,4,2,2,1
"Belgium",138,7,6,6,2,4,2
"Poland",138,8,9,5,2,3,1
"Colombia",138,8,6,2,1,1,2
"France",139,3,7,6,2,4,1
"Denmark",139,3,5,4,3,1,2
"Croatia",139,4,7,5,3,2,1
"Argentina",139,4,6,5,2,3,2
"South Korea",139,6,7,5,3,2,1
"Germany",139,6,6,5,4,1,2
"Belgium",139,7,7,2,0,2,1
"Panama",139,7,5,3,2,1,2
"Spain",140,2,7,3,0,3,1
"Portugal",140,2,5,4,3,1,2
"Argentina",140,4,9,9,2,7,1
"Iceland",140,4,4,3,3,0,2
"Belgium",140,7,6,4,2,2,1
"England",140,7,5,3,2,1,2
"Colombia",140,8,9,5,1,4,1
"Japan",140,8,4,1,1,0,2
"Uruguay",141,1,9,9,2,7,1
"Russia",141,1,4,2,5,-3,2
"Iran",141,2,7,9,2,7,1
"Portugal",141,2,6,8,5,3,2
"Argentina",141,4,7,5,1,4,1
"Nigeria",141,4,4,2,3,-1,2
"Switzerland",141,5,7,5,1,4,1
"Costa Rica",141,5,5,3,1,2,2
"England",141,7,9,10,2,8,1
"Belgium",141,7,4,2,2,0,2
"Uruguay",142,1,9,6,3,3,1
"Russia",142,1,4,4,4,0,2
"France",142,3,9,7,1,6,1
"Peru",142,3,4,4,5,-1,2
"Argentina",142,4,7,6,4,2,1
"Iceland",142,4,6,5,3,2,2
"Switzerland",142,5,7,4,1,3,1
"Serbia",142,5,4,3,3,0,2
"Colombia",142,8,7,4,1,3,1
"Japan",142,8,5,4,3,1,2
"Russia",143,1,7,4,1,3,1
"Uruguay",143,1,5,4,1,3,2
"Spain",143,2,7,4,0,4,1
"Portugal",143,2,5,1,0,1,2
"France",143,3,7,3,1,2,1
"Peru",143,3,5,3,2,1,2
"Argentina",143,4,9,6,0,6,1
"Iceland",143,4,6,5,4,1,2
"Switzerland",143,5,7,4,0,4,1
"Brazil",143,5,5,1,0,1,2
"South Korea",143,6,9,7,0,7,1
"Mexico",143,6,4,5,7,-2,2
"Belgium",143,7,7,5,1,4,1
"Tunisia",143,7,6,4,4,0,2
"Poland",143,8,9,9,0,9,1
"Colombia",143,8,4,3,4,-1,2
"Argentina",144,4,9,9,1,8,1
"Croatia",144,4,4,3,1,2,2
"Brazil",144,5,9,5,1,4,1
"Serbia",144,5,4,3,3,0,2
"Germany",144,6,7,4,0,4,1
"South Korea",144,6,4,2,1,1,2
"Poland",144,8,7,3,1,2,1
"Japan",144,8,5,4,2,2,2
"Uruguay",145,1,7,5,1,4,1
"Saudi Arabia",145,1,5,3,1,2,2
"Spain",145,2,5,4,1,3,1
"Morocco",145,2,4,2,4,-2,2
"Croatia",145,4,7,3,1,2,1
"Iceland",145,4,5,2,1,1,2
"Serbia",145,5,7,4,0,4,1
"Switzerland",145,5,4,1,1,0,2
"Mexico",145,6,7,5,3,2,1
"Germany",145,6,6,5,2,3,2
"England",145,7,7,5,3,2,1
"Belgium",145,7,6,4,3,1,2
"Colombia",145,8,7,4,1,3,1
"Japan",145,8,4,3,1,2,2
"Russia",146,1,9,6,0,6,1
"Egypt",146,1,6,4,3,1,2
"Spain",146,2,7,2,0,2,1
"Iran",146,2,6,4,1,3,2
"France",146,3,9,5,1,4,1
"Australia",146,3,4,4,4,0,2
"Brazil",146,5,9,7,0,7,1
"Costa Rica",146,5,4,2,2,0,2
"Belgium",146,7,7,4,2,2,1
"England",146,7,6,4,1,3,2
"Colombia",146,8,7,4,2,2,1
"Poland",146,8,5,3,2,1,2
"Spain",147,2,7,5,0,5,1
"Portugal",147,2,6,9,2,7,2
"Brazil",147,5,7,3,0,3,1
"Switzerland",147,5,6,8,3,5,2
"South Korea",147,6,7,4,1,3,1
"Mexico",147,6,6,2,1,1,2
"Belgium",147,7,7,7,2,5,1
"Tunisia",147,7,4,2,4,-2,2
"Spain",148,2,7,6,2,4,1
"Morocco",148,2,6,3,2,1,2
"Mexico",148,6,7,8,2,6,1
"South Korea",148,6,6,7,4,3,2
"England",148,7,7,6,1,5,1
"Panama",148,7,6,2,4,-2,2
"Senegal",148,8,7,5,2,3,1
"Japan",148,8,6,4,4,0,2
"Egypt",149,1,7,4,2,2,1
"Saudi Arabia",149,1,4,2,3,-1,2
"Portugal",149,2,7,3,0,3,1
"Spain",149,2,5,5,3,2,2
"Argentina",149,4,7,4,1,3,1
"Croatia",149,4,5,5,3,2,2
"Costa Rica",149,5,7,7,4,3,1
"Brazil",149,5,4,2,1,1,2
"Japan",149,8,7,4,1,3,1
"Senegal",149,8,4,1,1,0,2
"Saudi Arabia",150,1,7,5,1,4,1
"Uruguay",150,1,5,2,1,1,2
"Croatia",150,4,7,7,2,5,1
"Argentina",150,4,5,6,2,4,2
"Germany",150,6,7,5,3,2,1
"Sweden",150,6,4,1,1,0,2
"England",150,7,7,6,3,3,1
"Belgium",150,7,6,3,1,2,2
"Poland",150,8,7,4,1,3,1
"Japan",150,8,5,3,1,2,2
"Spain",151,2,9,4,1,3,1
"Portugal",151,2,4,5,2,3,2
"Iceland",151,4,7,6,2,4,1
"Argentina",151,4,5,6,3,3,2
"Costa Rica",151,5,7,5,1,4,1
"Serbia",151,5,6,3,4,-1,2
"England",151,7,9,7,1,6,1
"Belgium",151,7,6,2,2,0,2
"Poland",151,8,7,6,1,5,1
"Colombia",151,8,6,4,4,0,2
"Uruguay",152,1,9,7,1,6,1
"Saudi Arabia",152,1,6,3,3,0,2
"Australia",152,3,6,5,4,1,1
"Peru",152,3,5,2,1,1,2
"Croatia",152,4,6,6,5,1,1
"Argentina",152,4,5,5,3,2,2
"Brazil",152,5,9,9,1,8,1
"Costa Rica",152,5,6,6,5,1,2
"Germany",152,6,9,7,1,6,1
"South Korea",152,6,6,4,4,0,2
"Belgium",152,7,7,4,1,3,1
"England",152,7,5,5,4,1,2
"Colombia",152,8,9,6,1,5,1
"Senegal",152,8,6,4,2,2,2
"Russia",153,1,6,4,3,1,1
"Uruguay",153,1,5,3,2,1,2
"Spain",153,2,9,5,1,4,1
"Portugal",153,2,6,4,1,3,2
"Nigeria",153,4,7,4,1,3,1
"Argentina",153,4,5,2,1,1,2
"England",153,7,9,9,2,7,1
"Belgium",153,7,6,3,2,1,2
"Japan",153,8,7,5,2,3,1
"Colombia",153,8,5,5,4,1,2
"Saudi Arabia",154,1,7,3,1,2,1
"Egypt",154,1,4,2,2,0,2
"Argentina",154,4,7,4,2,2,1
"Croatia",154,4,4,5,5,0,2
"Costa Rica",154,5,7,4,1,3,1
"Brazil",154,5,6,6,6,0,2
"Mexico",154,6,9,6,1,5,1
"Germany",154,6,4,3,3,0,2
"Uruguay",155,1,9,7,1,6,1
"Saudi Arabia",155,1,6,5,5,0,2
"France",155,3,7,4,1,3,1
"Peru",155,3,6,2,1,1,2
"Germany",155,6,7,6,2,4,1
"Mexico",155,6,5,4,3,1,2
"Belgium",155,7,7,5,2,3,1
"England",155,7,6,7,4,3,2
"Russia",156,1,7,4,2,2,1
"Egypt",156,1,4,5,4,1,2
"Spain",156,2,9,7,0,7,1
"Iran",156,2,4,2,4,-2,2
"Germany",156,6,7,4,0,4,1
"Mexico",156,6,5,2,1,1,2
"Belgium",156,7,9,5,2,3,1
"Panama",156,7,6,3,1,2,2
"Egypt",157,1,9,5,2,3,1
"Russia",157,1,6,7,5,2,2
"Iran",157,2,9,7,3,4,1
"Spain",157,2,6,5,4,1,2
"France",157,3,9,8,2,6,1
"Peru",157,3,4,2,4,-2,2
"Argentina",157,4,9,6,2,4,1
"Iceland",157,4,6,5,2,3,2
"Costa Rica",157,5,9,7,4,3,1
"Brazil",157,5,4,4,4,0,2
"Belgium",157,7,7,5,2,3,1
"Panama",157,7,5,1,0,1,2
"Japan",157,8,7,4,1,3,1
"Poland",157,8,6,4,3,1,2
"Egypt",158,1,7,6,3,3,1
"Uruguay",158,1,5,4,1,3,2
"Argentina",158,4,7,6,1,5,1
"Iceland",158,4,6,7,3,4,2
"Brazil",158,5,7,7,1,6,1
"Costa Rica",158,5,4,3,4,-1,2
"Germany",158,6,9,5,2,3,1
"Mexico",158,6,6,6,2,4,2
"England",158,7,7,12,5,7,1
"Belgium",158,7,5,7,6,1,2
"Uruguay",159,1,7,3,0,3,1
"Russia",159,1,4,2,2,0,2
"France",159,3,7,8,4,4,1
"Australia",159,3,6,3,3,0,2
"Croatia",159,4,7,5,1,4,1
"Argentina",159,4,6,9,1,8,2
"Costa Rica",159,5,7,5,1,4,1
"Brazil",159,5,6,4,4,0,2
"Russia",160,1,7,7,3,4,1
"Uruguay",160,1,4,5,6,-1,2
"France",160,3,7,5,1,4,1
"Australia",160,3,4,2,3,-1,2
"Brazil",160,5,7,5,1,4,1
"Costa Rica",160,5,6,3,4,-1,2
"Belgium",160,7,9,6,2,4,1
"Panama",160,7,6,5,4,1,2
"Egypt",161,1,7,3,1,2,1
"Uruguay",161,1,6,3,1,2,2
"Croatia",161,4,7,8,3,5,1
"Iceland",161,4,5,3,2,1,2
"Sweden",161,6,9,8,1,7,1
"Germany",161,6,6,4,3,1,2
"Poland",161,8,6,5,3,2,1
"Colombia",161,8,5,2,1,1,2
"Uruguay",162,1,9,6,1,5,1
"Egypt",162,1,6,5,2,3,2
"Portugal",162,2,9,4,1,3,1
"Spain",162,2,6,6,2,4,2
"Brazil",162,5,9,6,1,5,1
"Serbia",162,5,4,3,2,1,2
"Germany",162,6,7,7,1,6,1
"South Korea",162,6,4,2,2,0,2
"Panama",162,7,9,9,4,5,1
"Tunisia",162,7,6,5,4,1,2
"Uruguay",163,1,7,6,2,4,1
"Russia",163,1,5,4,3,1,2
"Spain",163,2,7,6,2,4,1
"Portugal",163,2,6,6,5,1,2
"Peru",163,3,7,7,4,3,1
"Denmark",163,3,6,5,3,2,2
"Japan",163,8,9,4,1,3,1
"Senegal",163,8,4,3,3,0,2
"Egypt",164,1,7,5,3,2,1
"Uruguay",164,1,6,4,2,2,2
"Portugal",164,2,5,6,2,4,1
"Spain",164,2,4,4,5,-1,2
"France",164,3,7,7,1,6,1
"Peru",164,3,5,3,1,2,2
"Brazil",164,5,7,3,1,2,1
"Costa Rica",164,5,6,3,2,1,2
"England",164,7,7,6,3,3,1
"Belgium",164,7,6,2,1,1,2
"Poland",164,8,7,6,2,4,1
"Colombia",164,8,5,6,3,3,2
"Uruguay",165,1,9,7,1,6,1
"Russia",165,1,6,6,5,1,2
"Croatia",165,4,5,5,4,1,1
"Argentina",165,4,4,5,5,0,2
"Brazil",165,5,9,8,3,5,1
"Switzerland",165,5,6,4,2,2,2
"Tunisia",165,7,7,4,2,2,1
"Belgium",165,7,5,4,3,1,2
"Poland",165,8,9,6,0,6,1
"Japan",165,8,6,5,3,2,2
"Russia",166,1,7,7,3,4,1
"Egypt",166,1,5,5,4,1,2
"Morocco",166,2,7,3,1,2,1
"Portugal",166,2,5,6,3,3,2
"France",166,3,7,5,2,3,1
"Australia",166,3,4,3,6,-3,2
"Brazil",166,5,7,7,0,7,1
"Switzerland",166,5,4,2,3,-1,2
"Mexico",167,6,7,4,0,4,1
"Germany",167,6,6,6,3,3,2
"England",167,7,7,6,2,4,1
"Belgium",167,7,5,4,1,3,2
"Japan",167,8,7,6,2,4,1
"Colombia",167,8,5,4,3,1,2
"Spain",168,2,9,4,1,3,1
"Portugal",168,2,6,4,1,3,2
"France",168,3,5,5,3,2,1
"Australia",168,3,4,2,3,-1,2
"Switzerland",168,5,9,6,1,5,1
"Brazil",168,5,6,4,3,1,2
"Germany",168,6,9,3,0,3,1
"Mexico",168,6,4,3,3,0,2
"Spain",169,2,9,3,0,3,1
"Morocco",169,2,4,2,2,0,2
"France",169,3,9,9,2,7,1
"Denmark",169,3,4,3,3,0,2
"Germany",169,6,7,6,3,3,1
"Sweden",169,6,4,2,2,0,2
"England",169,7,7,5,2,3,1
"Panama",169,7,6,4,4,0,2
"Senegal",169,8,7,5,3,2,1
"Poland",169,8,6,7,2,5,2
"Spain",170,2,9,5,0,5,1
"Iran",170,2,6,5,2,3,2
"France",170,3,9,6,0,6,1
"Denmark",170,3,4,4,3,1,2
"Argentina",170,4,9,5,2,3,1
"Croatia",170,4,6,5,2,3,2
"England",170,7,7,6,3,3,1
"Belgium",170,7,6,8,3,5,2
"Russia",171,1,9,3,0,3,1
"Uruguay",171,1,6,4,1,3,2
"Portugal",171,2,7,6,2,4,1
"Spain",171,2,4,4,4,0,2
"France",171,3,7,6,1,5,1
"Peru",171,3,6,2,1,1,2
"Croatia",171,4,7,5,2,3,1
"Argentina",171,4,6,8,5,3,2
"Belgium",171,7,7,7,2,5,1
"England",171,7,6,6,7,-1,2
"Poland",171,8,7,4,2,2,1
"Colombia",171,8,4,2,2,0,2
"Russia",172,1,7,5,1,4,1
"Egypt",172,1,3,0,0,0,2
"France",172,3,6,5,4,1,1
"Peru",172,3,5,6,5,1,2
"Argentina",172,4,9,11,1,10,1
"Nigeria",172,4,6,5,7,-2,2
"Switzerland",172,5,7,6,1,5,1
"Costa Rica",172,5,6,2,2,0,2
"Sweden",172,6,6,7,4,3,1
"Mexico",172,6,5,4,3,1,2
"Senegal",172,8,7,5,3,2,1
"Poland",172,8,5,5,2,3,2
"Russia",173,1,6,4,3,1,1
"Egypt",173,1,5,5,4,1,2
"Brazil",173,5,9,6,0,6,1
"Serbia",173,5,4,1,3,-2,2
"South Korea",173,6,9,5,1,4,1
"Germany",173,6,6,4,1,3,2
"Belgium",173,7,7,3,1,2,1
"England",173,7,5,3,0,3,2
"Poland",173,8,7,5,2,3,1
"Colombia",173,8,6,3,2,1,2
"Egypt",174,1,6,5,3,2,1
"Russia",174,1,5,3,2,1,2
"Iran",174,2,7,10,3,7,1
"Portugal",174,2,6,5,2,3,2
"France",174,3,9,5,1,4,1
"Peru",174,3,4,3,3,0,2
"Serbia",174,5,7,4,1,3,1
"Brazil",174,5,4,3,2,1,2
"Japan",174,8,9,5,1,4,1
"Senegal",174,8,6,4,3,1,2
"Russia",175,1,9,7,1,6,1
"Uruguay",175,1,6,5,3,2,2
"Spain",175,2,7,9,2,7,1
"Iran",175,2,5,5,3,2,2
"Nigeria",175,4,7,5,2,3,1
"Argentina",175,4,6,4,1,3,2
"Costa Rica",175,5,9,6,3,3,1
"Brazil",175,5,6,6,3,3,2
"Mexico",175,6,7,4,1,3,1
"Sweden",175,6,6,4,2,2,2
"England",175,7,6,6,3,3,1
"Panama",175,7,5,4,3,1,2
"Russia",176,1,7,5,1,4,1
"Uruguay",176,1,4,5,4,1,2
"Portugal",176,2,7,4,2,2,1
"Morocco",176,2,4,2,2,0,2
"Mexico",176,6,7,5,1,4,1
"Germany",176,6,6,3,2,1,2
"England",176,7,7,6,2,4,1
"Belgium",176,7,4,1,1,0,2
"Poland",176,8,7,6,2,4,1
"Japan",176,8,4,3,5,-2,2
"Uruguay",177,1,9,8,2,6,1
"Saudi Arabia",177,1,4,3,5,-2,2
"France",177,3,9,8,2,6,1
"Peru",177,3,4,3,4,-1,2
"Iceland",177,4,7,7,3,4,1
"Argentina",177,4,4,6,6,0,2
"Mexico",177,6,7,8,4,4,1
"South Korea",177,6,4,3,3,0,2
"Belgium",177,7,7,4,0,4,1
"Panama",177,7,4,4,4,0,2
"Egypt",178,1,7,6,2,4,1
"Uruguay",178,1,4,3,3,0,2
"Spain",178,2,9,6,2,4,1
"Portugal",178,2,6,5,3,2,2
"France",178,3,9,7,2,5,1
"Australia",178,3,4,2,4,-2,2
"Germany",178,6,5,7,3,4,1
"South Korea",178,6,4,5,5,0,2
"England",178,7,9,10,3,7,1
"Belgium",178,7,4,4,4,0,2
"France",179,3,7,5,3,2,1
"Peru",179,3,5,6,4,2,2
"Poland",179,8,7,5,3,2,1
"Senegal",179,8,5,4,3,1,2
"Uruguay",180,1,9,9,3,6,1
"Egypt",180,1,6,7,4,3,2
"Spain",180,2,9,9,1,8,1
"Portugal",180,2,4,6,7,-1,2
"Iceland",180,4,7,5,1,4,1
"Argentina",180,4,5,5,3,2,2
"Mexico",180,6,7,5,1,4,1
"Germany",180,6,4,4,3,1,2
"Portugal",181,2,7,6,4,2,1
"Morocco",181,2,4,3,3,0,2
"Croatia",181,4,9,5,2,3,1
"Argentina",181,4,6,8,2,6,2
"Argentina",182,4,7,4,2,2,1
"Croatia",182,4,4,2,4,-2,2
"Serbia",182,5,7,4,2,2,1
"Costa Rica",182,5,4,3,3,0,2
"Germany",182,6,7,3,0,3,1
"South Korea",182,6,6,5,3,2,2
"England",182,7,7,8,2,6,1
"Panama",182,7,6,5,5,0,2
"Spain",183,2,7,4,1,3,1
"Portugal",183,2,3,2,2,0,2
"Costa Rica",183,5,7,10,1,9,1
"Brazil",183,5,6,3,5,-2,2
"Sweden",183,6,7,4,0,4,1
"Mexico",183,6,4,2,2,0,2
"England",183,7,7,5,2,3,1
"Belgium",183,7,6,6,5,1,2
"Senegal",183,8,7,4,2,2,1
"Colombia",183,8,4,3,3,0,2
"Uruguay",184,1,9,6,2,4,1
"Russia",184,1,6,6,2,4,2
"Spain",184,2,7,6,3,3,1
"Iran",184,2,4,4,3,1,2
"France",184,3,9,9,1,8,1
"Peru",184,3,4,5,4,1,2
"Argentina",184,4,9,7,0,7,1
"Croatia",184,4,6,4,3,1,2
"Brazil",184,5,7,3,1,2,1
"Switzerland",184,5,4,5,6,-1,2
"South Korea",184,6,7,5,2,3,1
"Sweden",184,6,6,4,1,3,2
"Uruguay",185,1,9,11,0,11,1
"Saudi Arabia",185,1,4,2,6,-4,2
"Portugal",185,2,7,7,4,3,1
"Iran",185,2,6,4,2,2,2
"Croatia",185,4,9,8,2,6,1
"Iceland",185,4,6,5,5,0,2
"Brazil",185,5,6,4,3,1,1
"Switzerland",185,5,5,6,3,3,2
"Belgium",185,7,6,9,3,6,1
"England",185,7,5,4,3,1,2
"Colombia",185,8,7,3,1,2,1
"Poland",185,8,6,3,2,1,2
"Egypt",186,1,7,6,3,3,1
"Uruguay",186,1,4,4,3,1,2
"Portugal",186,2,9,7,2,5,1
"Iran",186,2,6,5,4,1,2
"Peru",186,3,5,4,2,2,1
"Denmark",186,3,4,3,4,-1,2
"Belgium",186,7,7,6,1,5,1
"England",186,7,4,1,2,-1,2
"Poland",186,8,7,6,3,3,1
"Japan",186,8,4,4,5,-1,2
"Spain",187,2,9,10,3,7,1
"Morocco",187,2,6,2,2,0,2
"Peru",187,3,9,3,0,3,1
"France",187,3,6,4,2,2,2
"Brazil",187,5,9,7,1,6,1
"Costa Rica",187,5,6,7,4,3,2
"Germany",187,6,9,8,1,7,1
"Mexico",187,6,6,6,3,3,2
"Poland",187,8,7,3,0,3,1
"Japan",187,8,6,2,2,0,2
"Egypt",188,1,7,4,2,2,1
"Uruguay",188,1,5,3,1,2,2
"Spain",188,2,7,3,1,2,1
"Morocco",188,2,4,3,2,1,2
"France",188,3,7,5,3,2,1
"Australia",188,3,5,5,4,1,2
"Argentina",188,4,7,5,1,4,1
"Croatia",188,4,6,3,2,1,2
"Belgium",188,7,9,5,1,4,1
"England",188,7,6,7,2,5,2
"Colombia",188,8,7,5,2,3,1
"Japan",188,8,6,6,3,3,2
"Portugal",189,2,9,7,3,4,1
"Spain",189,2,6,6,6,0,2
"England",189,7,7,7,3,4,1
"Belgium",189,7,5,5,3,2,2
"Spain",190,2,6,6,3,3,1
"Portugal",190,2,5,3,1,2,2
"France",190,3,7,6,2,4,1
"Peru",190,3,4,5,5,0,2
"Croatia",190,4,9,6,1,5,1
"Iceland",190,4,4,5,5,0,2
"Brazil",190,5,7,6,4,2,1
"Costa Rica",190,5,5,5,2,3,2
"Belgium",190,7,7,3,1,2,1
"England",190,7,6,7,1,6,2
"Colombia",190,8,7,6,3,3,1
"Poland",190,8,3,0,0,0,2
"Saudi Arabia",191,1,7,5,2,3,1
"Uruguay",191,1,5,3,1,2,2
"Spain",191,2,9,7,1,6,1
"Iran",191,2,4,6,7,-1,2
"Brazil",191,5,9,7,1,6,1
"Costa Rica",191,5,6,6,3,3,2
"Germany",191,6,7,5,1,4,1
"Mexico",191,6,6,3,3,0,2
"France",192,3,9,5,2,3,1
"Australia",192,3,4,2,2,0,2
"Uruguay",193,1,9,8,0,8,1
"Russia",193,1,6,8,5,3,2
"Iran",193,2,9,12,5,7,1
"Spain",193,2,6,5,3,2,2
"Argentina",193,4,9,4,0,4,1
"Croatia",193,4,4,5,3,2,2
"Costa Rica",193,5,7,6,3,3,1
"Switzerland",193,5,4,6,4,2,2
"Poland",193,8,7,10,1,9,1
"Colombia",193,8,5,5,3,2,2
"Uruguay",194,1,7,8,3,5,1
"Russia",194,1,4,4,3,1,2
"Spain",194,2,7,6,1,5,1
"Morocco",194,2,4,1,3,-2,2
"France",194,3,7,7,5,2,1
"Australia",194,3,4,5,4,1,2
"South Korea",194,6,7,4,1,3,1
"Germany",194,6,6,5,3,2,2
"England",194,7,7,3,0,3,1
"Belgium",194,7,6,5,1,4,2
"Japan",194,8,9,5,1,4,1
"Colombia",194,8,6,8,3,5,2
"France",195,3,9,7,0,7,1
"Denmark",195,3,4,2,2,0,2
"Croatia",195,4,9,6,0,6,1
"Iceland",195,4,6,5,3,2,2
"Germany",195,6,7,6,3,3,1
"Mexico",195,6,4,7,7,0,2
"Panama",195,7,7,7,3,4,1
"England",195,7,5,3,2,1,2
"Poland",195,8,7,5,2,3,1
"Japan",195,8,4,3,3,0,2
"Portugal",196,2,7,6,4,2,1
"Spain",196,2,4,6,7,-1,2
"Denmark",196,3,7,7,2,5,1
"France",196,3,5,3,1,2,2
"Argentina",196,4,7,5,2,3,1
"Nigeria",196,4,4,5,4,1,2
"South Korea",196,6,7,6,2,4,1
"Mexico",196,6,6,3,3,0,2
"Portugal",197,2,7,7,5,2,1
"Iran",197,2,6,8,4,4,2
"Denmark",197,3,7,3,0,3,1
"Australia",197,3,4,3,3,0,2
"Iceland",197,4,7,8,4,4,1
"Argentina",197,4,5,7,4,3,2
"Costa Rica",197,5,7,5,3,2,1
"Brazil",197,5,4,3,2,1,2
"England",197,7,9,10,2,8,1
"Belgium",197,7,4,4,3,1,2
"Colombia",197,8,9,6,2,4,1
"Japan",197,8,6,4,3,1,2
"Uruguay",198,1,7,5,2,3,1
"Egypt",198,1,4,3,3,0,2
"Australia",198,3,7,4,2,2,1
"Peru",198,3,6,3,2,1,2
"Argentina",198,4,7,6,2,4,1
"Iceland",198,4,6,4,2,2,2
"Brazil",198,5,7,9,7,2,1
"Costa Rica",198,5,4,4,4,0,2
"Belgium",198,7,9,12,5,7,1
"England",198,7,6,5,5,0,2
"Japan",198,8,9,6,1,5,1
"Colombia",198,8,4,3,3,0,2
"Croatia",199,4,9,10,4,6,1
"Nigeria",199,4,6,4,3,1,2
"Switzerland",199,5,7,3,1,2,1
"Serbia",199,5,5,4,2,2,2
"South Korea",199,6,9,4,1,3,1
"Germany",199,6,6,5,3,2,2
"Japan",199,8,6,3,2,1,1
"Poland",199,8,5,2,0,2,2
"Uruguay",200,1,7,3,1,2,1
"Russia",200,1,5,3,1,2,2
"France",200,3,7,5,0,5,1
"Peru",200,3,6,7,3,4,2
"Argentina",200,4,9,6,1,5,1
"Croatia",200,4,4,6,2,4,2
"South Korea",200,6,7,3,1,2,1
"Germany",200,6,6,5,2,3,2
"Belgium",200,7,7,5,3,2,1
"England",200,7,5,2,1,1,2
"Colombia",200,8,7,6,1,5,1
"Poland",200,8,4,4,3,1,2
"Peru",201,3,9,6,2,4,1
"France",201,3,6,6,4,2,2
"Argentina",201,4,9,4,0,4,1
"Croatia",201,4,6,3,1,2,2
"Colombia",201,8,9,7,0,7,1
"Poland",201,8,6,6,3,3,2
"Spain",202,2,7,5,0,5,1
"Portugal",202,2,5,2,0,2,2
"Germany",202,6,7,4,1,3,1
"South Korea",202,6,6,3,1,2,2
"England",202,7,9,5,1,4,1
"Belgium",202,7,6,6,2,4,2
"Uruguay",203,1,9,10,2,8,1
"Egypt",203,1,4,4,5,-1,2
"Spain",203,2,9,5,0,5,1
"Iran",203,2,4,3,2,1,2
"France",203,3,9,4,0,4,1
"Peru",203,3,6,3,2,1,2
"Brazil",203,5,7,6,0,6,1
"Switzerland",203,5,3,0,0,0,2
"Mexico",203,6,9,5,2,3,1
"Sweden",203,6,4,3,2,1,2
"England",203,7,7,4,2,2,1
"Belgium",203,7,5,5,2,3,2
"Spain",204,2,7,4,1,3,1
"Iran",204,2,6,4,2,2,2
"Denmark",204,3,9,4,1,3,1
"France",204,3,4,6,5,1,2
"Argentina",204,4,9,5,1,4,1
"Iceland",204,4,4,6,5,1,2
"Brazil",204,5,7,4,1,3,1
"Switzerland",204,5,5,4,1,3,2
"Mexico",204,6,5,3,2,1,1
"Germany",204,6,4,4,3,1,2
"Belgium",204,7,9,9,1,8,1
"Panama",204,7,6,4,3,1,2
"Uruguay",205,1,6,4,3,1,1
"Russia",205,1,5,3,1,2,2
"Spain",205,2,6,8,2,6,1
"Portugal",205,2,5,3,2,1,2
"France",205,3,7,3,1,2,1
"Peru",205,3,4,1,1,0,2
"Japan",205,8,7,4,1,3,1
"Poland",205,8,4,3,5,-2,2
"Uruguay",206,1,9,5,0,5,1
"Russia",206,1,6,5,5,0,2
"Argentina",206,4,7,6,0,6,1
"Croatia",206,4,3,0,0,0,2
"Poland",206,8,9,6,1,5,1
"Colombia",206,8,4,4,4,0,2
"Uruguay",207,1,9,7,2,5,1
"Saudi Arabia",207,1,4,3,2,1,2
"Denmark",207,3,5,3,2,1,1
"Peru",207,3,4,2,2,0,2
"Croatia",207,4,7,8,4,4,1
"Argentina",207,4,5,6,4,2,2
"Brazil",207,5,9,7,0,7,1
"Serbia",207,5,6,4,5,-1,2
"Uruguay",208,1,7,5,0,5,1
"Egypt",208,1,4,5,4,1,2
"France",208,3,9,6,3,3,1
"Australia",208,3,4,2,2,0,2
"Argentina",208,4,9,6,2,4,1
"Croatia",208,4,6,6,2,4,2
"Brazil",208,5,7,3,0,3,1
"Costa Rica",208,5,5,3,2,1,2
"South Korea",208,6,7,6,2,4,1
"Mexico",208,6,4,3,4,-1,2
"Belgium",208,7,6,7,3,4,1
"Tunisia",208,7,5,6,5,1,2
"Egypt",209,1,7,5,2,3,1
"Russia",209,1,6,5,3,2,2
"Portugal",209,2,7,5,2,3,1
"Spain",209,2,5,5,3,2,2
"Peru",209,3,7,5,2,3,1
"France",209,3,5,4,3,1,2
"Argentina",209,4,7,5,2,3,1
"Croatia",209,4,6,4,2,2,2
"Brazil",209,5,9,8,0,8,1
"Costa Rica",209,5,6,4,3,1,2
"Germany",209,6,9,8,2,6,1
"Mexico",209,6,6,6,4,2,2
"England",209,7,7,3,1,2,1
"Belgium",209,7,4,3,3,0,2
"Argentina",210,4,7,8,1,7,1
"Croatia",210,4,5,6,5,1,2
"Sweden",210,6,6,4,3,1,1
"Mexico",210,6,5,6,3,3,2
"Iran",211,2,9,5,0,5,1
"Spain",211,2,4,4,3,1,2
"Argentina",211,4,7,3,1,2,1
"Iceland",211,4,4,2,1,1,2
"Brazil",211,5,7,10,3,7,1
"Costa Rica",211,5,6,5,7,-2,2
"Germany",211,6,9,6,3,3,1
"Mexico",211,6,6,4,2,2,2
"Belgium",211,7,5,2,0,2,1
"England",211,7,4,5,4,1,2
"Poland",211,8,7,5,3,2,1
"Colombia",211,8,4,4,2,2,2
"Uruguay",212,1,7,5,1,4,1
"Egypt",212,1,5,2,1,1,2
"Iran",212,2,7,2,0,2,1
"Spain",212,2,5,5,4,1,2
"France",212,3,9,5,0,5,1
"Peru",212,3,6,3,1,2,2
"Argentina",212,4,9,6,0,6,1
"Iceland",212,4,6,6,2,4,2
"Switzerland",212,5,7,2,0,2,1
"Brazil",212,5,6,4,2,2,2
"South Korea",212,6,7,4,2,2,1
"Germany",212,6,6,4,3,1,2
"France",213,3,7,6,1,5,1
"Denmark",213,3,4,3,4,-1,2
"Croatia",213,4,7,4,2,2,1
"Nigeria",213,4,5,3,2,1,2
"Brazil",213,5,7,3,0,3,1
"Costa Rica",213,5,6,4,3,1,2
"Belgium",213,7,7,6,3,3,1
"England",213,7,6,6,3,3,2
"Uruguay",214,1,9,10,2,8,1
"Saudi Arabia",214,1,4,5,3,2,2
"France",214,3,9,5,0,5,1
"Australia",214,3,4,2,3,-1,2
"Belgium",214,7,9,9,0,9,1
"England",214,7,6,6,3,3,2
"Poland",214,8,7,5,1,4,1
"Colombia",214,8,5,4,1,3,2
"Iran",215,2,7,6,2,4,1
"Spain",215,2,6,2,1,1,2
"France",215,3,7,2,0,2,1
"Peru",215,3,5,4,2,2,2
"Switzerland",215,5,7,3,1,2,1
"Brazil",215,5,6,6,2,4,2
"England",215,7,7,5,2,3,1
"Panama",215,7,6,5,2,3,2
"Japan",215,8,7,5,3,2,1
"Colombia",215,8,4,5,4,1,2
"Uruguay",216,1,9,5,1,4,1
"Saudi Arabia",216,1,6,5,3,2,2
"Portugal",216,2,7,8,1,7,1
"Iran",216,2,5,6,3,3,2
"France",216,3,7,5,3,2,1
"Peru",216,3,5,4,2,2,2
"Argentina",216,4,7,3,1,2,1
"Iceland",216,4,4,4,2,2,2
"Germany",216,6,9,4,0,4,1
"Sweden",216,6,4,3,2,1,2
"Belgium",216,7,7,3,0,3,1
"Panama",216,7,6,4,4,0,2
"Spain",217,2,7,5,1,4,1
"Portugal",217,2,6,5,2,3,2
"Denmark",217,3,9,5,0,5,1
"Peru",217,3,4,1,3,-2,2
"Iceland",217,4,7,5,2,3,1
"Argentina",217,4,6,4,2,2,2
"Brazil",217,5,7,7,3,4,1
"Costa Rica",217,5,4,3,4,-1,2
"Mexico",217,6,6,5,2,3,1
"South Korea",217,6,5,3,2,1,2
"England",217,7,7,8,3,5,1
"Tunisia",217,7,4,1,3,-2,2
"France",218,3,9,6,1,5,1
"Denmark",218,3,4,3,2,1,2
"Croatia",218,4,7,6,2,4,1
"Argentina",218,4,5,5,4,1,2
"Mexico",218,6,7,4,1,3,1
"Germany",218,6,6,4,3,1,2
"Spain",219,2,9,11,0,11,1
"Iran",219,2,4,3,4,-1,2
"Denmark",219,3,6,5,4,1,1
"Australia",219,3,5,3,2,1,2
"Argentina",219,4,9,9,0,9,1
"Croatia",219,4,6,3,1,2,2
"Germany",219,6,9,8,1,7,1
"Mexico",219,6,6,3,4,-1,2
"Colombia",219,8,7,3,0,3,1
"Poland",219,8,5,3,2,1,2
"Uruguay",220,1,9,6,1,5,1
"Saudi Arabia",220,1,6,5,3,2,2
"France",220,3,9,7,2,5,1
"Australia",220,3,6,6,4,2,2
"Brazil",220,5,7,7,0,7,1
"Switzerland",220,5,6,6,6,0,2
"Germany",220,6,7,8,1,7,1
"Mexico",220,6,6,7,6,1,2
"Belgium",220,7,9,6,2,4,1
"England",220,7,4,4,3,1,2
"Poland",220,8,9,5,0,5,1
"Senegal",220,8,6,5,3,2,2
"Peru",221,3,7,3,1,2,1
"France",221,3,6,7,3,4,2
"Switzerland",221,5,6,5,3,2,1
"Serbia",221,5,5,2,1,1,2
"Portugal",222,2,7,3,1,2,1
"Iran",222,2,6,8,4,4,2
"Brazil",222,5,9,7,2,5,1
"Switzerland",222,5,6,3,3,0,2
"Germany",222,6,9,6,1,5,1
"Mexico",222,6,6,4,3,1,2
"Colombia",222,8,7,3,1,2,1
"Japan",222,8,4,4,2,2,2
"Uruguay",223,1,7,4,2,2,1
"Saudi Arabia",223,1,5,5,4,1,2
"France",223,3,9,9,3,6,1
"Peru",223,3,4,2,3,-1,2
"Croatia",223,4,9,5,1,4,1
"Argentina",223,4,6,5,1,4,2
"Brazil",223,5,7,7,1,6,1
"Switzerland",223,5,4,2,5,-3,2
"Germany",223,6,9,11,3,8,1
"Mexico",223,6,4,4,4,0,2
"Belgium",223,7,7,3,0,3,1
"England",223,7,4,4,4,0,2
"Spain",224,2,9,6,2,4,1
"Portugal",224,2,6,3,2,1,2
"France",224,3,9,4,0,4,1
"Australia",224,3,4,5,4,1,2
"Brazil",224,5,9,7,0,7,1
"Switzerland",224,5,6,4,2,2,2
"Germany",224,6,7,7,5,2,1
"Mexico",224,6,5,6,3,3,2
"England",224,7,7,5,1,4,1
"Belgium",224,7,5,6,2,4,2
"Japan",224,8,9,8,2,6,1
"Poland",224,8,4,5,6,-1,2
"Iran",225,2,5,3,1,2,1
"Spain",225,2,4,3,3,0,2
"Argentina",225,4,7,3,0,3,1
"Nigeria",225,4,6,5,4,1,2
"Germany",225,6,7,4,1,3,1
"South Korea",225,6,6,4,3,1,2
"Tunisia",225,7,7,3,0,3,1
"England",225,7,5,2,0,2,2
"Colombia",225,8,7,3,1,2,1
"Poland",225,8,4,6,7,-1,2
"Uruguay",226,1,7,9,2,7,1
"Egypt",226,1,6,4,6,-2,2
"Portugal",226,2,7,8,0,8,1
"Iran",226,2,6,6,4,2,2
"Argentina",226,4,7,3,0,3,1
"Croatia",226,4,6,2,1,1,2
"South Korea",226,6,9,8,1,7,1
"Germany",226,6,4,3,5,-2,2
"Belgium",226,7,7,5,2,3,1
"England",226,7,5,3,0,3,2
"Colombia",226,8,7,8,2,6,1
"Poland",226,8,6,4,4,0,2
"France",227,3,9,7,1,6,1
"Peru",227,3,6,7,2,5,2
"Argentina",227,4,7,5,2,3,1
"Croatia",227,4,4,2,2,0,2
"Mexico",227,6,7,2,0,2,1
"Germany",227,6,6,4,2,2,2
"Colombia",227,8,9,5,2,3,1
"Japan",227,8,6,5,2,3,2
"Iran",228,2,9,5,1,4,1
"Spain",228,2,6,7,1,6,2
"France",228,3,7,8,5,3,1
"Denmark",228,3,4,4,4,0,2
"Argentina",228,4,9,8,1,7,1
"Croatia",228,4,4,5,3,2,2
"Germany",228,6,7,4,2,2,1
"South Korea",228,6,5,5,2,3,2
"England",228,7,7,7,1,6,1
"Belgium",228,7,4,2,3,-1,2
"Poland",228,8,7,2,0,2,1
"Senegal",228,8,4,2,4,-2,2
"Iran",229,2,6,4,4,0,1
"Spain",229,2,5,5,2,3,2
"Denmark",229,3,9,4,0,4,1
"Australia",229,3,4,2,2,0,2
"Sweden",229,6,7,7,3,4,1
"Germany",229,6,6,8,4,4,2
"England",229,7,9,9,3,6,1
"Belgium",229,7,6,3,3,0,2
"Poland",229,8,7,6,3,3,1
"Colombia",229,8,6,9,4,5,2
"Russia",230,1,9,6,0,6,1
"Uruguay",230,1,6,3,1,2,2
"Peru",230,3,7,4,0,4,1
"France",230,3,5,3,1,2,2
"Croatia",230,4,7,3,0,3,1
"Argentina",230,4,6,4,1,3,2
"Brazil",230,5,9,8,1,7,1
"Switzerland",230,5,6,4,2,2,2
"Panama",230,7,9,3,0,3,1
"England",230,7,4,3,2,1,2
"Saudi Arabia",231,1,7,4,1,3,1
"Egypt",231,1,5,1,0,1,2
"Argentina",231,4,7,5,1,4,1
"Iceland",231,4,6,3,3,0,2
"Portugal",232,2,7,3,1,2,1
"Iran",232,2,4,4,3,1,2
"France",232,3,7,8,4,4,1
"Australia",232,3,5,4,3,1,2
"Brazil",232,5,7,4,1,3,1
"Serbia",232,5,4,2,2,0,2
"South Korea",232,6,9,6,2,4,1
"Mexico",232,6,6,3,2,1,2
"England",232,7,9,8,0,8,1
"Belgium",232,7,4,4,3,1,2
"Uruguay",233,1,9,6,0,6,1
"Russia",233,1,4,3,4,-1,2
"Iran",233,2,7,3,1,2,1
"Spain",233,2,6,3,2,1,2
"Peru",233,3,7,7,2,5,1
"Australia",233,3,6,4,6,-2,2
"Croatia",233,4,6,4,3,1,1
"Nigeria",233,4,5,1,0,1,2
"Germany",233,6,9,8,1,7,1
"Mexico",233,6,6,5,4,1,2
"England",233,7,7,4,0,4,1
"Tunisia",233,7,4,3,4,-1,2
"Spain",234,2,7,4,1,3,1
"Portugal",234,2,5,4,1,3,2
"France",234,3,9,6,1,5,1
"Denmark",234,3,6,3,2,1,2
"Argentina",234,4,7,9,1,8,1
"Croatia",234,4,5,3,1,2,2
"Switzerland",234,5,7,6,2,4,1
"Brazil",234,5,6,4,2,2,2
"England",234,7,9,7,0,7,1
"Belgium",234,7,4,3,3,0,2
"Poland",234,8,7,3,1,2,1
"Colombia",234,8,4,3,3,0,2
"Portugal",235,2,7,6,3,3,1
"Iran",235,2,6,7,6,1,2
"France",235,3,9,7,2,5,1
"Denmark",235,3,6,4,2,2,2
"England",235,7,7,5,1,4,1
"Panama",235,7,5,4,3,1,2
"Japan",235,8,7,7,1,6,1
"Senegal",235,8,6,3,2,1,2
"Egypt",236,1,9,5,2,3,1
"Saudi Arabia",236,1,4,1,1,0,2
"Spain",236,2,7,4,2,2,1
"Iran",236,2,5,5,1,4,2
"Iceland",236,4,9,4,1,3,1
"Croatia",236,4,4,2,2,0,2
"Switzerland",236,5,7,6,2,4,1
"Brazil",236,5,4,2,2,0,2
"Mexico",236,6,7,6,1,5,1
"Germany",236,6,4,4,5,-1,2
"England",236,7,9,5,1,4,1
"Belgium",236,7,4,5,5,0,2
"Uruguay",237,1,7,7,4,3,1
"Saudi Arabia",237,1,5,7,4,3,2
"Peru",237,3,7,6,2,4,1
"France",237,3,4,8,5,3,2
"Brazil",237,5,7,5,2,3,1
"Serbia",237,5,4,3,4,-1,2
"Colombia",237,8,7,5,3,2,1
"Poland",237,8,4,6,6,0,2
"Egypt",238,1,5,3,1,2,1
"Uruguay",238,1,4,3,3,0,2
"Portugal",238,2,9,6,1,5,1
"Spain",238,2,6,6,4,2,2
"Peru",238,3,5,2,1,1,1
"France",238,3,4,5,3,2,2
"Croatia",238,4,7,4,1,3,1
"Iceland",238,4,6,6,4,2,2
"Mexico",238,6,7,6,2,4,1
"South Korea",238,6,6,4,3,1,2
"England",238,7,9,5,1,4,1
"Belgium",238,7,4,3,2,1,2
"Senegal",238,8,9,5,0,5,1
"Colombia",238,8,6,3,1,2,2
"Uruguay",239,1,9,6,3,3,1
"Russia",239,1,4,4,4,0,2
"Iran",239,2,7,5,1,4,1
"Morocco",239,2,6,2,2,0,2
"Denmark",239,3,7,5,1,4,1
"France",239,3,3,1,1,0,2
"Croatia",239,4,7,4,0,4,1
"Argentina",239,4,6,6,6,0,2
"Brazil",239,5,7,3,1,2,1
"Switzerland",239,5,5,3,2,1,2
"Germany",239,6,9,5,1,4,1
"Mexico",239,6,6,4,2,2,2
"England",239,7,9,8,1,7,1
"Belgium",239,7,4,2,2,0,2
"Poland",239,8,7,7,4,3,1
"Colombia",239,8,5,3,1,2,2
"Russia",240,1,7,2,0,2,1
"Uruguay",240,1,4,2,2,0,2
"Costa Rica",240,5,9,7,2,5,1
"Brazil",240,5,4,2,2,0,2
"Germany",240,6,7,5,2,3,1
"South Korea",240,6,6,4,1,3,2
"England",240,7,7,5,2,3,1
"Tunisia",240,7,5,3,2,1,2
"Saudi Arabia",241,1,7,8,2,6,1
"Uruguay",241,1,6,2,3,-1,2
"Portugal",241,2,7,6,2,4,1
"Spain",241,2,4,3,3,0,2
"France",241,3,7,5,2,3,1
"Australia",241,3,5,7,2,5,2
"Argentina",241,4,7,6,1,5,1
"Nigeria",241,4,4,3,4,-1,2
"Brazil",241,5,7,4,1,3,1
"Switzerland",241,5,6,4,1,3,2
"Spain",242,2,9,4,0,4,1
"Portugal",242,2,6,7,2,5,2
"Argentina",242,4,7,3,0,3,1
"Croatia",242,4,4,3,3,0,2
"Costa Rica",242,5,9,4,1,3,1
"Switzerland",242,5,4,4,4,0,2
"Germany",242,6,9,5,0,5,1
"Sweden",242,6,6,4,2,2,2
"England",242,7,7,3,0,3,1
"Belgium",242,7,6,5,2,3,2
"Colombia",242,8,5,3,2,1,1
"Poland",242,8,4,2,2,0,2
"Portugal",243,2,7,6,2,4,1
"Morocco",243,2,6,5,2,3,2
"Iceland",243,4,7,4,0,4,1
"Argentina",243,4,6,4,3,1,2
"Sweden",243,6,7,6,3,3,1
"Germany",243,6,5,5,4,1,2
"Colombia",243,8,7,6,2,4,1
"Poland",243,8,4,3,3,0,2
"Saudi Arabia",244,1,7,3,1,2,1
"Egypt",244,1,6,4,2,2,2
"Portugal",244,2,6,6,4,2,1
"Spain",244,2,5,4,1,3,2
"France",244,3,9,6,0,6,1
"Australia",244,3,4,3,3,0,2
"Brazil",244,5,7,2,0,2,1
"Serbia",244,5,6,4,3,1,2
"Belgium",244,7,9,9,1,8,1
"England",244,7,4,6,4,2,2
"Uruguay",245,1,9,6,1,5,1
"Egypt",245,1,4,3,4,-1,2
"Portugal",245,2,7,5,2,3,1
"Spain",245,2,5,5,3,2,2
"Brazil",245,5,9,9,1,8,1
"Switzerland",245,5,4,3,3,0,2
"Mexico",245,6,7,5,2,3,1
"South Korea",245,6,6,3,2,1,2
"England",245,7,9,3,0,3,1
"Belgium",245,7,6,5,3,2,2
"Portugal",246,2,9,8,2,6,1
"Iran",246,2,6,4,5,-1,2
"France",246,3,7,6,4,2,1
"Australia",246,3,5,2,1,1,2
"Argentina",246,4,7,7,3,4,1
"Croatia",246,4,6,6,4,2,2
"Brazil",246,5,7,8,2,6,1
"Switzerland",246,5,5,2,1,1,2
"South Korea",246,6,7,7,4,3,1
"Germany",246,6,6,4,3,1,2
"Belgium",246,7,7,6,2,4,1
"England",246,7,4,5,4,1,2
"Colombia",246,8,7,2,0,2,1
"Senegal",246,8,6,5,1,4,2
"Spain",247,2,9,14,0,14,1
"Portugal",247,2,6,6,6,0,2
"Peru",247,3,7,6,4,2,1
"France",247,3,5,4,3,1,2
"Argentina",247,4,9,6,3,3,1
"Croatia",247,4,6,7,2,5,2
"South Korea",247,6,7,5,3,2,1
"Germany",247,6,6,6,5,1,2
"Spain",248,2,7,3,0,3,1
"Iran",248,2,3,2,2,0,2
"Argentina",248,4,7,5,2,3,1
"Croatia",248,4,4,2,2,0,2
"Costa Rica",248,5,7,4,0,4,1
"Brazil",248,5,5,1,0,1,2
"Germany",248,6,9,7,0,7,1
"Mexico",248,6,4,4,3,1,2
"Poland",248,8,7,5,1,4,1
"Colombia",248,8,6,4,4,0,2
"Iran",249,2,7,6,2,4,1
"Portugal",249,2,5,6,5,1,2
"Croatia",249,4,7,5,2,3,1
"Argentina",249,4,5,5,4,1,2
"South Korea",249,6,7,7,2,5,1
"Mexico",249,6,5,3,2,1,2
"Panama",249,7,7,3,1,2,1
"Belgium",249,7,4,4,3,1,2
"Uruguay",250,1,9,7,2,5,1
"Saudi Arabia",250,1,6,4,3,1,2
"Portugal",250,2,7,2,0,2,1
"Spain",250,2,5,3,1,2,2
"Argentina",250,4,7,7,4,3,1
"Croatia",250,4,4,5,5,0,2
"Brazil",250,5,9,6,2,4,1
"Switzerland",250,5,6,8,3,5,2
"Sweden",250,6,7,5,2,3,1
"South Korea",250,6,5,4,2,2,2
"England",250,7,7,7,2,5,1
"Belgium",250,7,6,5,2,3,2
"Spain",251,2,9,5,2,3,1
"Iran",251,2,4,4,4,0,2
"France",251,3,7,4,1,3,1
"Denmark",251,3,6,4,3,1,2
"South Korea",251,6,7,6,2,4,1
"Germany",251,6,5,3,2,1,2
"Uruguay",252,1,7,4,0,4,1
"Russia",252,1,5,2,0,2,2
"Spain",252,2,7,3,0,3,1
"Portugal",252,2,4,4,4,0,2
"France",252,3,9,6,2,4,1
"Peru",252,3,6,6,3,3,2
"Argentina",252,4,7,4,2,2,1
"Croatia",252,4,5,6,3,3,2
"Germany",252,6,9,3,0,3,1
"South Korea",252,6,6,4,1,3,2
"Uruguay",253,1,7,2,0,2,1
"Egypt",253,1,6,3,2,1,2
"Portugal",253,2,6,5,4,1,1
"Spain",253,2,5,6,4,2,2
"France",253,3,6,3,3,0,1
"Australia",253,3,5,5,3,2,2
"Brazil",253,5,7,6,2,4,1
"Costa Rica",253,5,5,5,4,1,2
"Sweden",253,6,7,3,1,2,1
"Germany",253,6,5,3,2,1,2
"Poland",253,8,7,4,1,3,1
"Japan",253,8,5,5,2,3,2
"Uruguay",254,1,6,7,1,6,1
"Egypt",254,1,5,2,1,1,2
"Spain",254,2,9,7,3,4,1
"Portugal",254,2,4,7,5,2,2
"Peru",254,3,9,8,1,7,1
"France",254,3,6,5,3,2,2
"Argentina",254,4,9,7,0,7,1
"Croatia",254,4,4,2,4,-2,2
"Costa Rica",254,5,9,5,1,4,1
"Brazil",254,5,6,7,1,6,2
"Germany",254,6,7,7,2,5,1
"Sweden",254,6,4,5,4,1,2
"Uruguay",255,1,7,5,2,3,1
"Russia",255,1,6,4,2,2,2
"Spain",255,2,7,7,4,3,1
"Morocco",255,2,4,3,3,0,2
"Australia",255,3,7,4,2,2,1
"Peru",255,3,3,2,2,0,2
"England",255,7,7,4,2,2,1
"Belgium",255,7,6,6,3,3,2
"Colombia",255,8,7,4,1,3,1
"Japan",255,8,6,6,3,3,2
"Iran",256,2,7,4,2,2,1
"Portugal",256,2,5,3,2,1,2
"Peru",256,3,9,7,2,5,1
"France",256,3,6,5,2,3,2
"Brazil",256,5,9,8,0,8,1
"Costa Rica",256,5,6,6,4,2,2
"England",256,7,7,5,1,4,1
"Panama",256,7,5,2,1,1,2
"Colombia",256,8,7,6,2,4,1
"Poland",256,8,4,4,4,0,2
"Uruguay",257,1,7,10,3,7,1
"Russia",257,1,6,5,4,1,2
"Portugal",257,2,9,7,0,7,1
"Spain",257,2,6,5,3,2,2
"Iceland",257,4,7,3,0,3,1
"Argentina",257,4,6,6,3,3,2
"Costa Rica",257,5,7,4,0,4,1
"Serbia",257,5,6,4,4,0,2
"South Korea",257,6,7,5,2,3,1
"Germany",257,6,6,7,4,3,2
"Spain",258,2,7,6,1,5,1
"Iran",258,2,6,3,2,1,2
"Peru",258,3,7,6,1,5,1
"France",258,3,5,4,1,3,2
"Belgium",258,7,9,6,2,4,1
"England",258,7,6,6,2,4,2
"Colombia",258,8,7,6,2,4,1
"Poland",258,8,5,6,5,1,2
"Spain",259,2,7,7,2,5,1
"Iran",259,2,5,5,3,2,2
"Peru",259,3,7,5,2,3,1
"Denmark",259,3,5,5,2,3,2
"Argentina",259,4,7,5,1,4,1
"Croatia",259,4,4,1,1,0,2
"Costa Rica",259,5,7,6,4,2,1
"Serbia",259,5,5,4,3,1,2
"Germany",259,6,7,9,2,7,1
"Sweden",259,6,5,5,4,1,2
"England",259,7,6,8,5,3,1
"Belgium",259,7,5,5,4,1,2
"Japan",259,8,7,5,3,2,1
"Poland",259,8,5,5,3,2,2
"Spain",260,2,7,2,0,2,1
"Iran",260,2,4,2,3,-1,2
"Argentina",260,4,7,6,2,4,1
"Nigeria",260,4,5,2,1,1,2
"South Korea",260,6,9,6,1,5,1
"Germany",260,6,6,4,3,1,2
"Spain",261,2,7,7,3,4,1
"Morocco",261,2,5,4,3,1,2
"France",261,3,7,7,2,5,1
"Denmark",261,3,4,8,6,2,2
"Sweden",261,6,7,9,2,7,1
"Germany",261,6,6,2,4,-2,2
"England",261,7,7,8,4,4,1
"Belgium",261,7,4,5,4,1,2
"Japan",261,8,6,7,4,3,1
"Senegal",261,8,5,4,3,1,2
"Saudi Arabia",262,1,7,4,1,3,1
"Russia",262,1,6,8,2,6,2
"Portugal",262,2,7,5,1,4,1
"Iran",262,2,6,5,6,-1,2
"France",262,3,9,9,3,6,1
"Denmark",262,3,6,7,9,-2,2
"Mexico",262,6,7,5,1,4,1
"Germany",262,6,5,1,0,1,2
"Belgium",262,7,7,4,2,2,1
"Panama",262,7,5,3,2,1,2
"Colombia",262,8,7,5,2,3,1
"Japan",262,8,4,8,4,4,2
"Uruguay",263,1,7,5,2,3,1
"Russia",263,1,6,3,2,1,2
"Spain",263,2,9,6,0,6,1
"Portugal",263,2,4,2,3,-1,2
"Australia",263,3,7,8,6,2,1
"France",263,3,5,7,5,2,2
"Argentina",263,4,7,4,2,2,1
"Iceland",263,4,5,2,1,1,2
"Iran",264,2,9,9,2,7,1
"Spain",264,2,6,6,3,3,2
"Argentina",264,4,7,5,1,4,1
"Croatia",264,4,6,7,3,4,2
"Brazil",264,5,9,10,1,9,1
"Costa Rica",264,5,4,4,4,0,2
"Germany",264,6,7,5,3,2,1
"South Korea",264,6,4,2,2,0,2
"Senegal",264,8,9,6,2,4,1
"Poland",264,8,6,6,5,1,2
"France",265,3,7,4,1,3,1
"Peru",265,3,5,2,1,1,2
"Croatia",265,4,7,3,0,3,1
"Argentina",265,4,4,3,3,0,2
"Brazil",265,5,9,6,0,6,1
"Costa Rica",265,5,6,4,2,2,2
"Colombia",265,8,7,3,1,2,1
"Poland",265,8,6,4,2,2,2
"France",266,3,7,6,4,2,1
"Denmark",266,3,5,3,1,2,2
"Brazil",266,5,7,4,0,4,1
"Costa Rica",266,5,4,3,3,0,2
"Germany",266,6,9,6,2,4,1
"Mexico",266,6,4,4,5,-1,2
"Russia",267,1,7,3,1,2,1
"Uruguay",267,1,6,6,3,3,2
"Peru",267,3,5,2,1,1,1
"Australia",267,3,4,1,1,0,2
"Argentina",267,4,7,4,1,3,1
"Iceland",267,4,5,3,2,1,2
"Switzerland",267,5,6,3,3,0,1
"Costa Rica",267,5,5,5,3,2,2
"England",267,7,7,7,2,5,1
"Panama",267,7,4,5,7,-2,2
"Spain",268,2,7,8,3,5,1
"Portugal",268,2,5,5,3,2,2
"Peru",268,3,9,7,3,4,1
"Australia",268,3,4,3,3,0,2
"Iceland",268,4,7,3,1,2,1
"Argentina",268,4,5,5,2,3,2
"Costa Rica",268,5,6,4,4,0,1
"Brazil",268,5,5,3,1,2,2
"Colombia",268,8,7,5,2,3,1
"Senegal",268,8,4,3,4,-1,2
"Portugal",269,2,9,6,1,5,1
"Spain",269,2,6,6,3,3,2
"Argentina",269,4,7,6,1,5,1
"Croatia",269,4,6,4,4,0,2
"Brazil",269,5,7,5,3,2,1
"Costa Rica",269,5,6,3,2,1,2
"Germany",269,6,9,6,1,5,1
"South Korea",269,6,6,6,2,4,2
"England",269,7,7,5,1,4,1
"Panama",269,7,6,3,4,-1,2
"Colombia",269,8,7,7,4,3,1
"Poland",269,8,5,5,4,1,2
"Uruguay",270,1,7,4,1,3,1
"Russia",270,1,6,6,4,2,2
"Spain",270,2,9,10,2,8,1
"Portugal",270,2,4,4,3,1,2
"France",270,3,7,8,2,6,1
"Peru",270,3,6,6,5,1,2
"Croatia",270,4,9,6,1,5,1
"Argentina",270,4,6,5,3,2,2
"England",270,7,7,6,2,4,1
"Panama",270,7,4,3,4,-1,2
"Colombia",270,8,7,8,1,7,1
"Poland",270,8,5,3,2,1,2
"Spain",271,2,9,10,1,9,1
"Iran",271,2,4,2,3,-1,2
"Argentina",271,4,9,5,1,4,1
"Croatia",271,4,6,6,3,3,2
"Poland",271,8,7,4,2,2,1
"Colombia",271,8,6,4,2,2,2
"Peru",272,3,7,6,1,5,1
"Australia",272,3,6,5,4,1,2
"Argentina",272,4,7,9,3,6,1
"Nigeria",272,4,4,5,5,0,2
"Brazil",272,5,9,8,1,7,1
"Switzerland",272,5,4,2,2,0,2
"Germany",272,6,7,8,3,5,1
"South Korea",272,6,5,6,4,2,2
"Portugal",273,2,9,4,1,3,1
"Spain",273,2,6,7,3,4,2
"France",273,3,7,4,1,3,1
"Peru",273,3,6,3,3,0,2
"Belgium",273,7,7,10,2,8,1
"England",273,7,5,4,1,3,2
"Spain",274,2,9,6,1,5,1
"Portugal",274,2,4,3,2,1,2
"Brazil",274,5,7,6,4,2,1
"Costa Rica",274,5,4,5,4,1,2
"England",274,7,9,4,1,3,1
"Belgium",274,7,4,3,3,0,2
"Uruguay",275,1,7,7,2,5,1
"Egypt",275,1,5,1,0,1,2
"Argentina",275,4,9,11,1,10,1
"Iceland",275,4,6,3,3,0,2
"Switzerland",275,5,7,8,1,7,1
"Brazil",275,5,4,2,5,-3,2
"England",275,7,7,7,0,7,1
"Panama",275,7,5,3,2,1,2
"France",276,3,9,5,0,5,1
"Australia",276,3,4,2,1,1,2
"Brazil",276,5,9,8,1,7,1
"Switzerland",276,5,4,3,4,-1,2
"Mexico",276,6,7,5,3,2,1
"South Korea",276,6,6,7,3,4,2
"England",276,7,7,6,3,3,1
"Panama",276,7,5,8,5,3,2
"Poland",276,8,6,4,4,0,1
"Colombia",276,8,5,3,0,3,2
"Uruguay",277,1,5,3,2,1,1
"Russia",277,1,4,4,3,1,2
"France",277,3,9,12,0,12,1
"Australia",277,3,6,3,4,-1,2
"Argentina",277,4,6,6,4,2,1
"Croatia",277,4,5,6,3,3,2
"Mexico",277,6,9,6,2,4,1
"Germany",277,6,6,4,2,2,2
"Spain",278,2,7,5,2,3,1
"Portugal",278,2,4,5,3,2,2
"Brazil",278,5,9,6,1,5,1
"Switzerland",278,5,6,4,3,1,2
"Mexico",278,6,7,2,0,2,1
"South Korea",278,6,6,3,1,2,2
"Belgium",278,7,7,5,1,4,1
"Panama",278,7,6,10,5,5,2
"Uruguay",279,1,7,7,3,4,1
"Russia",279,1,5,5,4,1,2
"France",279,3,7,8,3,5,1
"Australia",279,3,5,2,1,1,2
"Nigeria",279,4,5,4,2,2,1
"Croatia",279,4,4,4,4,0,2
"Brazil",279,5,7,9,1,8,1
"Costa Rica",279,5,4,2,6,-4,2
"Germany",279,6,7,7,2,5,1
"Mexico",279,6,6,2,2,0,2
"England",279,7,7,5,2,3,1
"Belgium",279,7,4,4,3,1,2
"Poland",279,8,7,4,1,3,1
"Colombia",279,8,5,4,1,3,2
"Uruguay",280,1,7,4,1,3,1
"Egypt",280,1,5,3,2,1,2
"Spain",280,2,9,7,1,6,1
"Morocco",280,2,6,4,5,-1,2
"France",280,3,9,6,1,5,1
"Australia",280,3,4,4,5,-1,2
"Argentina",280,4,7,6,2,4,1
"Croatia",280,4,6,5,1,4,2
"Costa Rica",280,5,7,4,2,2,1
"Serbia",280,5,5,5,4,1,2
"Panama",280,7,7,3,0,3,1
"England",280,7,5,3,2,1,2
"Senegal",280,8,7,3,1,2,1
"Colombia",280,8,5,1,0,1,2
"Uruguay",281,1,7,4,2,2,1
"Russia",281,1,3,2,2,0,2
"Iran",281,2,9,6,0,6,1
"Portugal",281,2,4,3,2,1,2
"Australia",281,3,7,10,4,6,1
"Denmark",281,3,4,4,7,-3,2
"Croatia",281,4,7,3,0,3,1
"Argentina",281,4,5,4,0,4,2
"Switzerland",281,5,7,2,0,2,1
"Brazil",281,5,6,4,1,3,2
"South Korea",281,6,7,3,1,2,1
"Germany",281,6,4,4,5,-1,2
"Uruguay",282,1,7,7,2,5,1
"Egypt",282,1,5,3,2,1,2
"Portugal",282,2,9,8,2,6,1
"Iran",282,2,6,5,3,2,2
"France",282,3,7,5,0,5,1
"Peru",282,3,4,4,6,-2,2
"Germany",282,6,7,5,0,5,1
"South Korea",282,6,4,4,5,-1,2
"England",282,7,9,5,1,4,1
"Belgium",282,7,6,6,4,2,2
"Colombia",282,8,7,5,2,3,1
"Japan",282,8,5,8,2,6,2
"Uruguay",283,1,7,2,0,2,1
"Saudi Arabia",283,1,5,3,1,2,2
"Argentina",283,4,7,6,2,4,1
"Iceland",283,4,6,6,3,3,2
"Serbia",283,5,7,6,2,4,1
"Brazil",283,5,5,7,2,5,2
"Sweden",283,6,7,5,3,2,1
"Germany",283,6,5,2,1,1,2
"Egypt",284,1,9,6,1,5,1
"Russia",284,1,6,3,2,1,2
"Portugal",284,2,6,6,3,3,1
"Spain",284,2,5,3,2,1,2
"Argentina",284,4,7,7,2,5,1
"Croatia",284,4,4,5,2,3,2
"Brazil",284,5,7,6,2,4,1
"Costa Rica",284,5,6,3,3,0,2
"Colombia",284,8,7,3,0,3,1
"Poland",284,8,6,5,3,2,2
"Uruguay",285,1,9,6,2,4,1
"Egypt",285,1,4,3,3,0,2
"Spain",285,2,9,7,1,6,1
"Iran",285,2,6,6,3,3,2
"Croatia",285,4,5,6,3,3,1
"Iceland",285,4,4,3,4,-1,2
"Brazil",285,5,9,8,0,8,1
"Costa Rica",285,5,4,3,4,-1,2
"Germany",285,6,7,9,3,6,1
"Sweden",285,6,4,3,2,1,2
"Panama",285,7,7,7,4,3,1
"Belgium",285,7,6,6,6,0,2
"Japan",285,8,9,6,1,5,1
"Colombia",285,8,6,5,3,2,2
"Russia",286,1,7,4,1,3,1
"Egypt",286,1,4,4,4,0,2
"Argentina",286,4,9,10,3,7,1
"Croatia",286,4,6,8,3,5,2
"Brazil",286,5,7,8,1,7,1
"Costa Rica",286,5,4,2,2,0,2
"South Korea",286,6,9,7,1,6,1
"Mexico",286,6,6,8,3,5,2
"Poland",286,8,7,7,3,4,1
"Japan",286,8,5,6,4,2,2
"Uruguay",287,1,9,10,0,10,1
"Saudi Arabia",287,1,4,4,7,-3,2
"Argentina",287,4,7,4,2,2,1
"Iceland",287,4,4,3,4,-1,2
"Brazil",287,5,9,6,2,4,1
"Costa Rica",287,5,6,5,4,1,2
"England",287,7,7,6,3,3,1
"Belgium",287,7,5,5,4,1,2
"Russia",288,1,7,4,1,3,1
"Uruguay",288,1,5,6,2,4,2
"Spain",288,2,7,6,1,5,1
"Iran",288,2,4,3,3,0,2
"Switzerland",288,5,7,3,0,3,1
"Brazil",288,5,6,3,1,2,2
"Sweden",288,6,5,2,1,1,1
"Mexico",288,6,4,3,3,0,2
"Poland",288,8,7,4,2,2,1
"Japan",288,8,5,4,3,1,2
"Russia",289,1,9,4,1,3,1
"Uruguay",289,1,6,5,3,2,2
"France",289,3,9,7,0,7,1
"Australia",289,3,4,4,2,2,2
"Mexico",289,6,9,4,1,3,1
"Germany",289,6,6,6,1,5,2
"Uruguay",290,1,7,4,0,4,1
"Russia",290,1,6,4,1,3,2
"Spain",290,2,7,5,2,3,1
"Iran",290,2,6,4,2,2,2
"Peru",290,3,7,7,3,4,1
"Denmark",290,3,4,3,4,-1,2
"Argentina",290,4,7,8,3,5,1
"Croatia",290,4,5,7,5,2,2
"Belgium",290,7,9,6,3,3,1
"Panama",290,7,6,7,3,4,2
"Colombia",290,8,7,6,2,4,1
"Senegal",290,8,5,5,4,1,2
"Uruguay",291,1,9,8,4,4,1
"Russia",291,1,4,5,3,2,2
"Spain",291,2,7,5,2,3,1
"Iran",291,2,5,5,1,4,2
"Peru",291,3,6,3,2,1,1
"France",291,3,5,2,0,2,2
"Iceland",291,4,9,7,1,6,1
"Argentina",291,4,6,7,2,5,2
"Costa Rica",291,5,9,8,4,4,1
"Brazil",291,5,6,9,6,3,2
"Mexico",291,6,7,7,1,6,1
"South Korea",291,6,4,5,4,1,2
"Belgium",291,7,7,6,3,3,1
"England",291,7,4,5,5,0,2
"Poland",291,8,7,4,1,3,1
"Japan",291,8,6,4,2,2,2
"Peru",292,3,7,3,0,3,1
"France",292,3,6,3,2,1,2
"Argentina",292,4,9,7,3,4,1
"Iceland",292,4,6,6,5,1,2
"Germany",292,6,7,7,3,4,1
"Mexico",292,6,6,6,3,3,2
"Japan",292,8,7,2,0,2,1
"Colombia",292,8,6,3,2,1,2
"Egypt",293,1,7,4,2,2,1
"Saudi Arabia",293,1,4,5,3,2,2
"France",293,3,7,6,1,5,1
"Australia",293,3,6,2,3,-1,2
"Argentina",293,4,9,12,5,7,1
"Croatia",293,4,6,8,7,1,2
"Panama",293,7,7,5,2,3,1
"England",293,7,3,2,2,0,2
"Poland",293,8,7,4,0,4,1
"Colombia",293,8,5,4,3,1,2
"Peru",294,3,7,7,4,3,1
"France",294,3,6,7,4,3,2
"Argentina",294,4,7,8,1,7,1
"Iceland",294,4,6,4,3,1,2
"Brazil",294,5,9,8,0,8,1
"Switzerland",294,5,6,4,3,1,2
"England",294,7,7,6,1,5,1
"Belgium",294,7,4,4,4,0,2
"Japan",294,8,7,6,2,4,1
"Poland",294,8,6,4,3,1,2
"Peru",295,3,7,3,1,2,1
"France",295,3,3,3,3,0,2
"Brazil",295,5,9,6,0,6,1
"Serbia",295,5,6,6,6,0,2
"South Korea",295,6,7,4,1,3,1
"Sweden",295,6,6,4,2,2,2
"Belgium",295,7,7,8,3,5,1
"England",295,7,6,8,5,3,2
"Portugal",296,2,9,8,1,7,1
"Spain",296,2,4,4,3,1,2
"Brazil",296,5,7,6,2,4,1
"Switzerland",296,5,6,3,3,0,2
"Poland",296,8,7,4,0,4,1
"Colombia",296,8,4,3,3,0,2
"Uruguay",297,1,9,5,0,5,1
"Saudi Arabia",297,1,4,4,2,2,2
"Spain",297,2,9,6,0,6,1
"Iran",297,2,4,3,3,0,2
"Peru",297,3,7,2,0,2,1
"France",297,3,6,5,3,2,2
"Argentina",297,4,9,8,2,6,1
"Croatia",297,4,4,6,3,3,2
"South Korea",297,6,9,5,1,4,1
"Sweden",297,6,4,1,1,0,2
"Belgium",297,7,9,6,1,5,1
"England",297,7,4,2,2,0,2
"Uruguay",298,1,7,7,2,5,1
"Russia",298,1,4,4,6,-2,2
"Portugal",298,2,7,7,2,5,1
"Iran",298,2,5,4,3,1,2
"Croatia",298,4,7,4,2,2,1
"Argentina",298,4,6,4,2,2,2
"England",298,7,7,8,3,5,1
"Belgium",298,7,6,6,7,-1,2
"Japan",298,8,7,5,1,4,1
"Poland",298,8,6,4,4,0,2
"Uruguay",299,1,9,9,3,6,1
"Egypt",299,1,4,6,5,1,2
"Iran",299,2,7,4,2,2,1
"Spain",299,2,6,7,3,4,2
"Croatia",299,4,7,3,0,3,1
"Argentina",299,4,5,5,1,4,2
"Germany",299,6,9,8,0,8,1
"Mexico",299,6,6,3,3,0,2
"Spain",300,2,7,9,1,8,1
"Portugal",300,2,4,5,7,-2,2
"Argentina",300,4,7,8,4,4,1
"Nigeria",300,4,4,5,7,-2,2
"Brazil",300,5,9,6,3,3,1
"Costa Rica",300,5,6,3,2,1,2
"Sweden",300,6,6,2,3,-1,1
"South Korea",300,6,5,5,2,3,2
"Poland",300,8,9,5,1,4,1
"Japan",300,8,4,2,2,0,2
"Uruguay",301,1,7,4,2,2,1
"Saudi Arabia",301,1,4,1,2,-1,2
"Portugal",301,2,7,10,4,6,1
"Spain",301,2,5,6,3,3,2
"England",301,7,7,9,2,7,1
"Belgium",301,7,5,4,1,3,2
"Uruguay",302,1,9,10,1,9,1
"Russia",302,1,6,5,4,1,2
"France",302,3,7,6,4,2,1
"Australia",302,3,6,7,5,2,2
"Argentina",302,4,9,5,1,4,1
"Croatia",302,4,6,4,2,2,2
"Brazil",302,5,9,8,0,8,1
"Costa Rica",302,5,6,4,2,2,2
"Belgium",302,7,7,7,2,5,1
"England",302,7,5,5,2,3,2
"Iran",303,2,7,3,1,2,1
"Spain",303,2,4,4,4,0,2
"Australia",303,3,7,5,3,2,1
"France",303,3,6,7,3,4,2
"Argentina",303,4,7,7,2,5,1
"Croatia",303,4,6,4,4,0,2
"Brazil",303,5,5,5,2,3,1
"Switzerland",303,5,4,2,4,-2,2
"Panama",303,7,7,3,1,2,1
"England",303,7,6,2,1,1,2
"Uruguay",304,1,9,7,1,6,1
"Egypt",304,1,4,3,4,-1,2
"Spain",304,2,6,6,4,2,1
"Iran",304,2,5,3,2,1,2
"Argentina",304,4,7,8,3,5,1
"Iceland",304,4,5,4,2,2,2
"Switzerland",304,5,7,4,0,4,1
"Brazil",304,5,6,6,3,3,2
"England",304,7,7,8,4,4,1
"Panama",304,7,5,4,3,1,2
"France",305,3,9,5,1,4,1
"Denmark",305,3,4,4,3,1,2
"Brazil",305,5,7,8,3,5,1
"Costa Rica",305,5,6,7,6,1,2
"South Korea",305,6,7,3,0,3,1
"Germany",305,6,5,4,2,2,2
"Panama",305,7,9,4,0,4,1
"England",305,7,6,5,1,4,2
"Uruguay",306,1,9,7,3,4,1
"Russia",306,1,6,6,4,2,2
"South Korea",306,6,7,4,1,3,1
"Germany",306,6,4,2,2,0,2
"Tunisia",306,7,7,5,1,4,1
"England",306,7,6,3,4,-1,2
"Colombia",306,8,9,5,1,4,1
"Senegal",306,8,4,2,3,-1,2
"Russia",307,1,7,4,1,3,1
"Saudi Arabia",307,1,4,1,1,0,2
"Spain",307,2,9,7,3,4,1
"Iran",307,2,6,6,4,2,2
"Denmark",307,3,7,4,2,2,1
"France",307,3,6,4,2,2,2
"Brazil",307,5,9,6,1,5,1
"Switzerland",307,5,6,5,3,2,2
"South Korea",307,6,9,7,1,6,1
"Germany",307,6,4,5,4,1,2
"Uruguay",308,1,9,6,2,4,1
"Russia",308,1,4,4,3,1,2
"Spain",308,2,7,4,1,3,1
"Iran",308,2,6,3,2,1,2
"Argentina",308,4,7,4,0,4,1
"Croatia",308,4,6,4,2,2,2
"Brazil",308,5,9,5,1,4,1
"Costa Rica",308,5,4,3,3,0,2
"Mexico",308,6,7,5,2,3,1
"Germany",308,6,4,3,3,0,2
"Belgium",308,7,7,5,2,3,1
"England",308,7,5,4,1,3,2
"Uruguay",309,1,7,5,2,3,1
"Saudi Arabia",309,1,5,3,2,1,2
"Iran",309,2,7,3,0,3,1
"Portugal",309,2,5,3,2,1,2
"France",309,3,7,5,1,4,1
"Peru",309,3,4,1,2,-1,2
"Croatia",309,4,6,4,2,2,1
"Argentina",309,4,5,2,1,1,2
"Germany",309,6,7,6,4,2,1
"South Korea",309,6,3,4,4,0,2
"England",309,7,9,6,1,5,1
"Belgium",309,7,6,3,2,1,2
"Colombia",309,8,7,5,1,4,1
"Japan",309,8,6,3,3,0,2
"Argentina",310,4,9,4,0,4,1
"Iceland",310,4,4,2,2,0,2
"Brazil",310,5,7,6,2,4,1
"Serbia",310,5,6,3,3,0,2
"Germany",310,6,7,5,0,5,1
"Mexico",310,6,4,6,5,1,2
"Egypt",311,1,7,7,3,4,1
"Russia",311,1,4,3,4,-1,2
"Spain",311,2,7,5,1,4,1
"Portugal",311,2,6,4,4,0,2
"Iceland",311,4,9,7,4,3,1
"Croatia",311,4,6,7,5,2,2
"Germany",311,6,9,7,0,7,1
"South Korea",311,6,6,3,2,1,2
"Belgium",311,7,9,4,1,3,1
"England",311,7,4,3,2,1,2
"Spain",312,2,9,10,3,7,1
"Morocco",312,2,4,3,5,-2,2
"France",312,3,7,4,0,4,1
"Denmark",312,3,4,3,4,-1,2
"Brazil",312,5,7,5,1,4,1
"Switzerland",312,5,5,4,3,1,2
"Belgium",312,7,7,5,0,5,1
"England",312,7,6,7,1,6,2
"Russia",313,1,7,5,3,2,1
"Uruguay",313,1,6,4,2,2,2
"Spain",313,2,7,7,5,2,1
"Portugal",313,2,6,8,4,4,2
"Argentina",313,4,7,8,1,7,1
"Nigeria",313,4,4,1,1,0,2
"Colombia",313,8,7,4,1,3,1
"Japan",313,8,6,5,3,2,2
"Uruguay",314,1,9,6,2,4,1
"Saudi Arabia",314,1,6,5,4,1,2
"Spain",314,2,7,8,1,7,1
"Portugal",314,2,5,3,0,3,2
"France",314,3,9,8,1,7,1
"Peru",314,3,4,4,5,-1,2
"Argentina",314,4,7,5,0,5,1
"Iceland",314,4,6,8,3,5,2
"Brazil",314,5,7,5,1,4,1
"Switzerland",314,5,6,7,4,3,2
"England",314,7,7,7,2,5,1
"Belgium",314,7,6,8,4,4,2
"Colombia",314,8,7,6,3,3,1
"Poland",314,8,3,6,6,0,2
"Russia",315,1,7,4,2,2,1
"Saudi Arabia",315,1,4,3,2,1,2
"Portugal",315,2,6,3,2,1,1
"Iran",315,2,5,3,2,1,2
"Denmark",315,3,9,3,0,3,1
"Australia",315,3,6,3,2,1,2
"Argentina",315,4,7,7,3,4,1
"Nigeria",315,4,4,1,1,0,2
"Switzerland",315,5,5,3,2,1,1
"Costa Rica",315,5,4,4,2,2,2
"Spain",316,2,7,6,4,2,1
"Iran",316,2,5,6,4,2,2
"France",316,3,9,6,1,5,1
"Denmark",316,3,6,5,2,3,2
"Belgium",316,7,9,5,1,4,1
"England",316,7,4,4,4,0,2
"Colombia",316,8,7,6,1,5,1
"Senegal",316,8,4,2,3,-1,2
"Saudi Arabia",317,1,7,5,2,3,1
"Uruguay",317,1,6,3,2,1,2
"Spain",317,2,9,5,1,4,1
"Portugal",317,2,6,8,5,3,2
"France",317,3,7,4,2,2,1
"Peru",317,3,4,3,3,0,2
"Switzerland",317,5,9,8,3,5,1
"Brazil",317,5,6,9,2,7,2
"Germany",317,6,7,5,2,3,1
"Mexico",317,6,6,2,1,1,2
"Spain",318,2,7,9,4,5,1
"Portugal",318,2,4,4,4,0,2
"France",318,3,7,7,2,5,1
"Peru",318,3,5,4,3,1,2
"Argentina",318,4,7,7,4,3,1
"Croatia",318,4,5,6,5,1,2
"Brazil",318,5,7,7,1,6,1
"Costa Rica",318,5,4,3,3,0,2
"Belgium",318,7,9,4,0,4,1
"Panama",318,7,4,2,1,1,2
"Uruguay",319,1,7,3,1,2,1
"Egypt",319,1,4,2,2,0,2
"Denmark",319,3,9,4,1,3,1
"France",319,3,6,7,2,5,2
"Croatia",319,4,9,7,2,5,1
"Argentina",319,4,6,4,4,0,2
"Brazil",319,5,9,9,5,4,1
"Serbia",319,5,4,5,5,0,2
"Mexico",319,6,9,5,2,3,1
"Germany",319,6,4,2,1,1,2
"Uruguay",320,1,9,7,0,7,1
"Saudi Arabia",320,1,4,5,5,0,2
"Peru",320,3,7,4,1,3,1
"France",320,3,5,5,2,3,2
"Argentina",320,4,9,7,2,5,1
"Nigeria",320,4,6,3,3,0,2
"Switzerland",320,5,6,5,2,3,1
"Brazil",320,5,5,3,2,1,2
"Germany",320,6,7,5,1,4,1
"South Korea",320,6,6,5,4,1,2
"England",320,7,7,4,2,2,1
"Panama",320,7,4,3,3,0,2
"Japan",320,8,7,5,2,3,1
"Colombia",320,8,5,3,2,1,2
"Uruguay",321,1,7,4,1,3,1
"Russia",321,1,5,3,1,2,2
"Spain",321,2,7,4,0,4,1
"Portugal",321,2,6,3,2,1,2
"Argentina",321,4,7,2,0,2,1
"Croatia",321,4,6,4,2,2,2
"Germany",321,6,7,4,1,3,1
"Mexico",321,6,5,2,1,1,2
"England",321,7,7,8,4,4,1
"Belgium",321,7,5,4,2,2,2
"Russia",322,1,9,7,2,5,1
"Uruguay",322,1,6,8,3,5,2
"France",322,3,9,7,0,7,1
"Peru",322,3,6,4,5,-1,2
"Croatia",322,4,9,8,0,8,1
"Iceland",322,4,6,3,2,1,2
"Belgium",322,7,6,6,4,2,1
"England",322,7,5,6,4,2,2
"Uruguay",323,1,9,10,4,6,1
"Saudi Arabia",323,1,6,5,4,1,2
"Spain",323,2,7,3,0,3,1
"Iran",323,2,6,4,3,1,2
"Argentina",323,4,7,5,2,3,1
"Croatia",323,4,6,8,3,5,2
"Mexico",323,6,6,8,3,5,1
"Germany",323,6,5,3,2,1,2
"England",323,7,9,5,0,5,1
"Panama",323,7,6,3,2,1,2
"Russia",324,1,7,4,1,3,1
"Saudi Arabia",324,1,4,4,3,1,2
"France",324,3,7,5,2,3,1
"Denmark",324,3,6,6,3,3,2
"Brazil",324,5,7,3,0,3,1
"Switzerland",324,5,3,2,2,0,2
"South Korea",324,6,7,3,0,3,1
"Germany",324,6,5,3,2,1,2
"Uruguay",325,1,7,5,2,3,1
"Egypt",325,1,6,4,2,2,2
"Portugal",325,2,6,4,1,3,1
"Spain",325,2,5,4,3,1,2
"Brazil",325,5,7,5,1,4,1
"Switzerland",325,5,4,4,2,2,2
"Germany",325,6,7,7,1,6,1
"South Korea",325,6,6,3,3,0,2
"Colombia",325,8,9,7,2,5,1
"Japan",325,8,4,4,6,-2,2
"Russia",326,1,7,3,1,2,1
"Egypt",326,1,5,6,4,2,2
"Portugal",326,2,9,6,3,3,1
"Iran",326,2,6,4,1,3,2
"France",326,3,7,4,1,3,1
"Denmark",326,3,6,5,4,1,2
"Croatia",326,4,7,7,3,4,1
"Iceland",326,4,4,2,3,-1,2
"Brazil",326,5,9,8,2,6,1
"Costa Rica",326,5,6,5,2,3,2
"South Korea",326,6,6,5,4,1,1
"Germany",326,6,5,3,1,2,2
"Colombia",326,8,9,5,0,5,1
"Japan",326,8,6,4,3,1,2
"Uruguay",327,1,9,8,3,5,1
"Russia",327,1,4,6,3,3,2
"France",327,3,9,4,0,4,1
"Denmark",327,3,6,2,2,0,2
"Croatia",327,4,7,7,2,5,1
"Argentina",327,4,6,6,3,3,2
"Sweden",327,6,7,4,1,3,1
"South Korea",327,6,6,4,3,1,2
"Belgium",327,7,9,7,2,5,1
"England",327,7,4,6,4,2,2
"Saudi Arabia",328,1,5,1,0,1,1
"Uruguay",328,1,4,4,3,1,2
"France",328,3,7,5,2,3,1
"Denmark",328,3,6,5,2,3,2
"Switzerland",328,5,7,4,1,3,1
"Brazil",328,5,5,3,2,1,2
"South Korea",328,6,7,5,1,4,1
"Germany",328,6,5,3,2,1,2
"Belgium",328,7,9,8,2,6,1
"England",328,7,4,2,2,0,2
"Poland",328,8,9,11,2,9,1
"Japan",328,8,4,7,9,-2,2
"Uruguay",329,1,7,2,0,2,1
"Saudi Arabia",329,1,4,3,3,0,2
"France",329,3,7,6,2,4,1
"Peru",329,3,4,3,2,1,2
"Argentina",329,4,9,6,1,5,1
"Iceland",329,4,6,4,4,0,2
"Costa Rica",329,5,7,7,4,3,1
"Switzerland",329,5,5,4,3,1,2
"Germany",329,6,9,7,2,5,1
"South Korea",329,6,6,4,4,0,2
"Belgium",329,7,7,3,0,3,1
"England",329,7,4,4,4,0,2
"Spain",330,2,7,5,2,3,1
"Iran",330,2,4,4,1,3,2
"Croatia",330,4,9,6,2,4,1
"Argentina",330,4,6,9,4,5,2
"Germany",330,6,9,8,1,7,1
"Sweden",330,6,6,3,4,-1,2
"England",330,7,7,5,3,2,1
"Belgium",330,7,6,11,5,6,2
"Japan",330,8,7,7,4,3,1
"Colombia",330,8,6,7,6,1,2
"Uruguay",331,1,7,5,2,3,1
"Saudi Arabia",331,1,5,2,1,1,2
"Iran",331,2,7,8,2,6,1
"Portugal",331,2,5,4,3,1,2
"France",331,3,9,11,2,9,1
"Australia",331,3,4,2,7,-5,2
"Argentina",331,4,7,5,2,3,1
"Nigeria",331,4,6,4,4,0,2
"Brazil",331,5,7,6,2,4,1
"Switzerland",331,5,4,3,2,1,2
"Germany",331,6,9,11,1,10,1
"South Korea",331,6,6,7,5,2,2
"Russia",332,1,7,2,0,2,1
"Uruguay",332,1,6,5,1,4,2
"Spain",332,2,9,11,2,9,1
"Portugal",332,2,6,6,5,1,2
"Denmark",332,3,7,3,1,2,1
"Australia",332,3,6,7,3,4,2
"Argentina",332,4,7,4,2,2,1
"Croatia",332,4,6,6,3,3,2
"Germany",332,6,6,2,2,0,1
"South Korea",332,6,5,3,1,2,2
"Panama",332,7,7,3,0,3,1
"England",332,7,4,3,1,2,2
"Colombia",332,8,9,8,2,6,1
"Poland",332,8,6,3,2,1,2
"Uruguay",333,1,6,4,3,1,1
"Egypt",333,1,5,4,3,1,2
"Portugal",333,2,7,7,3,4,1
"Spain",333,2,4,3,3,0,2
"Argentina",333,4,7,4,1,3,1
"Croatia",333,4,5,2,0,2,2
"Germany",333,6,9,5,0,5,1
"Sweden",333,6,4,2,2,0,2
"England",333,7,7,5,3,2,1
"Belgium",333,7,5,6,4,2,2
"Russia",334,1,7,4,1,3,1
"Egypt",334,1,5,3,2,1,2
"Spain",334,2,7,5,1,4,1
"Iran",334,2,4,3,3,0,2
"Argentina",334,4,9,6,0,6,1
"Croatia",334,4,6,3,2,1,2
"Brazil",334,5,7,7,2,5,1
"Costa Rica",334,5,6,3,2,1,2
"England",334,7,9,5,1,4,1
"Belgium",334,7,4,6,3,3,2
"Poland",334,8,7,8,2,6,1
"Japan",334,8,6,5,5,0,2
"Portugal",335,2,7,7,3,4,1
"Iran",335,2,4,2,3,-1,2
"Denmark",335,3,5,1,0,1,1
"France",335,3,4,4,2,2,2
"Brazil",335,5,9,4,1,3,1
"Switzerland",335,5,4,5,5,0,2
"Portugal",336,2,9,4,1,3,1
"Spain",336,2,4,4,4,0,2
"Peru",336,3,9,7,1,6,1
"France",336,3,6,3,4,-1,2
"Croatia",336,4,7,6,3,3,1
"Argentina",336,4,6,5,2,3,2
"Brazil",336,5,9,11,3,8,1
"Switzerland",336,5,4,1,4,-3,2
"England",336,7,9,12,2,10,1
"Belgium",336,7,6,4,1,3,2
"Poland",336,8,7,6,2,4,1
"Japan",336,8,4,3,5,-2,2
"Uruguay",337,1,9,5,2,3,1
"Russia",337,1,6,4,3,1,2
"Portugal",337,2,7,4,1,3,1
"Spain",337,2,4,4,3,1,2
"Argentina",337,4,7,4,0,4,1
"Croatia",337,4,6,5,5,0,2
"South Korea",337,6,7,5,2,3,1
"Mexico",337,6,6,3,2,1,2
"England",337,7,7,7,0,7,1
"Panama",337,7,6,4,6,-2,2
"Colombia",337,8,7,3,1,2,1
"Poland",337,8,5,1,0,1,2
"Spain",338,2,9,10,1,9,1
"Iran",338,2,6,6,2,4,2
"France",338,3,7,9,2,7,1
"Peru",338,3,5,4,3,1,2
"Argentina",338,4,9,6,2,4,1
"Nigeria",338,4,6,6,4,2,2
"Brazil",338,5,9,7,1,6,1
"Switzerland",338,5,4,2,2,0,2
"England",338,7,7,5,1,4,1
"Belgium",338,7,6,4,4,0,2
"Spain",339,2,7,2,0,2,1
"Morocco",339,2,4,4,3,1,2
"France",339,3,9,7,0,7,1
"Peru",339,3,6,3,2,1,2
"Brazil",339,5,9,8,2,6,1
"Costa Rica",339,5,4,2,2,0,2
"Poland",339,8,7,6,3,3,1
"Japan",339,8,5,4,3,1,2
"Saudi Arabia",340,1,7,4,2,2,1
"Russia",340,1,5,4,3,1,2
"Spain",340,2,7,6,4,2,1
"Iran",340,2,4,6,6,0,2
"Argentina",340,4,7,6,3,3,1
"Iceland",340,4,6,6,3,3,2
"Germany",340,6,7,4,2,2,1
"South Korea",340,6,6,6,5,1,2
"Poland",340,8,7,4,1,3,1
"Japan",340,8,4,2,2,0,2
"France",341,3,9,7,1,6,1
"Australia",341,3,4,1,2,-1,2
"Argentina",341,4,7,8,3,5,1
"Nigeria",341,4,4,3,3,0,2
"Costa Rica",341,5,7,6,3,3,1
"Brazil",341,5,6,6,5,1,2
"France",342,3,7,6,1,5,1
"Australia",342,3,4,2,2,0,2
"Belgium",342,7,7,6,2,4,1
"England",342,7,4,3,3,0,2
"Colombia",342,8,7,4,2,2,1
"Japan",342,8,5,3,1,2,2
"Uruguay",343,1,7,5,3,2,1
"Egypt",343,1,4,4,4,0,2
"Spain",343,2,6,5,2,3,1
"Morocco",343,2,5,1,0,1,2
"France",343,3,9,6,1,5,1
"Australia",343,3,6,3,3,0,2
"Argentina",343,4,9,6,1,5,1
"Croatia",343,4,4,2,3,-1,2
"Costa Rica",343,5,7,5,2,3,1
"Brazil",343,5,5,6,2,4,2
"Germany",343,6,7,6,1,5,1
"South Korea",343,6,4,2,2,0,2
"Belgium",343,7,9,7,0,7,1
"Panama",343,7,4,2,3,-1,2
"France",344,3,7,5,2,3,1
"Peru",344,3,6,4,2,2,2
"Croatia",344,4,9,7,2,5,1
"Nigeria",344,4,4,3,4,-1,2
"Brazil",344,5,7,9,3,6,1
"Costa Rica",344,5,5,6,3,3,2
"Germany",344,6,7,5,1,4,1
"Mexico",344,6,6,3,3,0,2
"England",344,7,9,5,1,4,1
"Belgium",344,7,6,2,2,0,2
"Colombia",344,8,7,9,6,3,1
"Japan",344,8,6,9,7,2,2
"Saudi Arabia",345,1,7,4,2,2,1
"Uruguay",345,1,6,4,2,2,2
"Portugal",345,2,7,6,2,4,1
"Spain",345,2,6,2,2,0,2
"France",345,3,9,7,1,6,1
"Peru",345,3,4,2,2,0,2
"Brazil",345,5,6,10,4,6,1
"Costa Rica",345,5,5,4,3,1,2
"Germany",345,6,7,6,2,4,1
"Mexico",345,6,6,6,3,3,2
"Colombia",345,8,7,4,2,2,1
"Poland",345,8,6,6,1,5,2
"Serbia",346,5,9,6,1,5,1
"Brazil",346,5,6,8,3,5,2
"Mexico",346,6,9,8,3,5,1
"South Korea",346,6,6,4,3,1,2
"England",346,7,7,6,2,4,1
"Belgium",346,7,6,6,3,3,2
"Senegal",346,8,7,4,2,2,1
"Japan",346,8,6,4,3,1,2
"France",347,3,7,6,2,4,1
"Peru",347,3,5,3,2,1,2
"Argentina",347,4,9,7,2,5,1
"Croatia",347,4,4,5,4,1,2
"Uruguay",348,1,7,4,0,4,1
"Russia",348,1,4,4,5,-1,2
"Spain",348,2,9,7,1,6,1
"Iran",348,2,4,3,6,-3,2
"France",348,3,7,5,3,2,1
"Australia",348,3,5,4,3,1,2
"Serbia",348,5,7,4,0,4,1
"Brazil",348,5,6,6,4,2,2
"Germany",348,6,7,4,1,3,1
"South Korea",348,6,4,4,4,0,2
"Belgium",348,7,6,4,3,1,1
"England",348,7,5,2,0,2,2
"Colombia",348,8,7,4,1,3,1
"Japan",348,8,5,2,1,1,2
"Russia",349,1,7,4,2,2,1
"Egypt",349,1,5,4,3,1,2
"France",349,3,7,6,3,3,1
"Peru",349,3,4,4,3,1,2
"Brazil",349,5,9,8,1,7,1
"Serbia",349,5,4,2,3,-1,2
"South Korea",349,6,9,5,1,4,1
"Germany",349,6,6,5,2,3,2
"England",349,7,5,5,2,3,1
"Panama",349,7,4,2,4,-2,2
"Colombia",349,8,7,3,0,3,1
"Japan",349,8,6,5,3,2,2
"Uruguay",350,1,7,5,1,4,1
"Saudi Arabia",350,1,4,3,3,0,2
"Spain",350,2,7,6,1,5,1
"Iran",350,2,5,5,4,1,2
"France",350,3,7,5,3,2,1
"Peru",350,3,6,6,2,4,2
"Iceland",350,4,7,4,2,2,1
"Argentina",350,4,6,3,2,1,2
"Switzerland",350,5,7,4,2,2,1
"Brazil",350,5,4,3,4,-1,2
"Belgium",350,7,7,5,1,4,1
"Tunisia",350,7,6,5,5,0,2
"Colombia",350,8,9,5,2,3,1
"Poland",350,8,6,5,2,3,2
"Spain",351,2,7,4,1,3,1
"Portugal",351,2,6,4,2,2,2
"Peru",351,3,9,7,1,6,1
"France",351,3,4,5,2,3,2
"Costa Rica",351,5,7,4,2,2,1
"Brazil",351,5,5,5,3,2,2
"Germany",351,6,9,7,2,5,1
"South Korea",351,6,6,4,2,2,2
"Senegal",351,8,7,4,2,2,1
"Japan",351,8,4,2,1,1,2
"Portugal",352,2,9,5,1,4,1
"Spain",352,2,6,2,1,1,2
"France",352,3,5,3,1,2,1
"Denmark",352,3,4,1,2,-1,2
"Panama",352,7,9,6,1,5,1
"Belgium",352,7,4,1,1,0,2
"Poland",352,8,7,3,1,2,1
"Colombia",352,8,5,5,3,2,2
"Spain",353,2,9,4,1,3,1
"Portugal",353,2,4,2,2,0,2
"Peru",353,3,7,6,3,3,1
"France",353,3,6,6,5,1,2
"Argentina",353,4,9,10,3,7,1
"Croatia",353,4,4,4,5,-1,2
"Germany",353,6,7,5,2,3,1
"Mexico",353,6,6,6,2,4,2
"England",353,7,9,5,0,5,1
"Belgium",353,7,6,5,1,4,2
"Spain",354,2,7,6,3,3,1
"Iran",354,2,5,2,1,1,2
"Peru",354,3,7,6,2,4,1
"Denmark",354,3,4,1,3,-2,2
"Brazil",354,5,9,5,0,5,1
"Switzerland",354,5,4,3,2,1,2
"Tunisia",354,7,6,3,2,1,1
"Belgium",354,7,5,5,4,1,2
"Portugal",355,2,9,5,0,5,1
"Iran",355,2,6,5,4,1,2
"France",355,3,9,5,1,4,1
"Denmark",355,3,6,4,2,2,2
"Brazil",355,5,7,8,3,5,1
"Switzerland",355,5,6,5,3,2,2
"Belgium",355,7,7,4,1,3,1
"England",355,7,4,2,2,0,2
"Japan",355,8,7,7,2,5,1
"Poland",355,8,5,7,5,2,2
"Portugal",356,2,7,9,2,7,1
"Spain",356,2,6,6,6,0,2
"Argentina",356,4,7,6,4,2,1
"Croatia",356,4,6,2,1,1,2
"Brazil",356,5,7,8,1,7,1
"Serbia",356,5,5,4,3,1,2
"Portugal",357,2,7,8,3,5,1
"Iran",357,2,6,4,4,0,2
"Argentina",357,4,9,4,0,4,1
"Croatia",357,4,6,6,3,3,2
"South Korea",357,6,7,4,0,4,1
"Mexico",357,6,5,4,2,2,2
"Japan",357,8,7,5,1,4,1
"Poland",357,8,5,4,2,2,2
"Uruguay",358,1,9,9,0,9,1
"Saudi Arabia",358,1,6,5,6,-1,2
"Portugal",358,2,7,5,3,2,1
"Spain",358,2,4,5,4,1,2
"Argentina",358,4,9,8,1,7,1
"Croatia",358,4,4,2,2,0,2
"Brazil",358,5,9,5,2,3,1
"Costa Rica",358,5,4,4,4,0,2
"England",358,7,7,2,0,2,1
"Belgium",358,7,6,6,2,4,2
"Denmark",359,3,9,6,2,4,1
"France",359,3,4,4,4,0,2
"Brazil",359,5,7,3,1,2,1
"Costa Rica",359,5,6,5,4,1,2
"Belgium",359,7,7,5,2,3,1
"Panama",359,7,5,4,3,1,2
"Colombia",359,8,7,4,1,3,1
"Japan",359,8,6,3,3,0,2
"Spain",360,2,9,7,3,4,1
"Iran",360,2,6,6,4,2,2
"France",360,3,7,6,3,3,1
"Australia",360,3,6,5,3,2,2
"Argentina",360,4,7,3,1,2,1
"Croatia",360,4,6,4,2,2,2
"Switzerland",360,5,9,9,2,7,1
"Brazil",360,5,6,5,3,2,2
"Germany",360,6,7,8,3,5,1
"South Korea",360,6,6,3,2,1,2
"England",360,7,7,5,3,2,1
"Belgium",360,7,4,4,4,0,2
"Japan",360,8,6,4,2,2,1
"Colombia",360,8,5,4,2,2,2
"Russia",361,1,7,2,0,2,1
"Uruguay",361,1,4,2,1,1,2
"Portugal",361,2,9,5,0,5,1
"Spain",361,2,6,3,1,2,2
"Croatia",361,4,7,5,2,3,1
"Argentina",361,4,6,6,2,4,2
"Brazil",361,5,9,5,0,5,1
"Serbia",361,5,6,4,3,1,2
"Colombia",361,8,7,3,0,3,1
"Japan",361,8,5,4,1,3,2
"Russia",362,1,9,7,2,5,1
"Egypt",362,1,4,4,3,1,2
"Portugal",362,2,7,5,3,2,1
"Iran",362,2,6,3,1,2,2
"France",362,3,7,9,2,7,1
"Peru",362,3,4,2,6,-4,2
"Argentina",362,4,9,9,2,7,1
"Croatia",362,4,4,5,4,1,2
"Germany",362,6,9,8,2,6,1
"Mexico",362,6,6,7,8,-1,2
"Japan",362,8,7,7,2,5,1
"Poland",362,8,5,2,1,1,2
"France",363,3,9,5,1,4,1
"Peru",363,3,4,2,1,1,2
"Argentina",363,4,7,4,2,2,1
"Croatia",363,4,4,7,4,3,2
"Brazil",363,5,9,10,1,9,1
"Switzerland",363,5,4,4,7,-3,2
"Uruguay",364,1,7,6,3,3,1
"Russia",364,1,4,5,4,1,2
"Spain",364,2,7,6,2,4,1
"Iran",364,2,4,3,3,0,2
"Brazil",364,5,9,4,0,4,1
"Costa Rica",364,5,6,5,2,3,2
"Germany",364,6,7,5,2,3,1
"South Korea",364,6,3,3,3,0,2
"England",364,7,9,7,0,7,1
"Belgium",364,7,6,5,1,4,2
"Poland",364,8,7,7,5,2,1
"Japan",364,8,4,3,3,0,2
"Portugal",365,2,9,7,2,5,1
"Spain",365,2,6,3,4,-1,2
"France",365,3,9,12,1,11,1
"Peru",365,3,6,3,3,0,2
"Argentina",365,4,9,10,0,10,1
"Croatia",365,4,6,3,3,0,2
"Switzerland",365,5,9,7,2,5,1
"Brazil",365,5,6,7,2,5,2
"Germany",365,6,9,14,3,11,1
"South Korea",365,6,6,3,2,1,2
"Germany",366,6,7,3,0,3,1
"South Korea",366,6,4,3,2,1,2
"England",366,7,9,9,0,9,1
"Belgium",366,7,6,5,3,2,2
"Poland",366,8,9,7,1,6,1
"Colombia",366,8,6,5,3,2,2
"France",367,3,9,5,1,4,1
"Denmark",367,3,6,4,3,1,2
"England",367,7,7,4,0,4,1
"Panama",367,7,5,1,0,1,2
"Colombia",367,8,9,6,1,5,1
"Poland",367,8,6,3,2,1,2
"Spain",368,2,7,4,2,2,1
"Portugal",368,2,6,6,4,2,2
"Brazil",368,5,9,12,3,9,1
"Switzerland",368,5,6,5,2,3,2
"England",368,7,7,7,2,5,1
"Belgium",368,7,6,7,5,2,2
"Japan",368,8,7,5,2,3,1
"Colombia",368,8,5,5,1,4,2
"Egypt",369,1,7,7,1,6,1
"Uruguay",369,1,6,3,4,-1,2
"Iran",369,2,7,4,2,2,1
"Spain",369,2,6,4,1,3,2
"France",369,3,7,6,3,3,1
"Peru",369,3,6,5,4,1,2
"Argentina",369,4,7,7,1,6,1
"Croatia",369,4,4,2,5,-3,2
"Brazil",369,5,7,3,1,2,1
"Switzerland",369,5,4,5,6,-1,2
"Germany",369,6,9,7,2,5,1
"Mexico",369,6,4,5,4,1,2
"Panama",369,7,7,3,1,2,1
"England",369,7,6,4,2,2,2
"Germany",370,6,9,5,1,4,1
"South Korea",370,6,6,4,4,0,2
"England",370,7,7,7,2,5,1
"Belgium",370,7,6,4,4,0,2
"Poland",370,8,7,8,3,5,1
"Colombia",370,8,4,5,3,2,2
"Russia",371,1,7,6,2,4,1
"Egypt",371,1,4,2,3,-1,2
"Spain",371,2,9,7,0,7,1
"Morocco",371,2,4,3,4,-1,2
"Peru",371,3,9,4,0,4,1
"France",371,3,6,4,1,3,2
"Iceland",371,4,7,4,2,2,1
"Argentina",371,4,4,7,4,3,2
"Brazil",371,5,9,6,0,6,1
"Costa Rica",371,5,4,1,1,0,2
"England",372,7,7,8,3,5,1
"Belgium",372,7,6,4,4,0,2
"Colombia",372,8,9,7,1,6,1
"Poland",372,8,6,3,3,0,2
"Uruguay",373,1,9,8,2,6,1
"Russia",373,1,4,5,4,1,2
"Iran",373,2,7,5,1,4,1
"Portugal",373,2,5,2,1,1,2
"Australia",373,3,6,5,3,2,1
"Peru",373,3,5,5,3,2,2
"Argentina",373,4,9,4,0,4,1
"Croatia",373,4,4,4,4,0,2
"Germany",373,6,9,7,2,5,1
"South Korea",373,6,4,3,3,0,2
"Russia",374,1,9,6,1,5,1
"Uruguay",374,1,6,6,5,1,2
"Spain",374,2,7,6,1,5,1
"Iran",374,2,4,2,4,-2,2
"France",374,3,7,9,6,3,1
"Denmark",374,3,6,8,6,2,2
"Nigeria",374,4,9,4,1,3,1
"Argentina",374,4,4,4,3,1,2
"Costa Rica",374,5,7,4,1,3,1
"Brazil",374,5,5,5,3,2,2
"Uruguay",375,1,9,11,2,9,1
"Egypt",375,1,6,6,4,2,2
"Iran",375,2,7,11,2,9,1
"Spain",375,2,5,6,4,2,2
"Argentina",375,4,9,7,2,5,1
"Croatia",375,4,6,4,2,2,2
"Uruguay",376,1,7,4,0,4,1
"Saudi Arabia",376,1,4,3,3,0,2
"Brazil",376,5,7,5,2,3,1
"Costa Rica",376,5,4,3,3,0,2
"Poland",376,8,7,5,3,2,1
"Colombia",376,8,4,4,1,3,2
"Portugal",377,2,7,3,1,2,1
"Iran",377,2,4,1,1,0,2
"France",377,3,9,8,2,6,1
"Denmark",377,3,6,2,3,-1,2
"Croatia",377,4,7,8,2,6,1
"Iceland",377,4,6,6,5,1,2
"Brazil",377,5,7,7,3,4,1
"Switzerland",377,5,4,4,4,0,2
"Panama",377,7,6,2,4,-2,1
"England",377,7,5,6,2,4,2
"Colombia",377,8,9,4,0,4,1
"Senegal",377,8,4,5,3,2,2
"Uruguay",378,1,9,5,0,5,1
"Russia",378,1,6,5,4,1,2
"France",378,3,7,5,3,2,1
"Denmark",378,3,5,7,5,2,2
"Argentina",378,4,7,3,0,3,1
"Croatia",378,4,4,2,2,0,2
"Switzerland",378,5,6,3,3,0,1
"Brazil",378,5,5,2,0,2,2
"Sweden",378,6,6,5,2,3,1
"Germany",378,6,5,4,3,1,2
"England",378,7,7,6,2,4,1
"Belgium",378,7,6,4,1,3,2
"Japan",378,8,7,4,1,3,1
"Senegal",378,8,4,2,3,-1,2
"Egypt",379,1,6,5,4,1,1
"Saudi Arabia",379,1,5,3,1,2,2
"Portugal",379,2,7,4,1,3,1
"Iran",379,2,6,4,2,2,2
"Peru",379,3,7,4,1,3,1
"France",379,3,4,3,3,0,2
"Nigeria",379,4,6,6,5,1,1
"Argentina",379,4,5,5,4,1,2
"South Korea",379,6,6,3,2,1,1
"Sweden",379,6,5,2,0,2,2
"Belgium",379,7,7,5,2,3,1
"England",379,7,4,3,2,1,2
"Colombia",379,8,7,4,1,3,1
"Poland",379,8,5,3,2,1,2
"Russia",380,1,7,6,2,4,1
"Uruguay",380,1,4,3,3,0,2
"France",380,3,7,5,1,4,1
"Peru",380,3,6,5,3,2,2
"Croatia",380,4,7,4,2,2,1
"Argentina",380,4,5,4,3,1,2
"England",380,7,7,8,2,6,1
"Belgium",380,7,4,3,3,0,2
"Spain",381,2,9,6,2,4,1
"Iran",381,2,6,5,2,3,2
"Peru",381,3,7,4,2,2,1
"France",381,3,6,6,2,4,2
"Argentina",381,4,7,9,3,6,1
"Iceland",381,4,6,5,4,1,2
"Brazil",381,5,5,5,4,1,1
"Switzerland",381,5,4,3,3,0,2
"Germany",381,6,7,3,1,2,1
"Mexico",381,6,6,6,3,3,2
"England",381,7,7,6,2,4,1
"Belgium",381,7,6,10,3,7,2
"Senegal",381,8,6,4,4,0,1
"Poland",381,8,5,6,4,2,2
"Argentina",382,4,9,9,2,7,1
"Nigeria",382,4,6,3,4,-1,2
"Germany",382,6,9,10,0,10,1
"Sweden",382,6,4,5,6,-1,2
"Japan",382,8,7,6,2,4,1
"Poland",382,8,4,5,5,0,2
"Iran",383,2,7,4,1,3,1
"Spain",383,2,6,5,4,1,2
"Denmark",383,3,7,4,2,2,1
"France",383,3,6,4,2,2,2
"Argentina",383,4,9,3,0,3,1
"Nigeria",383,4,6,4,2,2,2
"Brazil",383,5,9,8,1,7,1
"Switzerland",383,5,6,5,5,0,2
"England",383,7,7,4,2,2,1
"Belgium",383,7,5,3,2,1,2
"Uruguay",384,1,7,5,1,4,1
"Russia",384,1,4,2,3,-1,2
"France",384,3,7,7,2,5,1
"Peru",384,3,5,2,1,1,2
"Costa Rica",384,5,9,4,0,4,1
"Switzerland",384,5,6,2,2,0,2
"Mexico",384,6,7,5,1,4,1
"Germany",384,6,5,3,2,1,2
"Portugal",385,2,7,5,3,2,1
"Spain",385,2,5,3,1,2,2
"France",385,3,9,8,1,7,1
"Denmark",385,3,4,2,4,-2,2
"Argentina",385,4,9,5,1,4,1
"Iceland",385,4,4,5,4,1,2
"Brazil",385,5,7,4,1,3,1
"Switzerland",385,5,4,2,3,-1,2
"Colombia",385,8,9,8,0,8,1
"Poland",385,8,4,3,5,-2,2
"Iran",386,2,6,5,3,2,1
"Spain",386,2,5,4,2,2,2
"Denmark",386,3,7,2,0,2,1
"France",386,3,6,2,1,1,2
"Brazil",386,5,9,11,0,11,1
"Serbia",386,5,4,2,5,-3,2
"England",386,7,7,7,3,4,1
"Belgium",386,7,5,6,2,4,2
"Senegal",386,8,7,5,3,2,1
"Japan",386,8,4,4,4,0,2
"Uruguay",387,1,9,5,0,5,1
"Russia",387,1,6,2,1,1,2
"Iran",387,2,7,4,1,3,1
"Portugal",387,2,5,6,3,3,2
"Mexico",387,6,7,4,1,3,1
"Germany",387,6,5,4,1,3,2
"Belgium",387,7,7,5,2,3,1
"Tunisia",387,7,6,4,2,2,2
"Colombia",387,8,7,5,2,3,1
"Japan",387,8,4,6,7,-1,2
"Spain",388,2,7,6,2,4,1
"Portugal",388,2,6,6,3,3,2
"Australia",388,3,6,3,2,1,1
"France",388,3,5,3,2,1,2
"Argentina",388,4,7,3,1,2,1
"Croatia",388,4,6,3,1,2,2
"Belgium",388,7,7,5,0,5,1
"Panama",388,7,5,2,1,1,2
"Uruguay",389,1,9,3,0,3,1
"Egypt",389,1,4,4,2,2,2
"France",389,3,9,8,0,8,1
"Denmark",389,3,6,6,3,3,2
"Argentina",389,4,7,3,1,2,1
"Croatia",389,4,6,4,2,2,2
"Brazil",389,5,9,9,1,8,1
"Costa Rica",389,5,6,4,6,-2,2
"Belgium",389,7,7,3,1,2,1
"England",389,7,4,4,1,3,2
"Colombia",389,8,7,5,2,3,1
"Poland",389,8,5,4,3,1,2
"Spain",390,2,9,7,2,5,1
"Iran",390,2,6,5,3,2,2
"Belgium",390,7,7,6,1,5,1
"England",390,7,5,4,1,3,2
"Colombia",390,8,7,5,2,3,1
"Senegal",390,8,4,2,2,0,2
"Iran",391,2,9,5,1,4,1
"Portugal",391,2,6,3,2,1,2
"France",391,3,7,4,1,3,1
"Denmark",391,3,6,2,1,1,2
"Nigeria",391,4,7,3,1,2,1
"Argentina",391,4,4,2,2,0,2
"England",391,7,7,4,2,2,1
"Tunisia",391,7,4,3,3,0,2
"Colombia",391,8,7,5,1,4,1
"Poland",391,8,6,3,4,-1,2
"Uruguay",392,1,9,6,2,4,1
"Egypt",392,1,4,7,5,2,2
"Spain",392,2,9,7,1,6,1
"Portugal",392,2,4,3,4,-1,2
"France",392,3,7,9,0,9,1
"Australia",392,3,6,2,2,0,2
"Croatia",392,4,7,4,2,2,1
"Argentina",392,4,5,6,1,5,2
"Costa Rica",392,5,7,5,1,4,1
"Brazil",392,5,4,2,3,-1,2
"Germany",392,6,6,3,2,1,1
"South Korea",392,6,5,4,2,2,2
"Senegal",392,8,7,6,1,5,1
"Poland",392,8,5,4,3,1,2
"Uruguay",393,1,7,4,2,2,1
"Saudi Arabia",393,1,6,6,4,2,2
"Argentina",393,4,7,4,1,3,1
"Croatia",393,4,6,5,3,2,2
"England",393,7,9,5,1,4,1
"Belgium",393,7,6,7,2,5,2
"Colombia",393,8,7,3,1,2,1
"Poland",393,8,6,3,2,1,2
"France",394,3,7,6,3,3,1
"Australia",394,3,5,4,3,1,2
"Iceland",394,4,9,5,2,3,1
"Croatia",394,4,6,9,2,7,2
"Brazil",394,5,9,6,2,4,1
"Switzerland",394,5,6,6,4,2,2
"Germany",394,6,7,7,3,4,1
"South Korea",394,6,4,3,3,0,2
"England",394,7,9,5,0,5,1
"Belgium",394,7,6,2,1,1,2
"Poland",394,8,7,6,3,3,1
"Japan",394,8,5,8,2,6,2
"Portugal",395,2,6,6,2,4,1
"Spain",395,2,5,3,2,1,2
"England",395,7,7,9,1,8,1
"Belgium",395,7,4,4,5,-1,2
"France",396,3,7,4,1,3,1
"Peru",396,3,5,3,2,1,2
"Argentina",396,4,7,5,1,4,1
"Croatia",396,4,5,4,3,1,2
"Brazil",396,5,9,9,3,6,1
"Costa Rica",396,5,4,3,3,0,2
"Senegal",396,8,7,5,0,5,1
"Japan",396,8,5,3,1,2,2
"France",397,3,9,5,0,5,1
"Peru",397,3,4,5,4,1,2
"Argentina",397,4,7,8,3,5,1
"Iceland",397,4,6,5,5,0,2
"Brazil",397,5,7,5,2,3,1
"Costa Rica",397,5,5,4,3,1,2
"England",397,7,6,5,1,4,1
"Belgium",397,7,5,2,1,1,2
"France",398,3,7,5,0,5,1
"Peru",398,3,5,3,2,1,2
"Croatia",398,4,7,5,3,2,1
"Argentina",398,4,6,7,4,3,2
"Brazil",398,5,9,6,0,6,1
"Switzerland",398,5,6,2,3,-1,2
"England",398,7,9,6,3,3,1
"Belgium",398,7,6,8,2,6,2
"Uruguay",399,1,9,7,1,6,1
"Russia",399,1,4,4,3,1,2
"Portugal",399,2,7,4,1,3,1
"Iran",399,2,5,4,2,2,2
"Peru",399,3,9,6,2,4,1
"Denmark",399,3,4,2,2,0,2
"Argentina",399,4,9,5,2,3,1
"Iceland",399,4,4,4,4,0,2
"Brazil",399,5,7,8,3,5,1
"Costa Rica",399,5,4,6,5,1,2
"Germany",399,6,7,3,0,3,1
"Sweden",399,6,5,3,2,1,2
"Belgium",399,7,9,6,1,5,1
"England",399,7,4,5,3,2,2
"Uruguay",400,1,9,6,2,4,1
"Russia",400,1,4,5,3,2,2
"Switzerland",400,5,9,8,0,8,1
"Brazil",400,5,6,6,3,3,2
"Mexico",400,6,9,6,1,5,1
"South Korea",400,6,4,3,2,1,2
"England",400,7,9,5,0,5,1
"Belgium",400,7,4,3,2,1,2
"Colombia",400,8,7,6,3,3,1
"Japan",400,8,4,3,3,0,2
"Uruguay",401,1,6,6,4,2,1
"Egypt",401,1,5,4,3,1,2
"South Korea",401,6,7,4,1,3,1
"Mexico",401,6,5,3,1,2,2
"Uruguay",402,1,7,5,2,3,1
"Russia",402,1,5,2,0,2,2
"Peru",402,3,7,4,2,2,1
"France",402,3,5,5,1,4,2
"Argentina",402,4,7,8,3,5,1
"Iceland",402,4,4,4,7,-3,2
"Costa Rica",402,5,7,3,1,2,1
"Brazil",402,5,5,4,3,1,2
"Colombia",402,8,9,5,0,5,1
"Japan",402,8,6,6,2,4,2
"Russia",403,1,7,7,2,5,1
"Uruguay",403,1,6,8,4,4,2
"Peru",403,3,6,3,4,-1,1
"France",403,3,5,6,3,3,2
"Argentina",403,4,9,8,1,7,1
"Iceland",403,4,6,5,3,2,2
"Switzerland",403,5,5,2,1,1,1
"Serbia",403,5,4,3,3,0,2
"England",403,7,7,5,3,2,1
"Belgium",403,7,6,3,2,1,2
"Senegal",403,8,9,5,0,5,1
"Colombia",403,8,4,5,2,3,2
"Argentina",404,4,9,7,2,5,1
"Croatia",404,4,4,4,4,0,2
"Egypt",405,1,7,5,3,2,1
"Uruguay",405,1,6,3,2,1,2
"Peru",405,3,7,5,1,4,1
"Denmark",405,3,6,2,2,0,2
"Argentina",405,4,9,6,1,5,1
"Iceland",405,4,6,3,3,0,2
"Germany",405,6,9,5,0,5,1
"Sweden",405,6,4,4,5,-1,2
"Belgium",405,7,7,7,2,5,1
"England",405,7,6,4,3,1,2
"Uruguay",406,1,9,7,2,5,1
"Russia",406,1,4,4,4,0,2
"Spain",406,2,7,4,1,3,1
"Portugal",406,2,5,4,2,2,2
"Argentina",406,4,7,7,2,5,1
"Iceland",406,4,4,1,2,-1,2
"Costa Rica",406,5,9,6,0,6,1
"Brazil",406,5,6,4,3,1,2
"Mexico",406,6,6,4,2,2,1
"South Korea",406,6,5,3,2,1,2
"Belgium",406,7,7,6,1,5,1
"Panama",406,7,6,4,4,0,2
"Senegal",406,8,5,7,5,2,1
"Colombia",406,8,4,4,5,-1,2
"Uruguay",407,1,7,6,0,6,1
"Saudi Arabia",407,1,4,3,5,-2,2
"Portugal",407,2,9,5,1,4,1
"Spain",407,2,6,5,3,2,2
"Australia",407,3,9,3,0,3,1
"France",407,3,4,5,4,1,2
"Argentina",407,4,7,10,3,7,1
"Nigeria",407,4,5,3,2,1,2
"Serbia",407,5,6,2,3,-1,1
"Brazil",407,5,5,7,4,3,2
"Germany",407,6,7,8,0,8,1
"Mexico",407,6,5,1,0,1,2
"Belgium",407,7,7,5,1,4,1
"England",407,7,6,3,3,0,2
"Poland",407,8,7,5,2,3,1
"Colombia",407,8,6,6,4,2,2
"Uruguay",408,1,9,7,3,4,1
"Russia",408,1,4,3,3,0,2
"Brazil",408,5,7,5,1,4,1
"Costa Rica",408,5,5,3,2,1,2
"England",408,7,7,4,2,2,1
"Belgium",408,7,6,6,2,4,2
"Spain",409,2,7,5,1,4,1
"Portugal",409,2,6,3,3,0,2
"Argentina",409,4,7,4,1,3,1
"Croatia",409,4,5,5,2,3,2
"Switzerland",409,5,7,4,2,2,1
"Serbia",409,5,4,2,2,0,2
"Germany",409,6,7,4,1,3,1
"South Korea",409,6,4,2,2,0,2
"England",409,7,7,9,2,7,1
"Belgium",409,7,5,5,3,2,2
"Colombia",409,8,7,5,3,2,1
"Senegal",409,8,4,2,2,0,2
"France",410,3,7,7,2,5,1
"Australia",410,3,5,3,2,1,2
"Argentina",410,4,7,3,0,3,1
"Croatia",410,4,6,4,2,2,2
"Costa Rica",410,5,7,3,0,3,1
"Brazil",410,5,6,8,3,5,2
"Germany",410,6,7,6,3,3,1
"Mexico",410,6,6,5,3,2,2
"Colombia",410,8,7,4,1,3,1
"Senegal",410,8,6,2,1,1,2
"Uruguay",411,1,7,3,1,2,1
"Egypt",411,1,5,4,1,3,2
"Iran",411,2,9,8,2,6,1
"Spain",411,2,6,3,1,2,2
"Iceland",411,4,6,3,1,2,1
"Croatia",411,4,5,4,3,1,2
"Belgium",411,7,7,5,2,3,1
"Tunisia",411,7,4,2,3,-1,2
"Peru",412,3,9,4,1,3,1
"France",412,3,6,7,5,2,2
"Brazil",412,5,9,6,2,4,1
"Costa Rica",412,5,4,3,3,0,2
"England",412,7,7,4,1,3,1
"Belgium",412,7,6,5,4,1,2
"Colombia",412,8,7,6,1,5,1
"Japan",412,8,4,3,4,-1,2
"Uruguay",413,1,7,6,2,4,1
"Egypt",413,1,4,1,1,0,2
"Iran",413,2,7,4,1,3,1
"Spain",413,2,6,6,3,3,2
"Croatia",413,4,7,6,2,4,1
"Argentina",413,4,5,6,2,4,2
"England",413,7,7,5,2,3,1
"Belgium",413,7,4,4,4,0,2
"Colombia",413,8,9,5,0,5,1
"Poland",413,8,4,3,2,1,2
"France",414,3,7,7,4,3,1
"Denmark",414,3,6,6,5,1,2
"Germany",414,6,7,4,1,3,1
"South Korea",414,6,6,5,2,3,2
"Belgium",414,7,9,6,3,3,1
"England",414,7,6,6,3,3,2
"Colombia",414,8,9,5,0,5,1
"Poland",414,8,6,5,3,2,2
"Russia",415,1,7,7,2,5,1
"Uruguay",415,1,6,5,5,0,2
"Spain",415,2,7,4,0,4,1
"Portugal",415,2,6,7,4,3,2
"Argentina",415,4,7,6,3,3,1
"Croatia",415,4,5,6,5,1,2
"Brazil",415,5,9,7,2,5,1
"Costa Rica",415,5,4,5,5,0,2
"Germany",415,6,7,6,1,5,1
"South Korea",415,6,4,4,3,1,2
"Colombia",415,8,9,4,0,4,1
"Japan",415,8,4,2,2,0,2
"Russia",416,1,7,6,2,4,1
"Uruguay",416,1,5,4,2,2,2
"Peru",416,3,7,5,3,2,1
"Denmark",416,3,4,5,4,1,2
"Brazil",416,5,9,8,2,6,1
"Switzerland",416,5,4,2,2,0,2
"Colombia",416,8,5,5,2,3,1
"Senegal",416,8,4,3,5,-2,2
"Saudi Arabia",417,1,9,7,0,7,1
"Uruguay",417,1,6,5,2,3,2
"Spain",417,2,7,4,2,2,1
"Portugal",417,2,5,2,1,1,2
"South Korea",417,6,7,6,1,5,1
"Germany",417,6,6,5,5,0,2
"Poland",417,8,7,4,1,3,1
"Japan",417,8,3,2,2,0,2
"Russia",418,1,6,4,2,2,1
"Uruguay",418,1,5,2,1,1,2
"Spain",418,2,7,5,1,4,1
"Portugal",418,2,6,2,1,1,2
"France",418,3,9,6,1,5,1
"Peru",418,3,4,3,3,0,2
"Argentina",418,4,7,8,1,7,1
"Croatia",418,4,6,6,5,1,2
"Japan",418,8,7,4,1,3,1
"Poland",418,8,4,3,2,1,2
"Uruguay",419,1,7,4,2,2,1
"Egypt",419,1,5,5,2,3,2
"Spain",419,2,5,7,6,1,1
"Portugal",419,2,4,3,3,0,2
"France",419,3,9,7,2,5,1
"Australia",419,3,4,4,5,-1,2
"Argentina",419,4,7,7,1,6,1
"Croatia",419,4,4,4,6,-2,2
"Brazil",419,5,7,7,2,5,1
"Costa Rica",419,5,6,7,3,4,2
"England",419,7,9,6,0,6,1
"Belgium",419,7,6,8,3,5,2
"Russia",420,1,9,6,1,5,1
"Saudi Arabia",420,1,4,4,4,0,2
"Iran",420,2,7,3,0,3,1
"Spain",420,2,4,4,3,1,2
"Brazil",420,5,9,7,1,6,1
"Switzerland",420,5,6,3,2,1,2
"South Korea",420,6,7,4,2,2,1
"Germany",420,6,5,1,0,1,2
"Belgium",420,7,9,7,1,6,1
"Panama",420,7,6,4,4,0,2
"Colombia",420,8,9,3,0,3,1
"Poland",420,8,6,2,1,1,2
"Uruguay",421,1,7,6,3,3,1
"Egypt",421,1,4,2,3,-1,2
"Switzerland",421,5,7,6,3,3,1
"Brazil",421,5,4,4,3,1,2
"Germany",421,6,9,4,1,3,1
"Mexico",421,6,6,4,2,2,2
"England",421,7,9,8,2,6,1
"Belgium",421,7,6,6,3,3,2
"Colombia",421,8,7,5,0,5,1
"Japan",421,8,4,3,3,0,2
"Spain",422,2,9,8,3,5,1
"Iran",422,2,6,5,5,0,2
"Denmark",422,3,7,4,2,2,1
"Peru",422,3,6,4,3,1,2
"Iceland",422,4,7,5,2,3,1
"Croatia",422,4,6,5,2,3,2
"Germany",422,6,7,7,2,5,1
"Mexico",422,6,5,5,1,4,2
"Uruguay",423,1,6,5,2,3,1
"Egypt",423,1,5,2,1,1,2
"Iran",423,2,7,6,1,5,1
"Spain",423,2,4,2,4,-2,2
"France",423,3,7,5,1,4,1
"Denmark",423,3,4,4,2,2,2
"Costa Rica",423,5,7,4,2,2,1
"Brazil",423,5,5,4,2,2,2
"England",423,7,5,1,0,1,1
"Panama",423,7,4,1,1,0,2
"Colombia",423,8,9,7,3,4,1
"Senegal",423,8,6,7,5,2,2
"Saudi Arabia",424,1,7,8,6,2,1
"Russia",424,1,5,4,3,1,2
"Spain",424,2,9,9,2,7,1
"Portugal",424,2,4,2,2,0,2
"Iceland",424,4,7,6,3,3,1
"Croatia",424,4,6,4,2,2,2
"Costa Rica",424,5,5,3,2,1,1
"Brazil",424,5,4,3,3,0,2
"Senegal",424,8,7,3,0,3,1
"Poland",424,8,4,4,4,0,2
"Saudi Arabia",425,1,7,4,1,3,1
"Uruguay",425,1,6,5,2,3,2
"Portugal",425,2,6,5,3,2,1
"Spain",425,2,5,4,2,2,2
"Iceland",425,4,7,8,6,2,1
"Argentina",425,4,6,7,5,2,2
"Costa Rica",425,5,7,5,2,3,1
"Brazil",425,5,5,5,2,3,2
"Mexico",425,6,7,3,1,2,1
"Germany",425,6,6,5,2,3,2
"Belgium",425,7,5,3,1,2,1
"England",425,7,4,3,4,-1,2
"Colombia",425,8,7,3,0,3,1
"Japan",425,8,4,3,3,0,2
"Egypt",426,1,9,8,4,4,1
"Uruguay",426,1,6,4,3,1,2
"Spain",426,2,9,5,0,5,1
"Iran",426,2,6,2,1,1,2
"France",426,3,9,5,0,5,1
"Denmark",426,3,4,2,2,0,2
"Argentina",426,4,9,7,0,7,1
"Croatia",426,4,6,8,4,4,2
"Costa Rica",426,5,7,4,2,2,1
"Brazil",426,5,5,5,2,3,2
"Mexico",426,6,7,3,1,2,1
"South Korea",426,6,6,9,5,4,2
"Uruguay",427,1,9,5,1,4,1
"Russia",427,1,4,6,5,1,2
"Peru",427,3,9,5,0,5,1
"France",427,3,4,2,2,0,2
"Argentina",427,4,7,5,2,3,1
"Nigeria",427,4,6,3,2,1,2
"Switzerland",427,5,9,5,0,5,1
"Brazil",427,5,6,4,3,1,2
"Uruguay",428,1,7,6,2,4,1
"Russia",428,1,5,5,3,2,2
"Spain",428,2,9,7,1,6,1
"Portugal",428,2,4,4,1,3,2
"Nigeria",428,4,7,3,1,2,1
"Argentina",428,4,4,4,5,-1,2
"Brazil",428,5,7,7,2,5,1
"Costa Rica",428,5,5,3,2,1,2
"Mexico",428,6,7,7,3,4,1
"Germany",428,6,5,5,3,2,2
"Uruguay",429,1,9,10,2,8,1
"Saudi Arabia",429,1,4,1,4,-3,2
"Spain",429,2,7,6,1,5,1
"Iran",429,2,5,2,1,1,2
"Argentina",429,4,6,5,4,1,1
"Croatia",429,4,5,4,2,2,2
"Brazil",429,5,7,6,4,2,1
"Serbia",429,5,4,3,4,-1,2
"South Korea",429,6,9,5,0,5,1
"Germany",429,6,6,6,2,4,2
"Colombia",429,8,9,6,1,5,1
"Japan",429,8,6,4,2,2,2
"Argentina",430,4,9,7,1,6,1
"Croatia",430,4,4,5,5,0,2
"Costa Rica",430,5,7,6,1,5,1
"Switzerland",430,5,4,2,2,0,2
"Germany",430,6,7,7,5,2,1
"Mexico",430,6,5,4,3,1,2
"Morocco",431,2,7,4,2,2,1
"Iran",431,2,4,4,3,1,2
"France",431,3,9,12,1,11,1
"Peru",431,3,6,9,4,5,2
"Croatia",431,4,7,6,2,4,1
"Nigeria",431,4,5,3,2,1,2
"Brazil",431,5,7,3,1,2,1
"Costa Rica",431,5,4,3,2,1,2
"South Korea",431,6,7,4,2,2,1
"Germany",431,6,5,5,2,3,2
"Panama",431,7,6,5,4,1,1
"Belgium",431,7,5,3,1,2,2
"Spain",432,2,7,5,0,5,1
"Morocco",432,2,6,4,5,-1,2
"France",432,3,9,5,0,5,1
"Australia",432,3,4,3,4,-1,2
"Argentina",432,4,9,4,0,4,1
"Croatia",432,4,6,4,2,2,2
"England",432,7,7,8,4,4,1
"Panama",432,7,6,4,2,2,2
"Japan",432,8,7,7,1,6,1
"Senegal",432,8,5,2,1,1,2
"Spain",433,2,9,6,0,6,1
"Iran",433,2,4,2,3,-1,2
"Argentina",433,4,9,7,1,6,1
"Nigeria",433,4,6,3,5,-2,2
"Costa Rica",433,5,7,4,0,4,1
"Brazil",433,5,5,2,1,1,2
"Belgium",433,7,6,4,2,2,1
"Tunisia",433,7,5,1,0,1,2
"Colombia",433,8,7,6,2,4,1
"Poland",433,8,6,5,3,2,2
"Australia",434,3,7,5,2,3,1
"France",434,3,6,5,2,3,2
"Argentina",434,4,6,4,1,3,1
"Iceland",434,4,5,2,1,1,2
"England",434,7,7,9,2,7,1
"Belgium",434,7,5,4,2,2,2
"Croatia",435,4,5,6,4,2,1
"Iceland",435,4,4,6,7,-1,2
"Belgium",435,7,7,6,0,6,1
"Panama",435,7,5,1,0,1,2
"Colombia",435,8,9,6,0,6,1
"Poland",435,8,4,2,4,-2,2
"France",436,3,9,5,1,4,1
"Australia",436,3,6,4,2,2,2
"Brazil",436,5,7,7,3,4,1
"Serbia",436,5,6,2,2,0,2
"Japan",436,8,6,6,5,1,1
"Poland",436,8,5,2,1,1,2
"Uruguay",437,1,9,7,0,7,1
"Russia",437,1,4,2,3,-1,2
"Portugal",437,2,9,6,1,5,1
"Spain",437,2,4,5,4,1,2
"France",437,3,9,10,2,8,1
"Denmark",437,3,4,2,5,-3,2
"Iceland",437,4,9,8,1,7,1
"Croatia",437,4,4,2,1,1,2
"Brazil",437,5,7,8,2,6,1
"Costa Rica",437,5,5,1,0,1,2
"Belgium",437,7,7,6,1,5,1
"England",437,7,5,4,2,2,2
"Japan",437,8,9,5,2,3,1
"Senegal",437,8,6,2,1,1,2
"Denmark",438,3,9,5,1,4,1
"France",438,3,6,3,2,1,2
"Argentina",438,4,5,7,2,5,1
"Nigeria",438,4,4,3,7,-4,2
"Costa Rica",438,5,7,3,0,3,1
"Switzerland",438,5,4,3,3,0,2
"Japan",438,8,7,4,2,2,1
"Colombia",438,8,6,3,1,2,2
"Uruguay",439,1,9,5,0,5,1
"Saudi Arabia",439,1,4,3,4,-1,2
"Spain",439,2,7,5,2,3,1
"Portugal",439,2,5,4,3,1,2
"Switzerland",439,5,9,6,1,5,1
"Costa Rica",439,5,4,2,2,0,2
"South Korea",439,6,9,7,1,6,1
"Germany",439,6,6,3,3,0,2
"Belgium",439,7,7,5,2,3,1
"Panama",439,7,5,2,1,1,2
"Poland",439,8,7,4,2,2,1
"Colombia",439,8,5,5,3,2,2
"Iran",440,2,5,4,0,4,1
"Morocco",440,2,4,3,6,-3,2
"France",440,3,9,7,0,7,1
"Australia",440,3,4,4,3,1,2
"Brazil",440,5,9,8,0,8,1
"Serbia",440,5,4,2,3,-1,2
"England",440,7,7,6,2,4,1
"Tunisia",440,7,6,9,5,4,2
"Egypt",441,1,7,7,3,4,1
"Saudi Arabia",441,1,4,2,4,-2,2
"Portugal",441,2,7,7,3,4,1
"Spain",441,2,5,2,1,1,2
"France",441,3,9,8,0,8,1
"Australia",441,3,6,5,6,-1,2
"Brazil",441,5,9,7,0,7,1
"Costa Rica",441,5,4,4,2,2,2
"Panama",441,7,7,3,1,2,1
"Belgium",441,7,4,3,3,0,2
"Portugal",442,2,7,6,1,5,1
"Spain",442,2,5,4,2,2,2
"Croatia",442,4,9,5,1,4,1
"Argentina",442,4,4,2,1,1,2
"Serbia",442,5,7,4,2,2,1
"Brazil",442,5,6,10,4,6,2
"South Korea",442,6,7,6,2,4,1
"Germany",442,6,5,5,4,1,2
"Colombia",442,8,9,6,0,6,1
"Poland",442,8,4,2,3,-1,2
"Portugal",443,2,7,5,0,5,1
"Spain",443,2,5,5,3,2,2
"Germany",443,6,9,5,0,5,1
"Sweden",443,6,4,1,1,0,2
"Poland",443,8,9,5,1,4,1
"Colombia",443,8,6,9,2,7,2
"Spain",444,2,9,10,2,8,1
"Iran",444,2,4,5,5,0,2
"Peru",444,3,7,5,2,3,1
"France",444,3,4,3,1,2,2
"Brazil",444,5,7,6,3,3,1
"Costa Rica",444,5,5,5,4,1,2
"Germany",444,6,7,8,2,6,1
"South Korea",444,6,4,2,3,-1,2
"Uruguay",445,1,7,6,3,3,1
"Saudi Arabia",445,1,5,5,3,2,2
"Denmark",445,3,9,6,2,4,1
"France",445,3,6,6,4,2,2
"Costa Rica",445,5,7,5,2,3,1
"Brazil",445,5,6,6,2,4,2
"Belgium",445,7,7,3,1,2,1
"England",445,7,5,6,2,4,2
"Spain",446,2,7,6,2,4,1
"Iran",446,2,5,4,2,2,2
"Croatia",446,4,7,3,1,2,1
"Argentina",446,4,4,2,2,0,2
"Belgium",446,7,9,7,1,6,1
"England",446,7,6,4,4,0,2
"Colombia",446,8,7,5,1,4,1
"Japan",446,8,4,7,6,1,2
"France",447,3,9,11,0,11,1
"Peru",447,3,4,3,6,-3,2
"Croatia",447,4,7,3,0,3,1
"Argentina",447,4,6,4,1,3,2
"Germany",447,6,7,5,1,4,1
"Mexico",447,6,4,1,1,0,2
"Panama",447,7,7,2,0,2,1
"England",447,7,4,2,2,0,2
"Japan",447,8,7,6,1,5,1
"Colombia",447,8,4,3,3,0,2
"Uruguay",448,1,5,7,5,2,1
"Egypt",448,1,4,3,4,-1,2
"Iran",448,2,7,5,1,4,1
"Spain",448,2,5,3,0,3,2
"France",448,3,9,5,1,4,1
"Peru",448,3,6,3,3,0,2
"Costa Rica",448,5,6,3,2,1,1
"Brazil",448,5,5,4,3,1,2
"Belgium",448,7,9,12,2,10,1
"England",448,7,6,7,9,-2,2
"Saudi Arabia",449,1,7,4,2,2,1
"Egypt",449,1,4,2,2,0,2
"Spain",449,2,7,6,3,3,1
"Morocco",449,2,6,2,1,1,2
"Brazil",449,5,7,9,1,8,1
"Costa Rica",449,5,6,2,6,-4,2
"Mexico",449,6,7,4,1,3,1
"Germany",449,6,5,3,2,1,2
"Japan",449,8,7,2,0,2,1
"Poland",449,8,6,5,1,4,2
"Russia",450,1,7,2,0,2,1
"Uruguay",450,1,6,4,1,3,2
"France",450,3,7,3,0,3,1
"Peru",450,3,6,7,2,5,2
"Argentina",450,4,7,6,0,6,1
"Croatia",450,4,6,3,3,0,2
"South Korea",450,6,7,4,2,2,1
"Mexico",450,6,4,4,3,1,2
"England",450,7,7,6,1,5,1
"Belgium",450,7,4,6,4,2,2
"Uruguay",451,1,9,9,0,9,1
"Russia",451,1,6,4,5,-1,2
"Spain",451,2,7,5,1,4,1
"Portugal",451,2,6,5,4,1,2
"Peru",451,3,9,5,2,3,1
"Denmark",451,3,4,2,1,1,2
"Brazil",451,5,7,9,0,9,1
"Costa Rica",451,5,6,5,3,2,2
"England",451,7,7,6,1,5,1
"Panama",451,7,6,3,4,-1,2
"Poland",451,8,9,9,3,6,1
"Colombia",451,8,6,6,2,4,2
"Uruguay",452,1,7,6,3,3,1
"Egypt",452,1,4,3,5,-2,2
"France",452,3,7,7,2,5,1
"Australia",452,3,6,4,6,-2,2
"Argentina",452,4,9,6,2,4,1
"Croatia",452,4,6,6,3,3,2
"Brazil",452,5,7,5,2,3,1
"Serbia",452,5,6,3,2,1,2
"Germany",452,6,9,8,5,3,1
"Mexico",452,6,6,8,5,3,2
"England",452,7,7,4,2,2,1
"Belgium",452,7,4,4,3,1,2
"Colombia",452,8,9,10,0,10,1
"Poland",452,8,6,3,5,-2,2
"Uruguay",453,1,9,8,1,7,1
"Egypt",453,1,4,3,3,0,2
"Portugal",453,2,7,9,1,8,1
"Spain",453,2,5,8,5,3,2
"Denmark",453,3,7,3,1,2,1
"Australia",453,3,6,2,1,1,2
"Argentina",453,4,7,7,1,6,1
"Iceland",453,4,5,2,1,1,2
"Brazil",453,5,6,6,5,1,1
"Switzerland",453,5,5,4,1,3,2
"Belgium",453,7,7,5,2,3,1
"Panama",453,7,4,2,3,-1,2
"Japan",453,8,9,5,1,4,1
"Colombia",453,8,4,3,4,-1,2
"Portugal",454,2,9,4,1,3,1
"Spain",454,2,6,3,2,1,2
"France",454,3,9,5,2,3,1
"Peru",454,3,4,1,1,0,2
"Argentina",454,4,6,7,3,4,1
"Iceland",454,4,5,4,3,1,2
"Colombia",454,8,9,5,0,5,1
"Japan",454,8,6,2,1,1,2
"Uruguay",455,1,7,3,0,3,1
"Saudi Arabia",455,1,6,5,5,0,2
"Switzerland",455,5,6,6,3,3,1
"Brazil",455,5,5,3,1,2,2
"Germany",455,6,9,6,0,6,1
"South Korea",455,6,4,2,2,0,2
"Belgium",455,7,7,5,0,5,1
"Panama",455,7,6,5,3,2,2
"Colombia",455,8,7,5,2,3,1
"Senegal",455,8,6,5,3,2,2
"Uruguay",456,1,7,5,2,3,1
"Saudi Arabia",456,1,4,5,5,0,2
"Spain",456,2,7,4,1,3,1
"Iran",456,2,4,1,2,-1,2
"Peru",456,3,9,4,0,4,1
"Australia",456,3,6,3,2,1,2
"Argentina",456,4,6,7,4,3,1
"Croatia",456,4,5,7,6,1,2
"Brazil",456,5,9,9,1,8,1
"Costa Rica",456,5,4,3,2,1,2
"Mexico",456,6,9,6,2,4,1
"Germany",456,6,4,6,4,2,2
"Belgium",456,7,9,6,0,6,1
"England",456,7,6,3,2,1,2
"Poland",456,8,6,3,2,1,1
"Japan",456,8,5,3,2,1,2
"Egypt",457,1,9,6,2,4,1
"Uruguay",457,1,4,2,3,-1,2
"Iran",457,2,9,6,3,3,1
"Spain",457,2,6,3,2,1,2
"Brazil",457,5,9,7,1,6,1
"Costa Rica",457,5,6,6,2,4,2
"Mexico",457,6,7,5,3,2,1
"Germany",457,6,4,2,2,0,2
"Colombia",457,8,7,4,0,4,1
"Senegal",457,8,6,3,3,0,2
"Uruguay",458,1,7,8,4,4,1
"Egypt",458,1,6,8,8,0,2
"Argentina",458,4,9,11,1,10,1
"Nigeria",458,4,6,5,5,0,2
"Serbia",458,5,7,4,2,2,1
"Costa Rica",458,5,5,4,2,2,2
"Belgium",458,7,9,4,0,4,1
"England",458,7,6,7,2,5,2
"Colombia",458,8,7,3,1,2,1
"Japan",458,8,5,2,1,1,2
"Portugal",459,2,7,6,2,4,1
"Spain",459,2,5,4,3,1,2
"France",459,3,9,7,1,6,1
"Denmark",459,3,6,4,2,2,2
"Argentina",459,4,7,5,1,4,1
"Croatia",459,4,6,6,2,4,2
"Switzerland",459,5,7,5,2,3,1
"Brazil",459,5,6,4,2,2,2
"South Korea",459,6,9,6,1,5,1
"Germany",459,6,6,2,2,0,2
"Belgium",459,7,7,6,1,5,1
"England",459,7,5,5,2,3,2
"Iran",460,2,7,4,0,4,1
"Portugal",460,2,6,2,1,1,2
"France",460,3,7,5,1,4,1
"Denmark",460,3,5,3,2,1,2
"Iceland",460,4,7,4,1,3,1
"Croatia",460,4,6,5,2,3,2
"Brazil",460,5,7,7,3,4,1
"Switzerland",460,5,5,3,2,1,2
"Germany",460,6,7,8,4,4,1
"Sweden",460,6,6,5,5,0,2
"England",460,7,7,5,1,4,1
"Panama",460,7,4,4,4,0,2
"Poland",460,8,7,3,0,3,1
"Senegal",460,8,3,1,1,0,2
"Uruguay",461,1,7,4,0,4,1
"Russia",461,1,4,3,4,-1,2
"Portugal",461,2,7,5,2,3,1
"Spain",461,2,5,4,2,2,2
"Denmark",461,3,7,3,0,3,1
"France",461,3,6,5,3,2,2
"Serbia",461,5,7,7,2,5,1
"Brazil",461,5,6,7,6,1,2
"Tunisia",461,7,6,4,6,-2,1
"England",461,7,5,7,2,5,2
"Colombia",461,8,7,8,0,8,1
"Poland",461,8,4,2,2,0,2
"Russia",462,1,7,5,3,2,1
"Uruguay",462,1,6,4,3,1,2
"Germany",462,6,7,4,0,4,1
"Mexico",462,6,5,2,1,1,2
"Belgium",462,7,7,8,3,5,1
"Panama",462,7,3,5,5,0,2
"Colombia",462,8,7,8,1,7,1
"Poland",462,8,5,4,2,2,2
"Uruguay",463,1,7,6,3,3,1
"Russia",463,1,6,6,3,3,2
"Spain",463,2,7,6,3,3,1
"Portugal",463,2,6,6,4,2,2
"Argentina",463,4,7,7,1,6,1
"Nigeria",463,4,4,4,5,-1,2
"Switzerland",463,5,7,4,1,3,1
"Costa Rica",463,5,4,2,2,0,2
"Germany",463,6,7,4,0,4,1
"Mexico",463,6,6,3,3,0,2
"Belgium",463,7,6,4,2,2,1
"England",463,7,5,3,2,1,2
"Uruguay",464,1,5,5,2,3,1
"Saudi Arabia",464,1,4,3,4,-1,2
"Portugal",464,2,7,6,4,2,1
"Iran",464,2,5,7,4,3,2
"Argentina",464,4,7,6,1,5,1
"Iceland",464,4,4,6,6,0,2
"Brazil",464,5,6,7,2,5,1
"Switzerland",464,5,5,5,4,1,2
"Germany",464,6,9,5,2,3,1
"Mexico",464,6,6,4,3,1,2
"England",464,7,5,4,0,4,1
"Tunisia",464,7,4,2,5,-3,2
"Poland",464,8,7,4,2,2,1
"Japan",464,8,4,4,4,0,2
"Portugal",465,2,7,5,3,2,1
"Spain",465,2,6,7,2,5,2
"Argentina",465,4,9,5,0,5,1
"Nigeria",465,4,4,4,4,0,2
"Brazil",465,5,7,4,2,2,1
"Costa Rica",465,5,4,3,2,1,2
"Germany",465,6,9,7,4,3,1
"Sweden",465,6,4,3,2,1,2
"Belgium",465,7,9,7,0,7,1
"Panama",465,7,6,3,1,2,2
"Colombia",465,8,7,7,2,5,1
"Japan",465,8,4,3,2,1,2
"Portugal",466,2,7,8,1,7,1
"Iran",466,2,5,2,1,1,2
"Argentina",466,4,5,3,0,3,1
"Nigeria",466,4,4,2,4,-2,2
"Germany",466,6,9,7,0,7,1
"Mexico",466,6,6,2,3,-1,2
"Belgium",466,7,9,6,0,6,1
"England",466,7,6,3,2,1,2
"France",467,3,7,5,2,3,1
"Peru",467,3,4,3,3,0,2
"Switzerland",467,5,7,3,0,3,1
"Costa Rica",467,5,6,3,2,1,2
"Germany",467,6,7,5,1,4,1
"Mexico",467,6,6,7,6,1,2
"Panama",467,7,5,3,2,1,1
"England",467,7,4,2,1,1,2
"Colombia",467,8,7,3,0,3,1
"Japan",467,8,4,2,1,1,2
"Germany",468,6,9,11,1,10,1
"Sweden",468,6,4,4,6,-2,2
"Belgium",468,7,9,3,0,3,1
"England",468,7,6,8,1,7,2
"Spain",469,2,7,9,2,7,1
"Portugal",469,2,4,5,5,0,2
"Croatia",469,4,7,6,2,4,1
"Argentina",469,4,6,2,2,0,2
"Mexico",469,6,9,6,1,5,1
"South Korea",469,6,6,4,2,2,2
"Japan",469,8,7,5,1,4,1
"Senegal",469,8,6,3,3,0,2
"Russia",470,1,9,3,0,3,1
"Uruguay",470,1,6,3,2,1,2
"Iran",470,2,9,6,3,3,1
"Spain",470,2,4,4,4,0,2
"Australia",470,3,7,3,1,2,1
"Denmark",470,3,4,2,2,0,2
"Brazil",470,5,9,4,1,3,1
"Costa Rica",470,5,6,4,3,1,2
"Germany",470,6,9,10,1,9,1
"Mexico",470,6,4,2,4,-2,2
"Uruguay",471,1,7,4,1,3,1
"Egypt",471,1,4,1,1,0,2
"Spain",471,2,9,6,1,5,1
"Iran",471,2,6,6,3,3,2
"Peru",471,3,7,7,3,4,1
"France",471,3,6,6,3,3,2
"Argentina",471,4,6,8,5,3,1
"Croatia",471,4,5,6,2,4,2
"England",471,7,7,6,3,3,1
"Panama",471,7,5,5,4,1,2
"Japan",471,8,7,3,0,3,1
"Colombia",471,8,4,2,2,0,2
"Spain",472,2,7,5,0,5,1
"Portugal",472,2,5,3,2,1,2
"France",472,3,7,4,1,3,1
"Denmark",472,3,6,3,2,1,2
"Iceland",472,4,7,5,1,4,1
"Argentina",472,4,6,4,2,2,2
"South Korea",472,6,7,6,3,3,1
"Germany",472,6,6,6,2,4,2
"Panama",472,7,7,5,3,2,1
"England",472,7,4,4,4,0,2
"Spain",473,2,7,6,1,5,1
"Portugal",473,2,6,4,3,1,2
"Brazil",473,5,9,8,1,7,1
"Switzerland",473,5,6,6,4,2,2
"South Korea",473,6,9,4,1,3,1
"Mexico",473,6,6,3,1,2,2
"Colombia",473,8,9,6,1,5,1
"Senegal",473,8,6,3,4,-1,2
"Uruguay",474,1,9,5,0,5,1
"Saudi Arabia",474,1,6,4,2,2,2
"Peru",474,3,7,3,1,2,1
"France",474,3,6,5,3,2,2
"Argentina",474,4,7,6,3,3,1
"Croatia",474,4,4,3,3,0,2
"Germany",474,6,9,5,1,4,1
"Sweden",474,6,6,3,2,1,2
"England",474,7,7,2,0,2,1
"Belgium",474,7,6,4,2,2,2
"Poland",474,8,7,4,2,2,1
"Senegal",474,8,4,3,2,1,2
"Uruguay",475,1,7,4,0,4,1
"Saudi Arabia",475,1,4,1,3,-2,2
"Portugal",475,2,9,6,1,5,1
"Iran",475,2,4,2,1,1,2
"France",475,3,5,3,1,2,1
"Denmark",475,3,4,4,5,-1,2
"Argentina",475,4,7,5,2,3,1
"Croatia",475,4,5,7,4,3,2
"Brazil",475,5,9,8,3,5,1
"Costa Rica",475,5,6,9,5,4,2
"Spain",476,2,7,4,1,3,1
"Morocco",476,2,4,2,2,0,2
"Peru",476,3,7,3,1,2,1
"Australia",476,3,6,2,1,1,2
"Costa Rica",476,5,9,6,1,5,1
"Switzerland",476,5,6,4,2,2,2
"Mexico",476,6,7,4,1,3,1
"Germany",476,6,6,4,2,2,2
"England",476,7,7,6,2,4,1
"Panama",476,7,5,2,1,1,2
"Poland",476,8,7,3,1,2,1
"Colombia",476,8,6,3,2,1,2
"Spain",477,2,9,6,0,6,1
"Portugal",477,2,6,3,1,2,2
"France",477,3,7,6,2,4,1
"Denmark",477,3,4,4,5,-1,2
"Germany",477,6,6,5,3,2,1
"Mexico",477,6,5,4,2,2,2
"England",477,7,9,10,2,8,1
"Tunisia",477,7,4,3,5,-2,2
"Colombia",477,8,7,5,1,4,1
"Poland",477,8,4,2,2,0,2
"Uruguay",478,1,9,5,0,5,1
"Russia",478,1,4,5,4,1,2
"France",478,3,9,6,2,4,1
"Australia",478,3,4,2,3,-1,2
"Argentina",478,4,7,4,1,3,1
"Croatia",478,4,5,5,3,2,2
"Brazil",478,5,5,2,1,1,1
"Switzerland",478,5,4,3,2,1,2
"England",478,7,7,6,1,5,1
"Panama",478,7,5,2,1,1,2
"Uruguay",479,1,7,3,0,3,1
"Egypt",479,1,4,3,2,1,2
"Iran",479,2,9,5,0,5,1
"Portugal",479,2,6,4,1,3,2
"Argentina",479,4,7,6,3,3,1
"Nigeria",479,4,5,5,4,1,2
"Brazil",479,5,9,9,3,6,1
"Serbia",479,5,6,4,3,1,2
"South Korea",479,6,7,4,1,3,1
"Germany",479,6,6,3,1,2,2
"England",479,7,9,5,0,5,1
"Belgium",479,7,6,5,2,3,2
"Uruguay",480,1,7,6,3,3,1
"Russia",480,1,4,3,2,1,2
"Australia",480,3,9,6,1,5,1
"France",480,3,6,4,3,1,2
"Croatia",480,4,9,6,3,3,1
"Argentina",480,4,4,4,3,1,2
"Brazil",480,5,9,8,2,6,1
"Switzerland",480,5,6,6,3,3,2
"Poland",480,8,7,6,4,2,1
"Japan",480,8,5,3,2,1,2
"Argentina",481,4,7,7,0,7,1
"Iceland",481,4,4,1,2,-1,2
"Colombia",481,8,7,4,1,3,1
"Senegal",481,8,5,6,3,3,2
"Egypt",482,1,7,4,2,2,1
"Uruguay",482,1,6,9,5,4,2
"France",482,3,9,9,1,8,1
"Peru",482,3,6,2,4,-2,2
"Brazil",482,5,7,3,0,3,1
"Switzerland",482,5,3,2,2,0,2
"Mexico",482,6,7,6,2,4,1
"Germany",482,6,5,5,3,2,2
"England",482,7,9,5,0,5,1
"Panama",482,7,4,1,2,-1,2
"Japan",482,8,9,6,2,4,1
"Senegal",482,8,6,5,2,3,2
"Saudi Arabia",483,1,7,4,2,2,1
"Russia",483,1,6,6,3,3,2
"Spain",483,2,7,7,2,5,1
"Iran",483,2,6,4,4,0,2
"Peru",483,3,5,6,4,2,1
"Denmark",483,3,4,3,3,0,2
"Iceland",483,4,6,5,3,2,1
"Croatia",483,4,5,7,4,3,2
"Mexico",483,6,7,5,2,3,1
"Germany",483,6,5,9,5,4,2
"Japan",483,8,9,4,1,3,1
"Colombia",483,8,4,2,2,0,2
"Uruguay",484,1,9,5,0,5,1
"Saudi Arabia",484,1,4,3,2,1,2
"France",484,3,7,6,0,6,1
"Peru",484,3,6,6,3,3,2
"Argentina",484,4,7,3,1,2,1
"Croatia",484,4,4,2,4,-2,2
"Costa Rica",484,5,9,7,4,3,1
"Switzerland",484,5,6,7,5,2,2
"Sweden",484,6,7,6,2,4,1
"South Korea",484,6,6,5,5,0,2
"England",484,7,7,6,2,4,1
"Panama",484,7,6,6,4,2,2
"Spain",485,2,7,8,2,6,1
"Portugal",485,2,5,6,3,3,2
"Argentina",485,4,9,7,1,6,1
"Croatia",485,4,4,2,3,-1,2
"Switzerland",485,5,7,5,2,3,1
"Costa Rica",485,5,4,3,3,0,2
"England",485,7,7,6,2,4,1
"Belgium",485,7,4,4,4,0,2
"Russia",486,1,7,8,4,4,1
"Uruguay",486,1,4,5,5,0,2
"Spain",486,2,9,9,2,7,1
"Portugal",486,2,6,5,5,0,2
"Argentina",486,4,7,3,1,2,1
"Iceland",486,4,4,5,5,0,2
"Switzerland",486,5,6,3,1,2,1
"Costa Rica",486,5,5,4,3,1,2
"Germany",486,6,7,9,4,5,1
"South Korea",486,6,6,5,5,0,2
"Poland",486,8,7,5,0,5,1
"Colombia",486,8,6,2,2,0,2
"Uruguay",487,1,9,10,2,8,1
"Russia",487,1,6,4,6,-2,2
"Iran",487,2,7,9,4,5,1
"Spain",487,2,5,6,4,2,2
"France",487,3,9,4,1,3,1
"Peru",487,3,6,5,1,4,2
"Brazil",487,5,9,8,2,6,1
"Switzerland",487,5,6,7,6,1,2
"Sweden",487,6,7,2,0,2,1
"South Korea",487,6,4,4,4,0,2
"England",487,7,7,6,3,3,1
"Tunisia",487,7,4,5,4,1,2
"Uruguay",488,1,7,3,0,3,1
"Egypt",488,1,5,2,0,2,2
"France",488,3,9,12,3,9,1
"Australia",488,3,4,3,6,-3,2
"Brazil",488,5,9,7,1,6,1
"Serbia",488,5,4,3,4,-1,2
"Germany",488,6,9,11,3,8,1
"Mexico",488,6,6,4,4,0,2
"Poland",488,8,7,5,3,2,1
"Japan",488,8,6,8,6,2,2
"Egypt",489,1,5,4,3,1,1
"Uruguay",489,1,4,6,6,0,2
"Portugal",489,2,7,3,1,2,1
"Spain",489,2,6,3,2,1,2
"Croatia",489,4,9,6,1,5,1
"Argentina",489,4,4,4,5,-1,2
"Brazil",489,5,9,8,1,7,1
"Switzerland",489,5,6,4,1,3,2
"Germany",489,6,9,9,2,7,1
"South Korea",489,6,6,5,6,-1,2
"Japan",489,8,7,7,3,4,1
"Senegal",489,8,4,2,2,0,2
"Spain",490,2,7,6,0,6,1
"Iran",490,2,4,4,4,0,2
"Peru",490,3,7,2,0,2,1
"France",490,3,5,3,2,1,2
"Brazil",490,5,7,4,1,3,1
"Costa Rica",490,5,5,4,3,1,2
"Germany",490,6,7,5,1,4,1
"Sweden",490,6,4,5,5,0,2
"Iran",491,2,9,6,0,6,1
"Spain",491,2,6,4,1,3,2
"Brazil",491,5,9,4,1,3,1
"Costa Rica",491,5,6,3,2,1,2
"Japan",491,8,7,4,1,3,1
"Colombia",491,8,4,2,2,0,2
"Uruguay",492,1,7,3,0,3,1
"Russia",492,1,6,3,2,1,2
"Croatia",492,4,9,5,2,3,1
"Argentina",492,4,6,5,1,4,2
"Costa Rica",492,5,7,2,0,2,1
"Brazil",492,5,6,3,1,2,2
"Germany",492,6,7,8,1,7,1
"South Korea",492,6,4,1,5,-4,2
"Japan",492,8,7,8,3,5,1
"Poland",492,8,4,4,4,0,2
"Australia",493,3,7,7,5,2,1
"Denmark",493,3,4,4,4,0,2
"Argentina",493,4,7,4,1,3,1
"Nigeria",493,4,4,4,4,0,2
"Brazil",493,5,9,7,1,6,1
"Costa Rica",493,5,4,4,1,3,2
"South Korea",493,6,9,4,1,3,1
"Germany",493,6,4,4,3,1,2
"Colombia",493,8,7,3,0,3,1
"Japan",493,8,4,4,5,-1,2
"Uruguay",494,1,7,9,5,4,1
"Russia",494,1,5,5,3,2,2
"Portugal",494,2,6,5,4,1,1
"Spain",494,2,5,6,3,3,2
"Peru",494,3,9,7,0,7,1
"France",494,3,6,6,1,5,2
"Argentina",494,4,9,6,0,6,1
"Iceland",494,4,6,3,1,2,2
"Brazil",494,5,9,5,1,4,1
"Switzerland",494,5,4,6,4,2,2
"Saudi Arabia",495,1,7,3,0,3,1
"Uruguay",495,1,6,9,1,8,2
"Brazil",495,5,9,10,1,9,1
"Costa Rica",495,5,4,4,5,-1,2
"Germany",495,6,7,4,0,4,1
"South Korea",495,6,4,3,2,1,2
"England",495,7,7,5,0,5,1
"Tunisia",495,7,5,2,1,1,2
"Colombia",495,8,6,2,2,0,1
"Poland",495,8,5,5,3,2,2
"Iran",496,2,7,5,2,3,1
"Portugal",496,2,6,6,3,3,2
"Denmark",496,3,7,7,3,4,1
"France",496,3,5,7,4,3,2
"Nigeria",496,4,5,2,1,1,1
"Argentina",496,4,4,4,1,3,2
"Brazil",496,5,7,8,5,3,1
"Switzerland",496,5,5,8,5,3,2
"England",496,7,7,4,0,4,1
"Panama",496,7,4,3,2,1,2
"Colombia",496,8,9,10,5,5,1
"Japan",496,8,4,4,4,0,2
"France",497,3,9,7,1,6,1
"Peru",497,3,6,7,2,5,2
"Argentina",497,4,7,6,3,3,1
"Nigeria",497,4,6,4,3,1,2
"Germany",497,6,6,4,4,0,1
"South Korea",497,6,5,3,1,2,2
"England",497,7,9,7,1,6,1
"Belgium",497,7,6,4,2,2,2
"Japan",497,8,5,4,2,2,1
"Colombia",497,8,4,3,3,0,2
"Saudi Arabia",498,1,6,3,2,1,1
"Uruguay",498,1,5,3,2,1,2
"France",498,3,9,6,1,5,1
"Peru",498,3,4,4,2,2,2
"Argentina",498,4,7,3,1,2,1
"Nigeria",498,4,5,3,2,1,2
"Brazil",498,5,7,4,2,2,1
"Costa Rica",498,5,4,4,3,1,2
"Japan",498,8,7,5,3,2,1
"Colombia",498,8,4,1,1,0,2
"Spain",499,2,7,7,3,4,1
"Portugal",499,2,6,5,4,1,2
"France",499,3,9,7,0,7,1
"Denmark",499,3,6,3,3,0,2
"Argentina",499,4,9,8,2,6,1
"Croatia",499,4,6,4,1,3,2
"Brazil",499,5,9,5,1,4,1
"Costa Rica",499,5,6,5,3,2,2
"England",499,7,6,6,2,4,1
"Panama",499,7,5,3,2,1,2
"Japan",499,8,7,3,0,3,1
"Colombia",499,8,4,5,5,0,2
"Uruguay",500,1,9,5,1,4,1
"Russia",500,1,6,4,2,2,2
"France",500,3,9,5,0,5,1
"Australia",500,3,6,7,4,3,2
"Argentina",500,4,6,6,2,4,1
"Croatia",500,4,5,5,4,1,2
"Uruguay",501,1,9,5,1,4,1
"Egypt",501,1,6,6,4,2,2
"Peru",501,3,7,5,0,5,1
"Denmark",501,3,6,4,2,2,2
"Argentina",501,4,7,5,2,3,1
"Iceland",501,4,4,3,3,0,2
"Brazil",501,5,7,3,0,3,1
"Serbia",501,5,4,1,2,-1,2
"Germany",501,6,7,3,0,3,1
"South Korea",501,6,5,1,0,1,2
"Poland",501,8,6,5,2,3,1
"Japan",501,8,5,5,4,1,2
"Iran",502,2,7,4,0,4,1
"Spain",502,2,6,3,3,0,2
"Uruguay",503,1,9,5,1,4,1
"Egypt",503,1,6,5,3,2,2
"Brazil",503,5,5,5,4,1,1
"Serbia",503,5,4,3,3,0,2
"England",503,7,7,5,1,4,1
"Tunisia",503,7,6,3,3,0,2
"Saudi Arabia",504,1,7,5,1,4,1
"Uruguay",504,1,4,2,3,-1,2
"Portugal",504,2,7,3,0,3,1
"Iran",504,2,5,3,0,3,2
"France",504,3,7,6,2,4,1
"Peru",504,3,6,5,3,2,2
"Argentina",504,4,9,7,1,6,1
"Croatia",504,4,6,3,3,0,2
"Brazil",504,5,9,7,1,6,1
"Switzerland",504,5,4,4,2,2,2
"Germany",504,6,9,5,1,4,1
"South Korea",504,6,6,4,2,2,2
"Uruguay",505,1,9,3,0,3,1
"Saudi Arabia",505,1,4,1,1,0,2
"South Korea",505,6,7,4,2,2,1
"Mexico",505,6,6,3,2,1,2
"France",506,3,9,7,0,7,1
"Peru",506,3,6,3,3,0,2
"Argentina",506,4,9,9,0,9,1
"Croatia",506,4,4,4,4,0,2
"Germany",506,6,7,5,3,2,1
"Mexico",506,6,5,3,2,1,2
"Belgium",506,7,9,4,1,3,1
"Tunisia",506,7,4,2,1,1,2
"Senegal",506,8,7,8,5,3,1
"Colombia",506,8,4,5,4,1,2
"Uruguay",507,1,7,11,2,9,1
"Egypt",507,1,6,3,4,-1,2
"Iran",507,2,7,7,2,5,1
"Spain",507,2,5,2,0,2,2
"Germany",507,6,7,4,1,3,1
"Sweden",507,6,6,4,3,1,2
"Uruguay",508,1,7,3,1,2,1
"Egypt",508,1,6,3,1,2,2
"Iran",508,2,7,4,2,2,1
"Portugal",508,2,6,3,2,1,2
"France",508,3,7,3,0,3,1
"Denmark",508,3,5,4,3,1,2
"Brazil",508,5,7,6,4,2,1
"Serbia",508,5,5,7,4,3,2
"Germany",508,6,9,11,1,10,1
"Sweden",508,6,4,1,3,-2,2
"England",508,7,7,5,1,4,1
"Belgium",508,7,6,11,4,7,2
"Russia",509,1,7,6,2,4,1
"Egypt",509,1,5,3,2,1,2
"France",509,3,7,4,1,3,1
"Peru",509,3,5,5,3,2,2
"Brazil",509,5,7,3,0,3,1
"Costa Rica",509,5,6,6,3,3,2
"Poland",509,8,9,4,1,3,1
"Japan",509,8,6,4,2,2,2
"Portugal",510,2,9,6,1,5,1
"Spain",510,2,4,2,2,0,2
"France",510,3,6,3,3,0,1
"Peru",510,3,5,4,2,2,2
"Brazil",510,5,7,6,1,5,1
"Switzerland",510,5,4,6,6,0,2
"England",510,7,7,4,1,3,1
"Belgium",510,7,6,8,5,3,2
"Poland",510,8,7,8,1,7,1
"Senegal",510,8,3,3,3,0,2
"Saudi Arabia",511,1,6,4,4,0,1
"Uruguay",511,1,5,4,2,2,2
"Costa Rica",511,5,7,5,2,3,1
"Switzerland",511,5,6,2,2,0,2
"Uruguay",512,1,7,7,4,3,1
"Saudi Arabia",512,1,3,3,3,0,2
"Argentina",512,4,7,5,2,3,1
"Croatia",512,4,6,7,4,3,2
"Switzerland",512,5,7,4,2,2,1
"Brazil",512,5,5,2,1,1,2
"Germany",512,6,7,5,3,2,1
"Mexico",512,6,6,7,5,2,2
"Poland",512,8,9,5,2,3,1
"Japan",512,8,4,4,3,1,2
"Egypt",513,1,7,5,3,2,1
"Uruguay",513,1,4,2,1,1,2
"Portugal",513,2,7,5,3,2,1
"Morocco",513,2,5,2,1,1,2
"Argentina",513,4,7,10,3,7,1
"Croatia",513,4,5,4,3,1,2
"Belgium",513,7,9,7,1,6,1
"England",513,7,4,2,2,0,2
"Colombia",513,8,7,5,2,3,1
"Senegal",513,8,6,6,4,2,2
"Croatia",514,4,7,5,1,4,1
"Argentina",514,4,5,3,2,1,2
"Brazil",514,5,7,8,4,4,1
"Serbia",514,5,6,5,3,2,2
"Uruguay",515,1,7,4,2,2,1
"Russia",515,1,6,6,3,3,2
"Iran",515,2,7,5,1,4,1
"Spain",515,2,6,4,3,1,2
"Australia",515,3,7,5,0,5,1
"France",515,3,5,2,1,1,2
"Argentina",515,4,7,5,2,3,1
"Croatia",515,4,5,6,5,1,2
"Brazil",515,5,9,10,1,9,1
"Costa Rica",515,5,6,3,2,1,2
"Germany",515,6,9,7,2,5,1
"Mexico",515,6,6,3,2,1,2
"Colombia",515,8,7,5,1,4,1
"Poland",515,8,4,2,3,-1,2
"Iran",516,2,9,5,1,4,1
"Portugal",516,2,6,4,2,2,2
"Argentina",516,4,9,6,2,4,1
"Croatia",516,4,6,7,4,3,2
"Switzerland",516,5,7,4,1,3,1
"Brazil",516,5,6,9,1,8,2
"Germany",516,6,7,5,3,2,1
"Sweden",516,6,4,4,4,0,2
"England",516,7,9,5,0,5,1
"Belgium",516,7,6,8,2,6,2
"Uruguay",517,1,9,9,1,8,1
"Saudi Arabia",517,1,6,4,4,0,2
"Spain",517,2,7,7,4,3,1
"Iran",517,2,5,4,3,1,2
"Peru",517,3,9,5,1,4,1
"France",517,3,6,8,4,4,2
"Argentina",517,4,9,8,2,6,1
"Nigeria",517,4,6,6,6,0,2
"Germany",517,6,7,4,2,2,1
"South Korea",517,6,4,3,2,1,2
"Brazil",518,5,9,7,1,6,1
"Switzerland",518,5,4,5,5,0,2
"Mexico",518,6,7,6,1,5,1
"Germany",518,6,5,5,2,3,2
"Belgium",518,7,7,3,0,3,1
"England",518,7,6,4,2,2,2
"Poland",518,8,7,4,2,2,1
"Japan",518,8,5,6,4,2,2
"Portugal",519,2,7,8,2,6,1
"Spain",519,2,6,5,3,2,2
"Brazil",519,5,9,10,1,9,1
"Switzerland",519,5,6,3,4,-1,2
"Germany",519,6,7,5,2,3,1
"Mexico",519,6,4,3,3,0,2
"England",519,7,9,10,4,6,1
"Belgium",519,7,6,5,3,2,2
"Saudi Arabia",520,1,9,4,1,3,1
"Egypt",520,1,4,4,3,1,2
"Iran",520,2,7,5,2,3,1
"Spain",520,2,6,7,5,2,2
"Denmark",520,3,7,5,3,2,1
"France",520,3,5,3,2,1,2
"Argentina",520,4,9,8,1,7,1
"Croatia",520,4,4,4,3,1,2
"Brazil",520,5,6,6,4,2,1
"Costa Rica",520,5,5,4,3,1,2
"Colombia",520,8,7,5,2,3,1
"Poland",520,8,6,3,3,0,2
"Portugal",521,2,7,4,0,4,1
"Spain",521,2,6,3,1,2,2
"France",521,3,9,7,2,5,1
"Australia",521,3,4,4,5,-1,2
"Argentina",521,4,9,4,1,3,1
"Croatia",521,4,6,2,1,1,2
"Mexico",521,6,5,2,1,1,1
"South Korea",521,6,4,3,3,0,2
"Japan",521,8,7,5,2,3,1
"Poland",521,8,6,5,3,2,2
"Uruguay",522,1,7,6,1,5,1
"Egypt",522,1,6,4,3,1,2
"England",522,7,7,4,1,3,1
"Belgium",522,7,3,3,3,0,2
"Iran",523,2,9,7,0,7,1
"Spain",523,2,6,5,3,2,2
"Peru",523,3,7,5,3,2,1
"Australia",523,3,3,3,3,0,2
"Argentina",523,4,9,8,0,8,1
"Croatia",523,4,4,2,5,-3,2
"Germany",523,6,7,3,0,3,1
"South Korea",523,6,6,4,1,3,2
"Colombia",523,8,7,6,2,4,1
"Poland",523,8,5,5,3,2,2
"Uruguay",524,1,9,7,1,6,1
"Russia",524,1,4,3,2,1,2
"Portugal",524,2,7,5,1,4,1
"Spain",524,2,5,1,0,1,2
"Australia",524,3,7,5,2,3,1
"France",524,3,6,5,4,1,2
"Argentina",524,4,9,10,4,6,1
"Croatia",524,4,6,13,6,7,2
"Brazil",524,5,7,3,0,3,1
"Serbia",524,5,4,2,2,0,2
"Germany",524,6,7,6,1,5,1
"South Korea",524,6,6,3,3,0,2
"Japan",524,8,7,4,2,2,1
"Colombia",524,8,5,6,5,1,2
"Portugal",525,2,7,3,0,3,1
"Iran",525,2,4,2,2,0,2
"Germany",525,6,7,6,4,2,1
"Mexico",525,6,4,5,3,2,2
"Japan",525,8,7,7,2,5,1
"Poland",525,8,5,1,0,1,2
"Argentina",526,4,7,2,0,2,1
"Iceland",526,4,4,2,1,1,2
"Brazil",526,5,9,6,0,6,1
"Costa Rica",526,5,6,2,1,1,2
"Germany",526,6,9,7,1,6,1
"Sweden",526,6,6,5,5,0,2
"Colombia",526,8,7,6,1,5,1
"Poland",526,8,5,4,1,3,2
"Spain",527,2,7,4,1,3,1
"Iran",527,2,4,3,4,-1,2
"Argentina",527,4,7,6,2,4,1
"Croatia",527,4,4,5,5,0,2
"Brazil",527,5,7,4,2,2,1
"Serbia",527,5,4,3,2,1,2
"Panama",527,7,6,4,2,2,1
"England",527,7,5,2,1,1,2
"Portugal",528,2,7,6,1,5,1
"Spain",528,2,6,6,2,4,2
"France",528,3,7,5,0,5,1
"Australia",528,3,6,4,5,-1,2
"Argentina",528,4,9,9,0,9,1
"Iceland",528,4,6,4,5,-1,2
"England",528,7,7,7,2,5,1
"Belgium",528,7,6,6,5,1,2
"Japan",528,8,9,3,0,3,1
"Colombia",528,8,6,3,1,2,2
"Spain",529,2,9,8,2,6,1
"Iran",529,2,6,4,2,2,2
"Nigeria",529,4,5,4,2,2,1
"Iceland",529,4,4,4,5,-1,2
"Costa Rica",529,5,9,7,2,5,1
"Brazil",529,5,6,8,5,3,2
"Portugal",530,2,7,5,1,4,1
"Spain",530,2,6,6,3,3,2
"Argentina",530,4,5,4,3,1,1
"Croatia",530,4,4,2,2,0,2
"Costa Rica",530,5,5,4,3,1,1
"Serbia",530,5,4,3,3,0,2
"Belgium",530,7,7,6,0,6,1
"England",530,7,6,3,2,1,2
"Russia",531,1,9,3,0,3,1
"Uruguay",531,1,6,3,2,1,2
"Argentina",531,4,7,10,0,10,1
"Iceland",531,4,4,3,1,2,2
"Brazil",531,5,9,6,2,4,1
"Switzerland",531,5,6,6,4,2,2
"Poland",531,8,7,5,1,4,1
"Japan",531,8,6,4,3,1,2
"Peru",532,3,6,4,4,0,1
"France",532,3,5,5,2,3,2
"Argentina",532,4,7,6,1,5,1
"Iceland",532,4,5,2,1,1,2
"Brazil",532,5,5,4,2,2,1
"Costa Rica",532,5,4,1,2,-1,2
"Portugal",533,2,7,5,2,3,1
"Spain",533,2,6,7,3,4,2
"France",533,3,7,6,1,5,1
"Australia",533,3,5,4,3,1,2
"Brazil",533,5,7,3,1,2,1
"Costa Rica",533,5,3,1,1,0,2
"Mexico",533,6,7,5,2,3,1
"South Korea",533,6,4,4,4,0,2
"England",533,7,7,4,0,4,1
"Belgium",533,7,6,3,2,1,2
"Uruguay",534,1,9,9,1,8,1
"Egypt",534,1,4,4,6,-2,2
"Spain",534,2,9,6,1,5,1
"Portugal",534,2,6,5,5,0,2
"Argentina",534,4,7,6,1,5,1
"Croatia",534,4,6,5,2,3,2
"Brazil",534,5,9,9,0,9,1
"Serbia",534,5,4,1,4,-3,2
"Germany",534,6,9,5,2,3,1
"South Korea",534,6,6,7,2,5,2
"Belgium",534,7,9,4,0,4,1
"England",534,7,6,5,1,4,2
"Uruguay",535,1,7,5,1,4,1
"Russia",535,1,4,3,3,0,2
"France",535,3,7,8,2,6,1
"Australia",535,3,6,7,4,3,2
"Argentina",535,4,9,8,1,7,1
"Croatia",535,4,6,9,4,5,2
"Brazil",535,5,7,6,2,4,1
"Serbia",535,5,6,2,1,1,2
"Colombia",535,8,9,7,0,7,1
"Poland",535,8,4,4,4,0,2
"Uruguay",536,1,7,6,3,3,1
"Russia",536,1,6,5,4,1,2
"France",536,3,7,6,1,5,1
"Peru",536,3,5,4,2,2,2
"Germany",536,6,7,4,1,3,1
"Sweden",536,6,4,2,2,0,2
"Belgium",536,7,9,7,1,6,1
"England",536,7,4,1,2,-1,2
"Poland",536,8,7,5,1,4,1
"Japan",536,8,4,2,2,0,2
"Uruguay",537,1,7,7,3,4,1
"Saudi Arabia",537,1,4,3,3,0,2
"Peru",537,3,7,4,0,4,1
"France",537,3,5,4,2,2,2
"Brazil",537,5,7,9,3,6,1
"Costa Rica",537,5,4,2,3,-1,2
"Mexico",537,6,7,5,0,5,1
"Germany",537,6,4,4,2,2,2
"Colombia",537,8,7,6,4,2,1
"Poland",537,8,4,5,3,2,2
"Iran",538,2,6,9,4,5,1
"Spain",538,2,5,2,0,2,2
"France",538,3,9,6,0,6,1
"Peru",538,3,6,4,1,3,2
"Argentina",538,4,7,7,3,4,1
"Croatia",538,4,6,5,2,3,2
"Switzerland",538,5,7,4,1,3,1
"Brazil",538,5,6,2,2,0,2
"Mexico",538,6,7,6,2,4,1
"Germany",538,6,4,3,3,0,2
"Russia",539,1,7,6,3,3,1
"Egypt",539,1,4,3,5,-2,2
"Peru",539,3,7,6,4,2,1
"France",539,3,5,6,4,2,2
"Brazil",539,5,7,8,2,6,1
"Serbia",539,5,4,3,6,-3,2
"South Korea",539,6,6,5,3,2,1
"Germany",539,6,5,4,2,2,2
"Belgium",539,7,9,5,2,3,1
"Tunisia",539,7,6,5,3,2,2
"Portugal",540,2,9,6,2,4,1
"Spain",540,2,6,5,3,2,2
"South Korea",540,6,9,6,2,4,1
"Germany",540,6,6,5,2,3,2
"Colombia",540,8,9,5,2,3,1
"Japan",540,8,4,3,3,0,2
"Egypt",541,1,7,5,3,2,1
"Saudi Arabia",541,1,4,6,4,2,2
"France",541,3,7,8,1,7,1
"Australia",541,3,4,3,3,0,2
"Argentina",541,4,9,7,2,5,1
"Iceland",541,4,4,2,1,1,2
"Germany",541,6,7,6,3,3,1
"Sweden",541,6,4,3,4,-1,2
"England",541,7,7,9,4,5,1
"Belgium",541,7,5,7,5,2,2
"Colombia",541,8,7,5,1,4,1
"Senegal",541,8,4,3,3,0,2
"Egypt",542,1,9,9,3,6,1
"Saudi Arabia",542,1,6,3,5,-2,2
"Denmark",542,3,9,4,1,3,1
"France",542,3,4,3,2,1,2
"Croatia",542,4,9,8,3,5,1
"Nigeria",542,4,4,4,6,-2,2
"Belgium",542,7,7,5,1,4,1
"England",542,7,5,4,3,1,2
"Poland",542,8,7,7,2,5,1
"Colombia",542,8,6,3,4,-1,2
"Portugal",543,2,9,4,1,3,1
"Iran",543,2,6,4,2,2,2
"France",543,3,9,9,2,7,1
"Australia",543,3,6,4,6,-2,2
"Argentina",543,4,9,5,0,5,1
"Croatia",543,4,6,6,2,4,2
"Switzerland",543,5,7,3,1,2,1
"Brazil",543,5,4,3,2,1,2
"England",543,7,9,7,3,4,1
"Tunisia",543,7,4,1,2,-1,2
"Egypt",544,1,7,8,3,5,1
"Uruguay",544,1,4,7,4,3,2
"Portugal",544,2,9,7,1,6,1
"Spain",544,2,6,6,3,3,2
"Brazil",544,5,9,8,1,7,1
"Costa Rica",544,5,4,5,2,3,2
"Germany",544,6,7,4,2,2,1
"Mexico",544,6,5,4,2,2,2
"Poland",544,8,7,8,4,4,1
"Colombia",544,8,5,7,4,3,2
"Egypt",545,1,7,5,3,2,1
"Uruguay",545,1,6,5,2,3,2
"Spain",545,2,7,5,0,5,1
"Portugal",545,2,4,4,6,-2,2
"France",545,3,7,2,0,2,1
"Australia",545,3,5,2,1,1,2
"South Korea",545,6,6,3,2,1,1
"Germany",545,6,5,4,2,2,2
"England",545,7,7,6,2,4,1
"Tunisia",545,7,6,4,2,2,2
"France",546,3,9,8,1,7,1
"Peru",546,3,6,8,3,5,2
"Brazil",546,5,9,6,1,5,1
"Serbia",546,5,4,2,3,-1,2
"South Korea",546,6,7,8,3,5,1
"Mexico",546,6,6,2,2,0,2
"Japan",546,8,9,8,3,5,1
"Poland",546,8,6,7,8,-1,2
"Uruguay",547,1,9,8,1,7,1
"Russia",547,1,4,6,3,3,2
"Spain",547,2,5,2,1,1,1
"Portugal",547,2,4,2,2,0,2
"Brazil",547,5,9,7,2,5,1
"Switzerland",547,5,6,6,3,3,2
"Mexico",547,6,7,8,3,5,1
"Germany",547,6,4,3,1,2,2
"Colombia",547,8,9,9,1,8,1
"Poland",547,8,4,2,4,-2,2
"Uruguay",548,1,9,9,0,9,1
"Russia",548,1,6,5,6,-1,2
"Spain",548,2,7,5,2,3,1
"Portugal",548,2,5,4,3,1,2
"Argentina",548,4,9,5,2,3,1
"Iceland",548,4,4,5,4,1,2
"Brazil",548,5,9,7,2,5,1
"Serbia",548,5,4,2,2,0,2
"England",548,7,9,4,1,3,1
"Panama",548,7,4,1,1,0,2
"Poland",548,8,9,11,3,8,1
"Japan",548,8,6,7,4,3,2
"Uruguay",549,1,9,9,1,8,1
"Egypt",549,1,4,3,6,-3,2
"Australia",549,3,9,5,2,3,1
"France",549,3,6,7,2,5,2
"Croatia",549,4,7,6,3,3,1
"Argentina",549,4,6,8,4,4,2
"England",549,7,9,10,3,7,1
"Panama",549,7,6,5,5,0,2
"Colombia",549,8,7,6,1,5,1
"Poland",549,8,6,3,2,1,2
"Uruguay",550,1,7,5,2,3,1
"Egypt",550,1,4,7,3,4,2
"Iran",550,2,7,8,4,4,1
"Portugal",550,2,4,4,3,1,2
"Australia",550,3,9,5,1,4,1
"France",550,3,6,5,1,4,2
"Belgium",550,7,9,6,0,6,1
"England",550,7,6,2,1,1,2
"Poland",550,8,9,4,1,3,1
"Colombia",550,8,6,5,3,2,2
"Uruguay",551,1,9,7,2,5,1
"Russia",551,1,4,3,3,0,2
"Peru",551,3,7,6,3,3,1
"Australia",551,3,4,4,5,-1,2
"Brazil",551,5,9,4,0,4,1
"Switzerland",551,5,4,4,2,2,2
"Germany",551,6,7,5,1,4,1
"Mexico",551,6,4,5,3,2,2
"Panama",551,7,9,5,0,5,1
"Belgium",551,7,4,2,2,0,2
"Japan",551,8,7,5,1,4,1
"Colombia",551,8,5,3,2,1,2
"Spain",552,2,9,5,2,3,1
"Iran",552,2,6,5,3,2,2
"Croatia",552,4,9,7,1,6,1
"Nigeria",552,4,4,2,4,-2,2
"Brazil",552,5,7,5,1,4,1
"Costa Rica",552,5,5,2,1,1,2
"Germany",552,6,9,9,3,6,1
"Mexico",552,6,4,5,4,1,2
"England",552,7,9,4,0,4,1
"Belgium",552,7,4,6,5,1,2
"Colombia",552,8,9,7,2,5,1
"Japan",552,8,4,3,3,0,2
"Uruguay",553,1,9,9,5,4,1
"Russia",553,1,4,2,2,0,2
"Switzerland",553,5,7,5,1,4,1
"Brazil",553,5,6,5,3,2,2
"Germany",553,6,9,6,0,6,1
"Sweden",553,6,6,6,3,3,2
"England",553,7,9,9,0,9,1
"Belgium",553,7,6,4,2,2,2
"Russia",554,1,7,5,2,3,1
"Uruguay",554,1,6,3,1,2,2
"Spain",554,2,6,5,5,0,1
"Portugal",554,2,5,6,2,4,2
"Argentina",554,4,7,8,0,8,1
"Croatia",554,4,6,8,3,5,2
"Brazil",554,5,9,8,1,7,1
"Switzerland",554,5,4,6,5,1,2
"Sweden",554,6,9,5,1,4,1
"Germany",554,6,4,6,4,2,2
"Belgium",554,7,7,6,3,3,1
"England",554,7,6,5,2,3,2
"Colombia",554,8,7,6,3,3,1
"Poland",554,8,5,5,4,1,2
"Uruguay",555,1,9,10,1,9,1
"Russia",555,1,4,1,5,-4,2
"Iran",555,2,9,7,2,5,1
"Portugal",555,2,6,9,3,6,2
"Peru",555,3,9,6,3,3,1
"France",555,3,6,5,2,3,2
"Argentina",555,4,9,5,0,5,1
"Croatia",555,4,6,4,1,3,2
"Brazil",555,5,9,6,0,6,1
"Serbia",555,5,6,3,2,1,2
"Uruguay",556,1,9,7,1,6,1
"Egypt",556,1,6,4,2,2,2
"Brazil",556,5,9,8,3,5,1
"Costa Rica",556,5,4,7,7,0,2
"England",556,7,7,4,1,3,1
"Belgium",556,7,6,6,3,3,2
"Poland",556,8,7,2,0,2,1
"Colombia",556,8,5,3,1,2,2
"Russia",557,1,7,8,5,3,1
"Uruguay",557,1,5,5,3,2,2
"Iran",557,2,7,6,3,3,1
"Portugal",557,2,5,5,2,3,2
"France",557,3,9,7,0,7,1
"Denmark",557,3,6,5,5,0,2
"Iceland",557,4,9,6,0,6,1
"Argentina",557,4,6,4,2,2,2
"Sweden",557,6,7,7,1,6,1
"Germany",557,6,6,7,4,3,2
"England",557,7,9,4,1,3,1
"Belgium",557,7,4,4,4,0,2
"Portugal",558,2,5,6,2,4,1
"Iran",558,2,4,4,5,-1,2
"France",558,3,7,2,0,2,1
"Denmark",558,3,4,1,1,0,2
"Brazil",558,5,7,5,1,4,1
"Serbia",558,5,4,5,3,2,2
"Germany",558,6,9,6,2,4,1
"Sweden",558,6,4,5,6,-1,2
"Portugal",559,2,9,4,1,3,1
"Spain",559,2,6,3,2,1,2
"Australia",559,3,9,8,0,8,1
"Peru",559,3,4,5,6,-1,2
"Brazil",559,5,7,10,3,7,1
"Costa Rica",559,5,5,4,2,2,2
"Belgium",559,7,9,10,4,6,1
"England",559,7,4,3,4,-1,2
"Iran",560,2,7,6,1,5,1
"Portugal",560,2,5,4,2,2,2
"France",560,3,7,3,0,3,1
"Denmark",560,3,6,4,3,1,2
"Argentina",560,4,9,8,1,7,1
"Croatia",560,4,6,4,5,-1,2
"Brazil",560,5,9,6,0,6,1
"Costa Rica",560,5,6,3,3,0,2
"Germany",560,6,9,6,3,3,1
"Sweden",560,6,4,3,2,1,2
"England",560,7,9,8,1,7,1
"Belgium",560,7,6,4,2,2,2
"Uruguay",561,1,9,8,3,5,1
"Egypt",561,1,6,6,4,2,2
"Portugal",561,2,7,2,0,2,1
"Spain",561,2,3,1,1,0,2
"Russia",562,1,7,3,1,2,1
"Egypt",562,1,4,4,3,1,2
"Iran",562,2,7,3,1,2,1
"Spain",562,2,6,3,1,2,2
"Argentina",562,4,9,6,2,4,1
"Croatia",562,4,4,6,4,2,2
"Germany",562,6,6,5,4,1,1
"South Korea",562,6,5,3,1,2,2
"Belgium",562,7,7,4,2,2,1
"Tunisia",562,7,6,4,2,2,2
"Colombia",562,8,7,7,2,5,1
"Senegal",562,8,5,5,4,1,2
"Uruguay",563,1,9,4,0,4,1
"Russia",563,1,6,8,4,4,2
"Argentina",563,4,7,7,2,5,1
"Nigeria",563,4,6,3,5,-2,2
"Brazil",563,5,9,7,1,6,1
"Costa Rica",563,5,4,4,5,-1,2
"Germany",563,6,9,6,2,4,1
"Mexico",563,6,6,3,2,1,2
"Japan",563,8,7,5,1,4,1
"Colombia",563,8,4,2,3,-1,2
"Peru",564,3,7,4,1,3,1
"France",564,3,4,2,2,0,2
"Belgium",564,7,7,5,2,3,1
"England",564,7,5,4,1,3,2
"Saudi Arabia",565,1,5,6,4,2,1
"Egypt",565,1,4,6,6,0,2
"Spain",565,2,7,7,0,7,1
"Portugal",565,2,5,2,0,2,2
"Australia",565,3,7,5,3,2,1
"Peru",565,3,6,3,2,1,2
"Germany",565,6,7,6,2,4,1
"Sweden",565,6,4,3,3,0,2
"Belgium",565,7,7,3,0,3,1
"England",565,7,4,3,3,0,2
"Portugal",566,2,9,9,3,6,1
"Spain",566,2,6,7,5,2,2
"Germany",566,6,7,3,1,2,1
"Mexico",566,6,6,3,2,1,2
"Belgium",566,7,9,11,1,10,1
"Tunisia",566,7,4,4,8,-4,2
"Japan",566,8,9,5,1,4,1
"Poland",566,8,6,3,2,1,2
"Saudi Arabia",567,1,6,2,3,-1,1
"Russia",567,1,5,4,1,3,2
"Portugal",567,2,7,4,0,4,1
"Spain",567,2,4,2,2,0,2
"France",567,3,7,5,3,2,1
"Denmark",567,3,5,2,0,2,2
"Iceland",567,4,7,9,5,4,1
"Nigeria",567,4,4,7,6,1,2
"England",567,7,7,3,0,3,1
"Belgium",567,7,6,3,2,1,2
"Colombia",567,8,9,4,1,3,1
"Senegal",567,8,4,3,3,0,2
"Russia",568,1,6,3,3,0,1
"Uruguay",568,1,5,2,0,2,2
"Peru",568,3,7,4,0,4,1
"France",568,3,4,1,3,-2,2
"Croatia",568,4,7,10,6,4,1
"Nigeria",568,4,4,5,6,-1,2
"Brazil",568,5,7,5,2,3,1
"Switzerland",568,5,4,1,2,-1,2
"South Korea",568,6,7,6,2,4,1
"Germany",568,6,4,3,5,-2,2
"Belgium",568,7,7,5,2,3,1
"England",568,7,5,4,1,3,2
"Colombia",568,8,7,7,1,6,1
"Poland",568,8,6,4,4,0,2
"Uruguay",569,1,9,7,2,5,1
"Russia",569,1,6,4,2,2,2
"Peru",569,3,9,6,1,5,1
"Denmark",569,3,6,3,3,0,2
"Mexico",569,6,9,6,0,6,1
"Sweden",569,6,6,6,6,0,2
"Belgium",569,7,7,5,1,4,1
"England",569,7,5,3,0,3,2
"Japan",569,8,7,7,2,5,1
"Colombia",569,8,5,5,3,2,2
"Uruguay",570,1,7,3,0,3,1
"Egypt",570,1,5,4,3,1,2
"Spain",570,2,9,6,1,5,1
"Morocco",570,2,4,3,3,0,2
"France",570,3,7,4,0,4,1
"Peru",570,3,4,2,2,0,2
"Argentina",570,4,7,5,0,5,1
"Nigeria",570,4,4,2,4,-2,2
"Brazil",570,5,7,6,2,4,1
"Switzerland",570,5,4,3,3,0,2
"Germany",570,6,6,9,6,3,1
"Mexico",570,6,5,5,4,1,2
"Colombia",570,8,7,7,3,4,1
"Senegal",570,8,6,9,5,4,2
"Portugal",571,2,7,5,1,4,1
"Spain",571,2,5,5,1,4,2
"Argentina",571,4,9,11,2,9,1
"Croatia",571,4,6,6,4,2,2
"Brazil",571,5,9,6,1,5,1
"Costa Rica",571,5,4,3,3,0,2
"Germany",571,6,7,6,2,4,1
"South Korea",571,6,6,3,4,-1,2
"Colombia",571,8,7,7,2,5,1
"Japan",571,8,5,3,2,1,2
"Uruguay",572,1,9,5,1,4,1
"Russia",572,1,4,2,3,-1,2
"Spain",572,2,7,3,1,2,1
"Portugal",572,2,4,4,2,2,2
"Argentina",572,4,7,8,4,4,1
"Croatia",572,4,4,6,3,3,2
"Brazil",572,5,7,8,1,7,1
"Costa Rica",572,5,5,5,4,1,2
"South Korea",572,6,9,5,0,5,1
"Germany",572,6,6,5,3,2,2
"England",572,7,7,6,1,5,1
"Panama",572,7,4,3,3,0,2
"Colombia",572,8,5,1,0,1,1
"Japan",572,8,4,4,3,1,2
"Egypt",573,1,9,6,3,3,1
"Saudi Arabia",573,1,6,4,3,1,2
"Morocco",573,2,7,4,2,2,1
"Spain",573,2,4,4,4,0,2
"Peru",573,3,9,6,1,5,1
"Denmark",573,3,6,5,3,2,2
"Argentina",573,4,9,7,1,6,1
"Iceland",573,4,4,1,3,-2,2
"Serbia",573,5,7,6,2,4,1
"Brazil",573,5,5,3,2,1,2
"Mexico",573,6,7,5,2,3,1
"Germany",573,6,5,4,2,2,2
"Russia",574,1,7,4,1,3,1
"Uruguay",574,1,4,4,1,3,2
"Spain",574,2,9,7,3,4,1
"Iran",574,2,6,9,5,4,2
"Australia",574,3,7,6,3,3,1
"Peru",574,3,4,4,4,0,2
"Argentina",574,4,7,6,2,4,1
"Croatia",574,4,6,7,2,5,2
"Brazil",574,5,7,3,0,3,1
"Costa Rica",574,5,6,5,3,2,2
"Colombia",574,8,7,3,0,3,1
"Senegal",574,8,6,2,2,0,2
"Russia",575,1,7,6,2,4,1
"Uruguay",575,1,6,4,2,2,2
"Spain",575,2,7,5,0,5,1
"Portugal",575,2,6,6,4,2,2
"France",575,3,7,7,4,3,1
"Australia",575,3,6,4,4,0,2
"Argentina",575,4,7,5,3,2,1
"Croatia",575,4,4,4,4,0,2
"Brazil",575,5,9,9,0,9,1
"Switzerland",575,5,4,1,1,0,2
"Belgium",575,7,9,7,2,5,1
"England",575,7,6,10,5,5,2
"Japan",575,8,7,8,5,3,1
"Colombia",575,8,5,4,3,1,2
"Spain",576,2,9,5,2,3,1
"Portugal",576,2,4,1,1,0,2
"Brazil",576,5,9,7,3,4,1
"Serbia",576,5,6,4,3,1,2
"Germany",576,6,7,4,2,2,1
"South Korea",576,6,5,2,1,1,2
"Poland",576,8,7,8,3,5,1
"Japan",576,8,4,1,3,-2,2
"Denmark",577,3,7,3,1,2,1
"Peru",577,3,3,2,2,0,2
"South Korea",577,6,9,6,1,5,1
"Mexico",577,6,4,3,4,-1,2
"England",577,7,7,8,3,5,1
"Panama",577,7,5,2,1,1,2
"Colombia",577,8,7,3,1,2,1
"Poland",577,8,6,3,1,2,2
"Egypt",578,1,7,4,1,3,1
"Saudi Arabia",578,1,6,4,4,0,2
"Spain",578,2,7,8,2,6,1
"Iran",578,2,5,3,2,1,2
"France",578,3,6,5,3,2,1
"Australia",578,3,5,7,5,2,2
"Colombia",578,8,9,7,1,6,1
"Japan",578,8,6,2,2,0,2
"Uruguay",579,1,7,6,4,2,1
"Egypt",579,1,6,5,4,1,2
"France",579,3,7,5,2,3,1
"Peru",579,3,5,4,1,3,2
"Costa Rica",579,5,5,3,2,1,1
"Switzerland",579,5,4,4,4,0,2
"Germany",579,6,9,8,1,7,1
"Mexico",579,6,4,5,3,2,2
"Saudi Arabia",580,1,9,5,2,3,1
"Egypt",580,1,6,4,3,1,2
"Switzerland",580,5,9,5,1,4,1
"Brazil",580,5,6,3,2,1,2
"Sweden",580,6,7,5,2,3,1
"Germany",580,6,5,3,2,1,2
"Panama",580,7,9,6,1,5,1
"Belgium",580,7,4,2,3,-1,2
"Colombia",580,8,9,6,1,5,1
"Poland",580,8,6,4,3,1,2
"Uruguay",581,1,9,7,2,5,1
"Saudi Arabia",581,1,4,4,3,1,2
"Argentina",581,4,7,4,1,3,1
"Croatia",581,4,6,6,3,3,2
"Brazil",581,5,7,6,2,4,1
"Costa Rica",581,5,5,7,5,2,2
"South Korea",581,6,7,7,1,6,1
"Germany",581,6,5,3,2,1,2
"England",581,7,7,6,3,3,1
"Panama",581,7,4,1,2,-1,2
"Uruguay",582,1,7,5,0,5,1
"Egypt",582,1,4,2,3,-1,2
"Argentina",582,4,9,4,0,4,1
"Nigeria",582,4,4,1,1,0,2
"Brazil",582,5,9,5,1,4,1
"Costa Rica",582,5,4,3,3,0,2
"Mexico",582,6,7,6,4,2,1
"South Korea",582,6,5,3,2,1,2
"Egypt",583,1,5,1,0,1,1
"Saudi Arabia",583,1,4,5,4,1,2
"Spain",583,2,9,10,2,8,1
"Portugal",583,2,6,5,2,3,2
"Denmark",583,3,7,5,1,4,1
"France",583,3,5,5,3,2,2
"Croatia",583,4,9,6,1,5,1
"Argentina",583,4,6,4,2,2,2
"England",583,7,7,3,0,3,1
"Panama",583,7,4,2,3,-1,2
"Poland",583,8,6,3,1,2,1
"Japan",583,8,5,3,2,1,2
"Uruguay",584,1,7,3,0,3,1
"Russia",584,1,6,4,3,1,2
"Spain",584,2,9,7,2,5,1
"Portugal",584,2,6,5,3,2,2
"Argentina",584,4,7,6,0,6,1
"Croatia",584,4,4,3,3,0,2
"Brazil",584,5,7,7,4,3,1
"Costa Rica",584,5,4,4,2,2,2
"Mexico",584,6,7,4,1,3,1
"Germany",584,6,6,3,1,2,2
"England",584,7,7,5,1,4,1
"Belgium",584,7,6,4,3,1,2
"Uruguay",585,1,7,6,4,2,1
"Russia",585,1,4,3,3,0,2
"Spain",585,2,7,5,1,4,1
"Iran",585,2,4,3,4,-1,2
"Germany",585,6,9,7,1,6,1
"Sweden",585,6,4,2,3,-1,2
"Poland",585,8,7,4,1,3,1
"Colombia",585,8,3,2,2,0,2
"Egypt",586,1,7,6,2,4,1
"Uruguay",586,1,5,3,1,2,2
"Spain",586,2,9,8,3,5,1
"Morocco",586,2,6,5,5,0,2
"Argentina",586,4,9,9,3,6,1
"Iceland",586,4,6,7,4,3,2
"Germany",586,6,9,4,1,3,1
"Mexico",586,6,4,3,2,1,2
"Panama",586,7,5,3,0,3,1
"Belgium",586,7,4,4,3,1,2
"Japan",586,8,9,8,2,6,1
"Senegal",586,8,4,4,4,0,2
"Uruguay",587,1,7,5,1,4,1
"Russia",587,1,5,3,2,1,2
"France",587,3,7,5,0,5,1
"Australia",587,3,6,5,4,1,2
"Argentina",587,4,7,4,1,3,1
"Iceland",587,4,6,3,1,2,2
"Brazil",587,5,7,7,2,5,1
"Costa Rica",587,5,4,4,3,1,2
"Spain",588,2,7,7,2,5,1
"Iran",588,2,6,4,3,1,2
"France",588,3,7,9,2,7,1
"Denmark",588,3,5,3,2,1,2
"Argentina",588,4,9,9,2,7,1
"Croatia",588,4,6,4,1,3,2
"Brazil",588,5,7,5,2,3,1
"Switzerland",588,5,4,3,4,-1,2
"Germany",588,6,9,7,2,5,1
"Mexico",588,6,4,3,3,0,2
"Uruguay",589,1,9,10,4,6,1
"Russia",589,1,4,7,7,0,2
"Morocco",589,2,7,4,1,3,1
"Portugal",589,2,5,1,0,1,2
"Iceland",589,4,9,5,1,4,1
"Argentina",589,4,4,3,1,2,2
"Brazil",589,5,7,7,3,4,1
"Costa Rica",589,5,5,4,2,2,2
"Sweden",589,6,7,5,1,4,1
"Germany",589,6,6,6,3,3,2
"Colombia",589,8,7,7,3,4,1
"Poland",589,8,6,3,2,1,2
"France",590,3,9,4,1,3,1
"Peru",590,3,4,3,3,0,2
"Argentina",590,4,9,7,1,6,1
"Iceland",590,4,6,4,2,2,2
"Germany",590,6,7,6,2,4,1
"Sweden",590,6,6,5,4,1,2
"England",590,7,9,6,0,6,1
"Belgium",590,7,6,5,1,4,2
"Poland",590,8,9,7,2,5,1
"Japan",590,8,6,3,3,0,2
"Portugal",591,2,9,7,0,7,1
"Spain",591,2,4,5,5,0,2
"Croatia",591,4,7,5,2,3,1
"Iceland",591,4,6,7,4,3,2
"Brazil",591,5,7,4,2,2,1
"Costa Rica",591,5,5,4,3,1,2
"Panama",591,7,7,4,2,2,1
"Belgium",591,7,4,3,3,0,2
"Poland",591,8,7,5,2,3,1
"Colombia",591,8,4,4,4,0,2
"France",592,3,9,5,0,5,1
"Denmark",592,3,6,5,4,1,2
"Mexico",592,6,7,2,0,2,1
"Germany",592,6,6,3,1,2,2
"Poland",592,8,9,9,1,8,1
"Japan",592,8,6,5,3,2,2
"Spain",593,2,9,12,2,10,1
"Iran",593,2,4,5,8,-3,2
"Argentina",593,4,7,3,1,2,1
"Croatia",593,4,4,3,1,2,2
"Brazil",593,5,9,5,0,5,1
"Serbia",593,5,4,3,3,0,2
"Mexico",593,6,9,6,0,6,1
"Germany",593,6,6,6,5,1,2
"England",593,7,7,9,1,8,1
"Belgium",593,7,5,4,3,1,2
"Colombia",593,8,7,5,2,3,1
"Japan",593,8,5,3,2,1,2
"Uruguay",594,1,9,9,2,7,1
"Saudi Arabia",594,1,4,3,5,-2,2
"Portugal",594,2,7,5,1,4,1
"Iran",594,2,6,4,5,-1,2
"France",594,3,7,5,2,3,1
"Australia",594,3,5,1,0,1,2
"Argentina",594,4,7,11,5,6,1
"Nigeria",594,4,6,5,8,-3,2
"Serbia",594,5,7,6,4,2,1
"Brazil",594,5,6,8,2,6,2
"Germany",594,6,6,4,1,3,1
"Sweden",594,6,5,2,1,1,2
"Belgium",594,7,7,8,1,7,1
"England",594,7,5,5,4,1,2
"Russia",595,1,9,5,2,3,1
"Uruguay",595,1,6,5,2,3,2
"Iran",595,2,7,4,2,2,1
"Portugal",595,2,6,8,3,5,2
"Croatia",595,4,9,8,1,7,1
"Iceland",595,4,4,1,3,-2,2
"Costa Rica",595,5,7,7,2,5,1
"Brazil",595,5,6,8,2,6,2
"Germany",595,6,9,7,1,6,1
"Mexico",595,6,6,5,3,2,2
"Belgium",595,7,7,5,2,3,1
"Panama",595,7,6,6,4,2,2
"Uruguay",596,1,9,6,2,4,1
"Russia",596,1,6,6,2,4,2
"Iran",596,2,7,4,2,2,1
"Spain",596,2,6,5,3,2,2
"Argentina",596,4,7,4,1,3,1
"Croatia",596,4,5,6,5,1,2
"Germany",596,6,9,6,1,5,1
"South Korea",596,6,4,4,4,0,2
"England",596,7,7,12,2,10,1
"Belgium",596,7,5,4,3,1,2
"Poland",596,8,7,3,0,3,1
"Colombia",596,8,5,4,0,4,2
"Saudi Arabia",597,1,7,5,3,2,1
"Uruguay",597,1,6,5,3,2,2
"France",597,3,7,5,0,5,1
"Peru",597,3,4,3,4,-1,2
"Brazil",597,5,7,5,2,3,1
"Switzerland",597,5,5,3,2,1,2
"Mexico",597,6,7,7,0,7,1
"South Korea",597,6,6,3,3,0,2
"Egypt",598,1,7,5,1,4,1
"Russia",598,1,5,4,1,3,2
"Croatia",598,4,7,4,2,2,1
"Iceland",598,4,5,6,4,2,2
"Germany",598,6,7,6,4,2,1
"Mexico",598,6,4,3,3,0,2
"England",598,7,7,6,2,4,1
"Belgium",598,7,6,6,5,1,2
"Argentina",599,4,9,6,1,5,1
"Iceland",599,4,6,5,2,3,2
"Germany",599,6,9,9,1,8,1
"Mexico",599,6,6,2,3,-1,2
"Belgium",599,7,7,7,1,6,1
"Panama",599,7,4,2,4,-2,2
"Brazil",600,5,9,10,1,9,1
"Costa Rica",600,5,4,4,6,-2,2
"Mexico",600,6,6,4,2,2,1
"Germany",600,6,5,4,3,1,2
"England",600,7,6,4,2,2,1
"Panama",600,7,5,3,1,2,2
"Uruguay",601,1,7,5,2,3,1
"Russia",601,1,4,1,1,0,2
"Portugal",601,2,9,5,1,4,1
"Spain",601,2,4,4,3,1,2
"France",601,3,9,5,1,4,1
"Denmark",601,3,4,4,3,1,2
"Brazil",601,5,7,4,1,3,1
"Serbia",601,5,4,3,4,-1,2
"England",601,7,7,3,1,2,1
"Belgium",601,7,6,6,3,3,2
"Poland",601,8,7,9,4,5,1
"Colombia",601,8,5,4,2,2,2
"Russia",602,1,5,2,1,1,1
"Saudi Arabia",602,1,4,5,2,3,2
"Iran",602,2,9,5,2,3,1
"Spain",602,2,6,5,2,3,2
"Argentina",602,4,9,7,1,6,1
"Iceland",602,4,6,3,2,1,2
"Brazil",602,5,7,6,3,3,1
"Costa Rica",602,5,4,3,3,0,2
"Colombia",602,8,7,7,3,4,1
"Senegal",602,8,4,3,4,-1,2
"Uruguay",603,1,7,4,1,3,1
"Russia",603,1,6,2,1,1,2
"Portugal",603,2,7,6,2,4,1
"Spain",603,2,6,4,4,0,2
"Peru",603,3,9,5,1,4,1
"Australia",603,3,4,4,5,-1,2
"Brazil",603,5,7,3,1,2,1
"Switzerland",603,5,6,4,2,2,2
"Germany",603,6,7,2,0,2,1
"Mexico",603,6,4,3,5,-2,2
"Belgium",603,7,7,5,2,3,1
"England",603,7,6,3,2,1,2
"Uruguay",604,1,9,8,1,7,1
"Russia",604,1,6,4,4,0,2
"Croatia",604,4,9,5,0,5,1
"Argentina",604,4,4,5,3,2,2
"Poland",604,8,7,3,0,3,1
"Colombia",604,8,6,3,2,1,2
"Russia",605,1,9,3,0,3,1
"Uruguay",605,1,4,3,2,1,2
"Spain",605,2,7,7,3,4,1
"Iran",605,2,4,4,2,2,2
"Australia",605,3,6,4,1,3,1
"France",605,3,5,4,3,1,2
"Iceland",605,4,7,6,3,3,1
"Argentina",605,4,6,6,4,2,2
"Brazil",605,5,9,9,1,8,1
"Costa Rica",605,5,4,5,6,-1,2
"South Korea",605,6,7,6,3,3,1
"Sweden",605,6,5,5,3,2,2
"Poland",605,8,9,7,2,5,1
"Colombia",605,8,6,5,3,2,2
"Brazil",606,5,7,9,3,6,1
"Switzerland",606,5,6,4,6,-2,2
"Panama",606,7,9,5,1,4,1
"England",606,7,6,5,4,1,2
"Colombia",606,8,7,4,1,3,1
"Poland",606,8,6,6,2,4,2
"Saudi Arabia",607,1,7,3,1,2,1
"Uruguay",607,1,6,4,2,2,2
"France",607,3,9,8,2,6,1
"Peru",607,3,4,5,5,0,2
"Poland",607,8,6,5,3,2,1
"Colombia",607,8,5,2,1,1,2
"Uruguay",608,1,9,12,2,10,1
"Saudi Arabia",608,1,4,3,4,-1,2
"Peru",608,3,6,3,2,1,1
"Australia",608,3,5,2,0,2,2
"England",608,7,7,4,0,4,1
"Belgium",608,7,5,5,1,4,2
"Russia",609,1,9,6,3,3,1
"Uruguay",609,1,4,2,2,0,2
"Denmark",609,3,9,3,0,3,1
"Peru",609,3,6,3,1,2,2
"Switzerland",609,5,9,6,3,3,1
"Brazil",609,5,6,6,2,4,2
"Germany",609,6,7,7,1,6,1
"Mexico",609,6,4,2,3,-1,2
"Belgium",609,7,7,4,1,3,1
"England",609,7,6,3,2,1,2
"Colombia",609,8,7,7,0,7,1
"Japan",609,8,5,3,1,2,2
"Russia",610,1,9,4,0,4,1
"Uruguay",610,1,4,4,4,0,2
"Iran",610,2,6,3,3,0,1
"Portugal",610,2,5,4,2,2,2
"Peru",610,3,9,9,3,6,1
"France",610,3,4,3,3,0,2
"Nigeria",610,4,5,2,1,1,1
"Iceland",610,4,4,3,3,0,2
"Colombia",610,8,7,5,2,3,1
"Japan",610,8,5,3,2,1,2
"Argentina",611,4,7,7,2,5,1
"Iceland",611,4,6,3,5,-2,2
"Mexico",611,6,5,2,1,1,1
"Sweden",611,6,4,4,3,1,2
"Belgium",611,7,7,6,4,2,1
"England",611,7,6,6,2,4,2
"Uruguay",612,1,9,8,0,8,1
"Russia",612,1,4,2,3,-1,2
"Brazil",612,5,9,6,1,5,1
"Costa Rica",612,5,6,5,4,1,2
"Germany",612,6,9,6,1,5,1
"Mexico",612,6,4,5,6,-1,2
"England",612,7,7,7,3,4,1
"Belgium",612,7,4,7,5,2,2
"Senegal",612,8,7,2,0,2,1
"Colombia",612,8,5,5,3,2,2
"Uruguay",613,1,7,7,1,6,1
"Russia",613,1,6,4,3,1,2
"Spain",613,2,9,9,2,7,1
"Iran",613,2,4,4,3,1,2
"France",613,3,9,8,1,7,1
"Peru",613,3,6,8,4,4,2
"Argentina",613,4,9,8,2,6,1
"Croatia",613,4,4,5,5,0,2
"Belgium",613,7,7,6,2,4,1
"England",613,7,6,3,3,0,2
"Portugal",614,2,7,8,3,5,1
"Spain",614,2,5,5,4,1,2
"France",614,3,9,7,2,5,1
"Peru",614,3,4,4,4,0,2
"Brazil",614,5,7,6,2,4,1
"Costa Rica",614,5,6,3,3,0,2
"Germany",614,6,7,6,3,3,1
"Mexico",614,6,6,8,4,4,2
"Uruguay",615,1,9,10,5,5,1
"Russia",615,1,4,5,6,-1,2
"Peru",615,3,7,3,1,2,1
"France",615,3,5,3,2,1,2
"Argentina",615,4,7,5,1,4,1
"Nigeria",615,4,6,5,2,3,2
"Germany",615,6,9,5,2,3,1
"Mexico",615,6,6,8,3,5,2
"Poland",615,8,7,7,1,6,1
"Japan",615,8,6,5,8,-3,2
"Spain",616,2,9,5,0,5,1
"Iran",616,2,6,4,4,0,2
"Croatia",616,4,7,3,0,3,1
"Nigeria",616,4,6,3,3,0,2
"Brazil",616,5,9,9,0,9,1
"Switzerland",616,5,4,5,4,1,2
"England",616,7,7,5,1,4,1
"Panama",616,7,5,3,1,2,2
"Colombia",616,8,9,6,2,4,1
"Japan",616,8,6,4,4,0,2
"Iran",617,2,7,6,2,4,1
"Spain",617,2,5,5,1,4,2
"France",617,3,7,7,2,5,1
"Australia",617,3,5,6,3,3,2
"Switzerland",617,5,7,3,1,2,1
"Brazil",617,5,4,3,3,0,2
"South Korea",617,6,7,4,1,3,1
"Germany",617,6,6,6,3,3,2
"England",618,7,7,3,0,3,1
"Belgium",618,7,5,4,2,2,2
"Uruguay",619,1,7,4,1,3,1
"Russia",619,1,5,4,3,1,2
"Brazil",619,5,7,4,1,3,1
"Switzerland",619,5,4,6,3,3,2
"Poland",619,8,7,7,5,2,1
"Japan",619,8,4,3,2,1,2
"Uruguay",620,1,9,8,0,8,1
"Egypt",620,1,6,4,5,-1,2
"Argentina",620,4,9,8,2,6,1
"Croatia",620,4,6,5,4,1,2
"Brazil",620,5,7,5,0,5,1
"Switzerland",620,5,5,2,1,1,2
"South Korea",620,6,7,2,0,2,1
"Germany",620,6,6,5,1,4,2
"England",620,7,9,6,1,5,1
"Panama",620,7,4,4,5,-1,2
"Colombia",620,8,9,7,1,6,1
"Senegal",620,8,4,2,4,-2,2
"Iran",621,2,7,5,2,3,1
"Spain",621,2,5,5,2,3,2
"France",621,3,9,7,2,5,1
"Peru",621,3,4,4,4,0,2
"Argentina",621,4,7,6,2,4,1
"Nigeria",621,4,6,3,4,-1,2
"Serbia",621,5,7,5,2,3,1
"Brazil",621,5,6,7,3,4,2
"Mexico",621,6,9,7,2,5,1
"Germany",621,6,6,6,4,2,2
"Belgium",621,7,9,5,0,5,1
"England",621,7,6,4,1,3,2
"Uruguay",622,1,7,8,1,7,1
"Egypt",622,1,6,3,2,1,2
"Argentina",622,4,7,6,0,6,1
"Croatia",622,4,6,6,7,-1,2
"Brazil",622,5,7,5,1,4,1
"Serbia",622,5,4,2,4,-2,2
"Germany",622,6,7,8,5,3,1
"Mexico",622,6,5,5,3,2,2
"Belgium",622,7,9,7,0,7,1
"England",622,7,6,6,1,5,2
"Russia",623,1,7,6,1,5,1
"Egypt",623,1,6,5,3,2,2
"Australia",623,3,7,3,1,2,1
"France",623,3,4,3,3,0,2
"Germany",623,6,9,6,0,6,1
"Mexico",623,6,6,7,2,5,2
"Egypt",624,1,6,7,4,3,1
"Uruguay",624,1,5,3,0,3,2
"Morocco",624,2,7,2,0,2,1
"Iran",624,2,4,4,4,0,2
"Peru",624,3,9,5,0,5,1
"France",624,3,6,8,2,6,2
"England",624,7,9,4,1,3,1
"Panama",624,7,6,3,1,2,2
"Colombia",624,8,9,5,0,5,1
"Japan",624,8,4,3,2,1,2
"Uruguay",625,1,9,7,1,6,1
"Russia",625,1,6,4,1,3,2
"Argentina",625,4,7,5,1,4,1
"Nigeria",625,4,4,5,4,1,2
"Costa Rica",625,5,7,7,5,2,1
"Switzerland",625,5,6,8,3,5,2
"Belgium",625,7,7,5,3,2,1
"England",625,7,6,6,3,3,2
"Portugal",626,2,7,3,0,3,1
"Iran",626,2,6,3,2,1,2
"Peru",626,3,9,5,2,3,1
"Australia",626,3,6,3,2,1,2
"Switzerland",626,5,7,4,0,4,1
"Serbia",626,5,5,2,1,1,2
"Belgium",626,7,7,7,1,6,1
"Panama",626,7,4,2,4,-2,2
"Uruguay",627,1,7,9,4,5,1
"Egypt",627,1,6,3,4,-1,2
"Iran",627,2,7,6,4,2,1
"Morocco",627,2,3,4,4,0,2
"France",627,3,7,4,2,2,1
"Australia",627,3,6,2,1,1,2
"Croatia",627,4,9,4,0,4,1
"Nigeria",627,4,4,1,1,0,2
"Costa Rica",627,5,7,3,1,2,1
"Switzerland",627,5,4,5,5,0,2
"South Korea",627,6,9,3,0,3,1
"Germany",627,6,6,5,4,1,2
"Panama",627,7,6,4,5,-1,1
"England",627,7,5,8,5,3,2
"Japan",627,8,7,6,2,4,1
"Colombia",627,8,4,3,3,0,2
"Saudi Arabia",628,1,7,5,3,2,1
"Russia",628,1,5,5,2,3,2
"France",628,3,6,3,3,0,1
"Peru",628,3,5,3,1,2,2
"Nigeria",628,4,6,2,1,1,1
"Argentina",628,4,5,5,4,1,2
"Mexico",628,6,7,4,1,3,1
"Germany",628,6,5,5,3,2,2
"Uruguay",629,1,9,7,1,6,1
"Russia",629,1,4,1,3,-2,2
"Spain",629,2,7,5,1,4,1
"Portugal",629,2,6,2,1,1,2
"Australia",629,3,7,5,2,3,1
"Peru",629,3,4,4,4,0,2
"Costa Rica",629,5,7,3,1,2,1
"Brazil",629,5,5,2,0,2,2
"Germany",629,6,9,7,0,7,1
"Mexico",629,6,6,7,2,5,2
"Iran",630,2,7,4,2,2,1
"Portugal",630,2,6,4,1,3,2
"Nigeria",630,4,5,2,1,1,1
"Argentina",630,4,4,2,2,0,2
"Brazil",630,5,7,5,3,2,1
"Switzerland",630,5,6,2,1,1,2
"Japan",630,8,9,9,2,7,1
"Poland",630,8,4,1,2,-1,2
"Iceland",631,4,6,4,5,-1,1
"Argentina",631,4,5,3,0,3,2
"Serbia",631,5,7,5,1,4,1
"Brazil",631,5,5,4,1,3,2
"Japan",631,8,9,5,0,5,1
"Colombia",631,8,6,4,1,3,2
"Brazil",632,5,9,3,0,3,1
"Costa Rica",632,5,4,2,2,0,2
"South Korea",632,6,9,7,1,6,1
"Germany",632,6,4,2,3,-1,2
"Uruguay",633,1,7,4,2,2,1
"Russia",633,1,4,3,3,0,2
"Spain",633,2,9,6,1,5,1
"Iran",633,2,6,3,2,1,2
"Argentina",633,4,7,2,0,2,1
"Iceland",633,4,5,3,1,2,2
"Brazil",633,5,9,5,1,4,1
"Switzerland",633,5,4,2,1,1,2
"Sweden",633,6,7,5,1,4,1
"Germany",633,6,5,4,2,2,2
"Belgium",633,7,7,5,3,2,1
"England",633,7,6,8,4,4,2
"Russia",634,1,9,11,5,6,1
"Uruguay",634,1,6,10,3,7,2
"Iceland",634,4,6,3,2,1,1
"Croatia",634,4,5,5,4,1,2
"Brazil",634,5,7,6,2,4,1
"Costa Rica",634,5,4,6,6,0,2
"Germany",634,6,7,6,2,4,1
"Mexico",634,6,3,2,2,0,2
"England",634,7,9,8,1,7,1
"Panama",634,7,4,4,3,1,2
"Iceland",635,4,7,7,3,4,1
"Argentina",635,4,4,5,5,0,2
"Brazil",635,5,7,5,2,3,1
"Costa Rica",635,5,4,5,5,0,2
"Poland",635,8,7,7,3,4,1
"Colombia",635,8,4,4,5,-1,2
"Russia",636,1,7,3,0,3,1
"Uruguay",636,1,5,4,2,2,2
"Iceland",636,4,7,6,2,4,1
"Argentina",636,4,6,4,3,1,2
"Brazil",636,5,9,6,2,4,1
"Serbia",636,5,6,4,3,1,2
"Germany",636,6,9,6,2,4,1
"Sweden",636,6,4,2,3,-1,2
"Belgium",636,7,9,7,2,5,1
"England",636,7,6,8,5,3,2
"Poland",636,8,6,3,2,1,1
"Japan",636,8,5,2,0,2,2
"Spain",637,2,7,6,3,3,1
"Iran",637,2,3,1,1,0,2
"France",637,3,9,6,1,5,1
"Australia",637,3,6,2,2,0,2
"Argentina",637,4,9,7,0,7,1
"Iceland",637,4,6,4,3,1,2
"Brazil",637,5,9,6,0,6,1
"Serbia",637,5,6,5,2,3,2
"Germany",637,6,6,7,3,4,1
"Sweden",637,6,5,3,2,1,2
"England",637,7,9,5,0,5,1
"Belgium",637,7,6,4,2,2,2
"France",638,3,7,5,3,2,1
"Peru",638,3,3,3,3,0,2
"Brazil",638,5,9,6,2,4,1
"Switzerland",638,5,6,3,3,0,2
"Germany",638,6,9,9,1,8,1
"Mexico",638,6,6,3,4,-1,2
"England",638,7,6,4,2,2,1
"Belgium",638,7,5,2,1,1,2
"Poland",638,8,7,3,1,2,1
"Colombia",638,8,6,5,2,3,2
"Egypt",639,1,7,7,3,4,1
"Uruguay",639,1,6,4,4,0,2
"France",639,3,7,6,4,2,1
"Denmark",639,3,5,7,4,3,2
"Brazil",639,5,9,6,2,4,1
"Serbia",639,5,4,2,2,0,2
"Germany",639,6,9,9,1,8,1
"Mexico",639,6,6,6,2,4,2
"Panama",639,7,7,8,6,2,1
"England",639,7,3,6,6,0,2
"Egypt",640,1,7,4,1,3,1
"Uruguay",640,1,5,1,0,1,2
"Costa Rica",640,5,7,6,3,3,1
"Brazil",640,5,5,1,0,1,2
"Mexico",640,6,7,4,0,4,1
"Germany",640,6,4,3,3,0,2
"Panama",640,7,6,3,3,0,1
"England",640,7,5,5,3,2,2
"Japan",640,8,7,3,1,2,1
"Colombia",640,8,6,3,1,2,2
"France",641,3,9,9,1,8,1
"Denmark",641,3,4,4,5,-1,2
"Croatia",641,4,7,5,3,2,1
"Iceland",641,4,4,3,3,0,2
"Costa Rica",641,5,9,5,1,4,1
"Brazil",641,5,6,7,2,5,2
"Germany",641,6,7,6,2,4,1
"Sweden",641,6,6,3,2,1,2
"England",641,7,7,4,2,2,1
"Panama",641,7,5,3,2,1,2
"Colombia",641,8,9,4,0,4,1
"Japan",641,8,4,2,2,0,2
"Saudi Arabia",642,1,7,4,2,2,1
"Uruguay",642,1,6,6,2,4,2
"France",642,3,7,7,2,5,1
"Peru",642,3,6,3,5,-2,2
"Argentina",642,4,7,5,2,3,1
"Iceland",642,4,6,3,3,0,2
"Brazil",642,5,9,3,0,3,1
"Costa Rica",642,5,6,2,1,1,2
"England",642,7,9,11,2,9,1
"Belgium",642,7,6,6,4,2,2
"Poland",642,8,9,6,0,6,1
"Colombia",642,8,4,2,2,0,2
"Russia",643,1,7,8,2,6,1
"Uruguay",643,1,5,3,2,1,2
"Brazil",643,5,6,5,4,1,1
"Switzerland",643,5,5,6,4,2,2
"England",643,7,9,9,1,8,1
"Belgium",643,7,6,7,2,5,2
"Colombia",643,8,9,7,0,7,1
"Poland",643,8,6,3,2,1,2
"Uruguay",644,1,7,3,0,3,1
"Saudi Arabia",644,1,5,4,3,1,2
"Portugal",644,2,7,4,1,3,1
"Iran",644,2,5,5,3,2,2
"Croatia",644,4,7,7,4,3,1
"Iceland",644,4,6,3,3,0,2
"Serbia",644,5,7,6,2,4,1
"Brazil",644,5,4,3,5,-2,2
"Belgium",644,7,9,9,0,9,1
"England",644,7,4,3,3,0,2
"Iran",645,2,9,6,0,6,1
"Spain",645,2,6,5,3,2,2
"Australia",645,3,6,4,3,1,1
"Denmark",645,3,5,3,2,1,2
"Brazil",645,5,7,6,3,3,1
"Costa Rica",645,5,4,4,2,2,2
"Portugal",646,2,7,5,1,4,1
"Spain",646,2,6,4,2,2,2
"Denmark",646,3,7,2,0,2,1
"Peru",646,3,6,4,3,1,2
"Argentina",646,4,7,5,2,3,1
"Iceland",646,4,6,4,3,1,2
"Brazil",646,5,7,5,3,2,1
"Switzerland",646,5,5,4,1,3,2
"England",646,7,7,4,0,4,1
"Belgium",646,7,6,5,4,1,2
"Egypt",647,1,7,4,1,3,1
"Russia",647,1,4,3,3,0,2
"Peru",647,3,5,2,1,1,1
"France",647,3,4,2,1,1,2
"Serbia",647,5,5,4,3,1,1
"Switzerland",647,5,4,1,1,0,2
"Mexico",647,6,7,5,2,3,1
"Sweden",647,6,3,2,2,0,2
"England",647,7,9,5,1,4,1
"Panama",647,7,4,1,1,0,2
"Colombia",647,8,7,4,2,2,1
"Poland",647,8,6,6,5,1,2
"Uruguay",648,1,7,3,1,2,1
"Egypt",648,1,6,4,1,3,2
"Costa Rica",648,5,7,3,1,2,1
"Serbia",648,5,4,3,3,0,2
"Belgium",648,7,7,5,1,4,1
"Tunisia",648,7,4,2,4,-2,2
"Iran",649,2,7,4,2,2,1
"Spain",649,2,3,4,4,0,2
"France",649,3,7,8,0,8,1
"Denmark",649,3,6,3,5,-2,2
"South Korea",649,6,6,3,3,0,1
"Mexico",649,6,5,4,2,2,2
"Belgium",649,7,7,5,2,3,1
"England",649,7,6,6,4,2,2
"France",650,3,9,9,1,8,1
"Peru",650,3,6,7,3,4,2
"Brazil",650,5,7,6,1,5,1
"Switzerland",650,5,5,3,2,1,2
"England",650,7,6,10,4,6,1
"Panama",650,7,5,6,3,3,2
"Colombia",650,8,9,8,1,7,1
"Poland",650,8,4,3,4,-1,2
"Saudi Arabia",651,1,7,5,3,2,1
"Egypt",651,1,5,3,1,2,2
"Spain",651,2,9,7,2,5,1
"Morocco",651,2,6,2,3,-1,2
"Switzerland",651,5,7,6,1,5,1
"Brazil",651,5,5,3,0,3,2
"Senegal",651,8,7,2,0,2,1
"Colombia",651,8,4,4,2,2,2
"Argentina",652,4,9,5,0,5,1
"Croatia",652,4,6,3,3,0,2
"Brazil",652,5,9,8,2,6,1
"Serbia",652,5,4,3,5,-2,2
"Belgium",652,7,7,3,1,2,1
"England",652,7,6,4,1,3,2
"Poland",652,8,7,6,2,4,1
"Japan",652,8,4,4,5,-1,2
"Uruguay",653,1,6,5,2,3,1
"Egypt",653,1,5,5,4,1,2
"Spain",653,2,7,5,1,4,1
"Portugal",653,2,5,2,0,2,2
"Brazil",653,5,9,10,2,8,1
"Costa Rica",653,5,4,5,4,1,2
"South Korea",653,6,7,4,2,2,1
"Germany",653,6,4,2,3,-1,2
"England",653,7,7,5,2,3,1
"Belgium",653,7,6,7,6,1,2
"Spain",654,2,7,6,4,2,1
"Iran",654,2,6,5,2,3,2
"France",654,3,9,5,1,4,1
"Denmark",654,3,6,4,2,2,2
"Argentina",654,4,7,4,1,3,1
"Iceland",654,4,6,2,2,0,2
"Brazil",654,5,7,8,1,7,1
"Serbia",654,5,3,4,4,0,2
"Germany",654,6,7,6,3,3,1
"South Korea",654,6,4,4,4,0,2
"Belgium",654,7,7,7,3,4,1
"England",654,7,5,3,2,1,2
"Colombia",654,8,9,8,1,7,1
"Japan",654,8,6,6,3,3,2
"Morocco",655,2,7,2,0,2,1
"Iran",655,2,6,2,1,1,2
"Argentina",655,4,7,5,0,5,1
"Croatia",655,4,6,4,3,1,2
"Panama",655,7,6,5,5,0,1
"Belgium",655,7,5,5,3,2,2
"Japan",655,8,7,4,0,4,1
"Poland",655,8,5,3,2,1,2
"Portugal",656,2,9,6,2,4,1
"Spain",656,2,6,4,2,2,2
"Denmark",656,3,9,6,3,3,1
"France",656,3,6,4,2,2,2
"Argentina",656,4,7,3,1,2,1
"Croatia",656,4,5,4,3,1,2
"Brazil",656,5,7,5,2,3,1
"Switzerland",656,5,4,4,4,0,2
"Belgium",656,7,9,9,0,9,1
"Tunisia",656,7,4,3,4,-1,2
"Spain",657,2,9,11,3,8,1
"Portugal",657,2,6,6,7,-1,2
"England",657,7,9,7,0,7,1
"Belgium",657,7,6,6,2,4,2
"Poland",657,8,7,5,3,2,1
"Japan",657,8,6,6,4,2,2
"France",658,3,9,5,0,5,1
"Peru",658,3,4,3,3,0,2
"Colombia",658,8,7,6,0,6,1
"Poland",658,8,6,3,4,-1,2
"Uruguay",659,1,7,8,2,6,1
"Russia",659,1,5,4,3,1,2
"Argentina",659,4,9,11,1,10,1
"Croatia",659,4,6,5,6,-1,2
"Japan",659,8,7,4,1,3,1
"Colombia",659,8,4,2,1,1,2
"Uruguay",660,1,9,6,0,6,1
"Saudi Arabia",660,1,4,2,3,-1,2
"Portugal",660,2,5,4,3,1,1
"Spain",660,2,4,4,4,0,2
"Croatia",660,4,6,7,3,4,1
"Argentina",660,4,5,4,3,1,2
"Brazil",660,5,7,6,2,4,1
"Serbia",660,5,4,3,8,-5,2
"Senegal",660,8,6,5,3,2,1
"Japan",660,8,5,5,3,2,2
"Uruguay",661,1,7,3,0,3,1
"Egypt",661,1,6,5,3,2,2
"Spain",661,2,9,6,0,6,1
"Portugal",661,2,4,3,4,-1,2
"Croatia",661,4,9,8,2,6,1
"Argentina",661,4,6,3,2,1,2
"South Korea",661,6,7,6,2,4,1
"Germany",661,6,6,6,3,3,2
"Poland",661,8,6,7,4,3,1
"Colombia",661,8,5,4,2,2,2
"Portugal",662,2,6,8,6,2,1
"Iran",662,2,5,7,5,2,2
"Peru",662,3,9,4,0,4,1
"France",662,3,6,2,1,1,2
"Brazil",662,5,7,6,1,5,1
"Costa Rica",662,5,5,5,2,3,2
"England",662,7,9,6,0,6,1
"Belgium",662,7,6,5,4,1,2
"Spain",663,2,9,11,2,9,1
"Portugal",663,2,6,6,2,4,2
"Argentina",663,4,7,7,3,4,1
"Nigeria",663,4,6,3,3,0,2
"Brazil",663,5,9,6,2,4,1
"Switzerland",663,5,4,4,3,1,2
"Mexico",663,6,7,4,1,3,1
"Sweden",663,6,4,2,2,0,2
"England",663,7,9,6,1,5,1
"Belgium",663,7,6,4,4,0,2
"Poland",663,8,7,3,0,3,1
"Colombia",663,8,4,1,2,-1,2
"Spain",664,2,7,7,1,6,1
"Morocco",664,2,4,2,4,-2,2
"Croatia",664,4,7,6,3,3,1
"Argentina",664,4,3,2,2,0,2
"Germany",664,6,7,6,2,4,1
"Sweden",664,6,4,4,5,-1,2
"Belgium",664,7,9,7,1,6,1
"England",664,7,4,4,3,1,2
"Colombia",664,8,5,4,3,1,1
"Senegal",664,8,4,1,1,0,2
"Iran",665,2,7,4,2,2,1
"Portugal",665,2,4,2,2,0,2
"Argentina",665,4,9,11,0,11,1
"Croatia",665,4,6,2,1,1,2
"Brazil",665,5,9,5,1,4,1
"Costa Rica",665,5,4,5,5,0,2
"South Korea",665,6,5,1,0,1,1
"Sweden",665,6,4,2,2,0,2
"England",665,7,6,4,2,2,1
"Belgium",665,7,5,2,1,1,2
"Uruguay",666,1,7,6,3,3,1
"Russia",666,1,4,3,3,0,2
"Portugal",666,2,6,6,3,3,1
"Spain",666,2,5,4,3,1,2
"Australia",666,3,5,5,4,1,1
"France",666,3,4,5,1,4,2
"Argentina",666,4,9,6,0,6,1
"Croatia",666,4,6,3,2,1,2
"Brazil",666,5,9,9,3,6,1
"Switzerland",666,5,4,2,2,0,2
"Colombia",666,8,9,9,2,7,1
"Senegal",666,8,4,1,5,-4,2
"Uruguay",668,1,9,9,1,8,1
"Saudi Arabia",668,1,4,4,6,-2,2
"Spain",668,2,7,7,1,6,1
"Iran",668,2,6,5,4,1,2
"Brazil",668,5,7,4,1,3,1
"Switzerland",668,5,4,3,4,-1,2
"Mexico",668,6,7,7,2,5,1
"South Korea",668,6,6,6,7,-1,2
"Panama",668,7,9,5,2,3,1
"Belgium",668,7,6,5,3,2,2
"Poland",668,8,9,8,2,6,1
"Colombia",668,8,6,9,2,7,2
"France",669,3,7,9,3,6,1
"Australia",669,3,6,4,4,0,2
"Argentina",669,4,7,6,1,5,1
"Croatia",669,4,6,5,5,0,2
"Costa Rica",669,5,7,3,0,3,1
"Serbia",669,5,6,4,4,0,2
"England",669,7,7,6,1,5,1
"Belgium",669,7,5,6,3,3,2
"Russia",670,1,9,7,1,6,1
"Egypt",670,1,6,3,4,-1,2
"France",670,3,7,5,0,5,1
"Denmark",670,3,4,2,2,0,2
"Brazil",670,5,7,6,1,5,1
"Switzerland",670,5,6,4,4,0,2
"Germany",670,6,7,4,2,2,1
"South Korea",670,6,5,5,4,1,2
"Poland",670,8,5,7,5,2,1
"Colombia",670,8,4,4,5,-1,2
"Egypt",671,1,7,6,1,5,1
"Uruguay",671,1,4,4,5,-1,2
"Spain",671,2,9,8,2,6,1
"Portugal",671,2,6,7,4,3,2
"France",671,3,9,8,0,8,1
"Peru",671,3,6,4,4,0,2
"Argentina",671,4,9,5,0,5,1
"Croatia",671,4,4,5,2,3,2
"Brazil",671,5,9,11,3,8,1
"Costa Rica",671,5,6,5,3,2,2
"England",671,7,7,5,0,5,1
"Panama",671,7,3,2,2,0,2
"Colombia",671,8,9,6,2,4,1
"Japan",671,8,6,6,2,4,2
"Mexico",672,6,7,5,2,3,1
"Germany",672,6,6,3,2,1,2
"England",672,7,9,7,2,5,1
"Belgium",672,7,6,7,3,4,2
"Colombia",672,8,9,6,0,6,1
"Japan",672,8,6,6,2,4,2
"Uruguay",673,1,7,5,1,4,1
"Russia",673,1,5,3,2,1,2
"Iran",673,2,6,7,4,3,1
"Portugal",673,2,5,5,2,3,2
"Croatia",673,4,7,3,0,3,1
"Argentina",673,4,5,3,1,2,2
"Brazil",673,5,6,7,2,5,1
"Switzerland",673,5,5,6,5,1,2
"Germany",673,6,5,5,3,2,1
"South Korea",673,6,4,3,4,-1,2
"Poland",673,8,7,6,2,4,1
"Colombia",673,8,5,3,2,1,2
"Uruguay",674,1,9,5,1,4,1
"Russia",674,1,6,4,2,2,2
"Argentina",674,4,7,7,2,5,1
"Croatia",674,4,4,3,5,-2,2
"England",674,7,9,5,1,4,1
"Belgium",674,7,4,4,2,2,2
"Colombia",674,8,7,4,2,2,1
"Japan",674,8,6,5,2,3,2
"Uruguay",675,1,9,8,1,7,1
"Egypt",675,1,6,7,6,1,2
"France",675,3,9,8,2,6,1
"Peru",675,3,4,4,6,-2,2
"Argentina",675,4,9,8,2,6,1
"Croatia",675,4,6,6,2,4,2
"Germany",675,6,9,5,1,4,1
"Mexico",675,6,4,3,3,0,2
"Colombia",675,8,9,7,0,7,1
"Poland",675,8,6,3,3,0,2
"Uruguay",676,1,7,7,0,7,1
"Saudi Arabia",676,1,4,3,3,0,2
"Portugal",676,2,7,2,0,2,1
"Iran",676,2,6,4,1,3,2
"Denmark",676,3,7,2,0,2,1
"France",676,3,6,3,1,2,2
"Germany",676,6,7,5,2,3,1
"South Korea",676,6,6,3,1,2,2
"Belgium",676,7,9,3,0,3,1
"England",676,7,6,8,1,7,2
"Colombia",676,8,9,5,0,5,1
"Japan",676,8,4,1,2,-1,2
"Russia",677,1,9,6,1,5,1
"Uruguay",677,1,4,2,1,1,2
"Spain",677,2,9,7,1,6,1
"Morocco",677,2,4,2,3,-1,2
"Germany",677,6,7,6,2,4,1
"Sweden",677,6,5,5,3,2,2
"England",677,7,7,7,1,6,1
"Belgium",677,7,6,7,6,1,2
"Japan",677,8,7,2,0,2,1
"Senegal",677,8,4,1,1,0,2
"Uruguay",678,1,7,6,2,4,1
"Saudi Arabia",678,1,6,2,2,0,2
"Spain",678,2,9,5,0,5,1
"Portugal",678,2,6,5,3,2,2
"France",678,3,9,6,0,6,1
"Denmark",678,3,4,5,5,0,2
"Iceland",678,4,7,6,4,2,1
"Croatia",678,4,5,4,2,2,2
"Brazil",678,5,7,7,1,6,1
"Switzerland",678,5,5,6,5,1,2
"Germany",678,6,7,3,1,2,1
"Sweden",678,6,4,3,2,1,2
"England",678,7,9,6,3,3,1
"Belgium",678,7,4,4,3,1,2
"Egypt",679,1,7,3,1,2,1
"Russia",679,1,6,2,1,1,2
"France",679,3,7,5,1,4,1
"Denmark",679,3,6,3,2,1,2
"Argentina",679,4,7,6,3,3,1
"Croatia",679,4,5,5,2,3,2
"Mexico",679,6,7,3,1,2,1
"South Korea",679,6,5,3,2,1,2
"Belgium",679,7,9,8,4,4,1
"Panama",679,7,6,6,3,3,2
"Portugal",680,2,7,7,4,3,1
"Iran",680,2,4,5,4,1,2
"France",680,3,9,9,1,8,1
"Australia",680,3,6,5,5,0,2
"England",680,7,9,9,2,7,1
"Panama",680,7,6,7,4,3,2
"Argentina",681,4,9,10,1,9,1
"Croatia",681,4,4,3,6,-3,2
"Brazil",681,5,7,5,2,3,1
"Serbia",681,5,4,4,4,0,2
"South Korea",681,6,9,8,2,6,1
"Germany",681,6,4,5,4,1,2
"England",681,7,7,2,0,2,1
"Belgium",681,7,6,3,1,2,2
"Uruguay",682,1,9,6,2,4,1
"Russia",682,1,6,7,5,2,2
"Spain",682,2,9,5,0,5,1
"Portugal",682,2,4,1,1,0,2
"Costa Rica",682,5,7,6,3,3,1
"Brazil",682,5,4,4,5,-1,2
"England",682,7,9,7,2,5,1
"Panama",682,7,4,2,2,0,2
"Colombia",682,8,7,4,2,2,1
"Poland",682,8,5,3,2,1,2
"Egypt",683,1,7,5,2,3,1
"Uruguay",683,1,4,4,2,2,2
"Spain",683,2,7,6,2,4,1
"Iran",683,2,4,4,2,2,2
"Peru",683,3,7,5,3,2,1
"Australia",683,3,4,4,3,1,2
"Belgium",683,7,9,8,0,8,1
"England",683,7,4,3,3,0,2
"Japan",683,8,7,6,2,4,1
"Colombia",683,8,5,5,2,3,2
"Spain",684,2,9,7,1,6,1
"Portugal",684,2,6,2,1,1,2
"Peru",684,3,7,5,2,3,1
"Denmark",684,3,6,2,1,1,2
"Germany",684,6,5,6,4,2,1
"Sweden",684,6,4,3,2,1,2
"Poland",684,8,7,7,0,7,1
"Senegal",684,8,6,6,5,1,2
"Russia",685,1,9,5,0,5,1
"Uruguay",685,1,4,2,2,0,2
"Argentina",685,4,7,7,1,6,1
"Iceland",685,4,4,2,2,0,2
"Brazil",685,5,9,7,1,6,1
"Switzerland",685,5,4,5,5,0,2
"Portugal",686,2,6,4,2,2,1
"Spain",686,2,5,1,0,1,2
"France",686,3,7,4,0,4,1
"Australia",686,3,6,4,3,1,2
"Argentina",686,4,9,6,2,4,1
"Iceland",686,4,4,5,3,2,2
"Costa Rica",686,5,9,6,2,4,1
"Brazil",686,5,6,3,1,2,2
"South Korea",686,6,7,4,2,2,1
"Germany",686,6,6,3,2,1,2
"Panama",686,7,9,4,0,4,1
"Belgium",686,7,6,2,1,1,2
"Spain",687,2,7,7,2,5,1
"Portugal",687,2,4,4,3,1,2
"Switzerland",687,5,9,5,1,4,1
"Costa Rica",687,5,4,4,3,1,2
"Germany",687,6,7,2,0,2,1
"Sweden",687,6,4,2,2,0,2
"England",687,7,7,7,2,5,1
"Belgium",687,7,5,5,3,2,2
"Saudi Arabia",688,1,6,2,3,-1,1
"Uruguay",688,1,5,3,0,3,2
"France",688,3,7,4,1,3,1
"Peru",688,3,5,4,2,2,2
"Croatia",688,4,5,4,3,1,1
"Nigeria",688,4,4,4,4,0,2
"Brazil",688,5,7,6,1,5,1
"Costa Rica",688,5,5,2,1,1,2
"Germany",688,6,7,6,3,3,1
"Sweden",688,6,4,5,6,-1,2
"Belgium",688,7,7,4,2,2,1
"England",688,7,6,9,3,6,2
"Poland",688,8,7,3,1,2,1
"Senegal",688,8,5,3,2,1,2
"Uruguay",689,1,7,8,2,6,1
"Egypt",689,1,4,3,4,-1,2
"Iran",689,2,9,8,3,5,1
"Spain",689,2,4,3,4,-1,2
"Argentina",689,4,7,7,1,6,1
"Nigeria",689,4,4,3,7,-4,2
"Brazil",689,5,9,7,2,5,1
"Switzerland",689,5,4,5,4,1,2
"Mexico",689,6,7,6,3,3,1
"Sweden",689,6,6,7,3,4,2
"England",689,7,5,7,3,4,1
"Tunisia",689,7,4,2,5,-3,2
"Colombia",689,8,5,4,2,2,1
"Japan",689,8,4,2,3,-1,2
"Peru",690,3,7,6,1,5,1
"France",690,3,6,5,3,2,2
"Argentina",690,4,9,6,0,6,1
"Iceland",690,4,6,4,4,0,2
"Brazil",690,5,7,7,2,5,1
"Switzerland",690,5,6,3,3,0,2
"Germany",690,6,7,7,3,4,1
"Mexico",690,6,4,4,3,1,2
"England",690,7,9,7,0,7,1
"Belgium",690,7,6,3,2,1,2
"Colombia",690,8,9,8,1,7,1
"Poland",690,8,6,4,4,0,2
"Uruguay",691,1,7,6,2,4,1
"Egypt",691,1,5,3,2,1,2
"Portugal",691,2,7,4,1,3,1
"Iran",691,2,6,4,1,3,2
"France",691,3,9,9,2,7,1
"Peru",691,3,4,1,1,0,2
"Argentina",691,4,9,5,2,3,1
"Croatia",691,4,6,5,2,3,2
"Brazil",691,5,9,7,2,5,1
"Switzerland",691,5,6,5,3,2,2
"Germany",691,6,5,1,0,1,1
"South Korea",691,6,4,5,4,1,2
"Panama",691,7,7,4,2,2,1
"England",691,7,6,5,2,3,2
"Egypt",692,1,7,4,1,3,1
"Saudi Arabia",692,1,6,4,4,0,2
"Spain",692,2,7,7,4,3,1
"Portugal",692,2,6,7,4,3,2
"Australia",692,3,9,5,1,4,1
"France",692,3,4,3,3,0,2
"Serbia",692,5,7,4,2,2,1
"Brazil",692,5,4,3,3,0,2
"England",692,7,9,8,1,7,1
"Belgium",692,7,6,5,3,2,2
"Uruguay",693,1,7,4,2,2,1
"Saudi Arabia",693,1,6,4,3,1,2
"Germany",693,6,9,6,2,4,1
"Mexico",693,6,4,4,3,1,2
"Russia",694,1,9,7,1,6,1
"Uruguay",694,1,6,7,6,1,2
"Australia",694,3,7,3,0,3,1
"France",694,3,6,5,2,3,2
"Argentina",694,4,9,8,2,6,1
"Iceland",694,4,4,1,3,-2,2
"Switzerland",694,5,7,7,1,6,1
"Brazil",694,5,6,8,3,5,2
"Mexico",694,6,7,8,6,2,1
"South Korea",694,6,4,6,5,1,2
"Panama",694,7,7,3,0,3,1
"England",694,7,6,4,1,3,2
"Japan",694,8,7,3,1,2,1
"Poland",694,8,5,2,1,1,2
"Iran",695,2,6,3,1,2,1
"Portugal",695,2,5,5,4,1,2
"South Korea",695,6,9,11,6,5,1
"Sweden",695,6,6,6,5,1,2
"Belgium",695,7,7,6,1,5,1
"Tunisia",695,7,4,3,3,0,2
"Colombia",695,8,7,4,2,2,1
"Poland",695,8,5,5,2,3,2
"Uruguay",696,1,7,6,3,3,1
"Russia",696,1,6,7,3,4,2
"Spain",696,2,9,4,1,3,1
"Iran",696,2,4,2,1,1,2
"France",696,3,9,10,2,8,1
"Peru",696,3,4,4,4,0,2
"Croatia",696,4,7,6,3,3,1
"Argentina",696,4,6,6,2,4,2
"Switzerland",696,5,7,4,2,2,1
"Brazil",696,5,6,6,2,4,2
"Mexico",696,6,7,6,3,3,1
"Sweden",696,6,5,7,4,3,2
"Spain",697,2,7,4,2,2,1
"Portugal",697,2,5,3,0,3,2
"France",697,3,9,7,1,6,1
"Peru",697,3,6,4,2,2,2
"Argentina",697,4,7,6,2,4,1
"Iceland",697,4,5,1,0,1,2
"Brazil",697,5,9,5,1,4,1
"Serbia",697,5,6,4,3,1,2
"Germany",697,6,7,4,1,3,1
"Mexico",697,6,4,4,4,0,2
"Belgium",697,7,7,6,1,5,1
"England",697,7,4,2,2,0,2
"Colombia",697,8,7,9,3,6,1
"Poland",697,8,6,6,2,4,2
"Portugal",698,2,9,6,3,3,1
"Spain",698,2,6,6,5,1,2
"Peru",698,3,7,5,2,3,1
"France",698,3,6,6,4,2,2
"Colombia",698,8,7,3,1,2,1
"Poland",698,8,4,3,3,0,2
"Russia",699,1,7,3,1,2,1
"Uruguay",699,1,4,4,4,0,2
"Spain",699,2,9,6,0,6,1
"Iran",699,2,6,6,6,0,2
"France",699,3,7,9,1,8,1
"Peru",699,3,6,8,6,2,2
"Nigeria",699,4,7,7,2,5,1
"Argentina",699,4,4,3,2,1,2
"Costa Rica",699,5,9,6,1,5,1
"Brazil",699,5,6,7,2,5,2
"Germany",699,6,9,7,1,6,1
"Mexico",699,6,4,2,3,-1,2
"England",699,7,7,5,0,5,1
"Belgium",699,7,5,2,1,1,2
"Poland",699,8,7,5,2,3,1
"Japan",699,8,6,4,3,1,2
"Saudi Arabia",700,1,7,3,1,2,1
"Uruguay",700,1,5,2,1,1,2
"Denmark",700,3,9,5,2,3,1
"France",700,3,4,3,2,1,2
"Argentina",700,4,7,6,2,4,1
"Croatia",700,4,5,3,1,2,2
"Brazil",700,5,7,10,1,9,1
"Switzerland",700,5,6,5,7,-2,2
"South Korea",700,6,7,3,1,2,1
"Germany",700,6,5,2,1,1,2
"Belgium",700,7,7,4,1,3,1
"Tunisia",700,7,4,4,5,-1,2
"Egypt",701,1,5,3,1,2,1
"Russia",701,1,4,3,4,-1,2
"Portugal",701,2,7,6,1,5,1
"Morocco",701,2,6,2,4,-2,2
"Argentina",701,4,7,6,0,6,1
"Nigeria",701,4,6,7,7,0,2
"South Korea",701,6,7,4,1,3,1
"Sweden",701,6,5,2,1,1,2
"Tunisia",701,7,7,6,3,3,1
"Belgium",701,7,6,8,6,2,2
"Poland",701,8,9,7,2,5,1
"Senegal",701,8,6,5,4,1,2
"Uruguay",702,1,7,6,3,3,1
"Russia",702,1,5,3,2,1,2
"Portugal",702,2,7,8,4,4,1
"Iran",702,2,4,4,4,0,2
"Colombia",702,8,9,9,4,5,1
"Poland",702,8,6,6,4,2,2
"Uruguay",703,1,7,7,3,4,1
"Saudi Arabia",703,1,5,6,4,2,2
"Denmark",703,3,7,3,0,3,1
"France",703,3,6,6,3,3,2
"Croatia",703,4,7,4,1,3,1
"Argentina",703,4,4,5,3,2,2
"England",703,7,7,11,3,8,1
"Belgium",703,7,6,3,2,1,2
"Uruguay",704,1,7,9,4,5,1
"Saudi Arabia",704,1,6,3,2,1,2
"Iran",704,2,7,5,2,3,1
"Spain",704,2,4,4,3,1,2
"Croatia",704,4,7,8,1,7,1
"Argentina",704,4,5,3,1,2,2
"Switzerland",704,5,7,4,1,3,1
"Costa Rica",704,5,3,3,3,0,2
"Panama",704,7,7,2,0,2,1
"Belgium",704,7,5,2,1,1,2
"Japan",704,8,7,4,1,3,1
"Poland",704,8,6,5,3,2,2
"Uruguay",705,1,9,7,2,5,1
"Russia",705,1,6,4,3,1,2
"Spain",705,2,5,4,3,1,1
"Iran",705,2,4,4,4,0,2
"Argentina",705,4,9,5,2,3,1
"Croatia",705,4,6,3,1,2,2
"Colombia",705,8,7,3,0,3,1
"Senegal",705,8,6,2,2,0,2
"Spain",706,2,7,6,2,4,1
"Portugal",706,2,3,5,5,0,2
"Argentina",706,4,9,7,2,5,1
"Croatia",706,4,4,4,4,0,2
"Sweden",706,6,9,6,2,4,1
"Mexico",706,6,4,4,3,1,2
"Japan",706,8,7,2,0,2,1
"Colombia",706,8,6,3,2,1,2
"France",707,3,9,8,1,7,1
"Peru",707,3,4,3,3,0,2
"Croatia",707,4,7,5,3,2,1
"Nigeria",707,4,5,7,6,1,2
"Brazil",707,5,6,7,2,5,1
"Costa Rica",707,5,5,3,1,2,2
"Mexico",707,6,7,5,2,3,1
"Sweden",707,6,4,4,4,0,2
"Belgium",707,7,7,9,3,6,1
"England",707,7,4,8,7,1,2
"Portugal",708,2,7,2,0,2,1
"Iran",708,2,5,4,2,2,2
"France",708,3,7,4,1,3,1
"Peru",708,3,4,2,1,1,2
"Argentina",708,4,7,7,1,6,1
"Croatia",708,4,4,3,1,2,2
"Serbia",708,5,9,6,0,6,1
"Switzerland",708,5,6,5,2,3,2
"South Korea",708,6,9,5,1,4,1
"Mexico",708,6,6,6,4,2,2
"Japan",708,8,7,5,1,4,1
"Poland",708,8,6,5,3,2,2
"Spain",709,2,9,9,1,8,1
"Morocco",709,2,4,2,3,-1,2
"Argentina",709,4,9,7,0,7,1
"Iceland",709,4,4,2,2,0,2
"Belgium",709,7,7,3,0,3,1
"Panama",709,7,5,2,1,1,2
"Colombia",709,8,7,7,1,6,1
"Japan",709,8,6,4,4,0,2
"Russia",710,1,7,4,2,2,1
"Saudi Arabia",710,1,4,2,2,0,2
"Denmark",710,3,7,8,3,5,1
"France",710,3,6,7,6,1,2
"Argentina",710,4,9,8,1,7,1
"Croatia",710,4,6,3,4,-1,2
"Mexico",710,6,6,5,3,2,1
"Germany",710,6,5,1,0,1,2
"Colombia",710,8,9,5,1,4,1
"Poland",710,8,6,4,3,1,2
"Uruguay",711,1,9,9,1,8,1
"Egypt",711,1,4,2,3,-1,2
"Peru",711,3,7,4,1,3,1
"France",711,3,6,5,2,3,2
"Croatia",711,4,7,3,0,3,1
"Argentina",711,4,5,1,0,1,2
"Germany",711,6,7,7,0,7,1
"South Korea",711,6,4,4,4,0,2
"Argentina",712,4,7,9,2,7,1
"Croatia",712,4,5,7,3,4,2
"Switzerland",712,5,9,6,1,5,1
"Brazil",712,5,6,2,1,1,2
"Tunisia",712,7,7,5,3,2,1
"England",712,7,6,6,2,4,2
"Japan",712,8,6,3,3,0,1
"Colombia",712,8,5,5,3,2,2
"Uruguay",713,1,9,9,0,9,1
"Egypt",713,1,6,4,1,3,2
"Croatia",713,4,7,3,1,2,1
"Argentina",713,4,6,4,1,3,2
"Brazil",713,5,7,9,4,5,1
"Costa Rica",713,5,6,6,4,2,2
"Germany",713,6,7,6,4,2,1
"South Korea",713,6,4,5,4,1,2
"England",713,7,7,6,2,4,1
"Belgium",713,7,6,6,5,1,2
"Colombia",713,8,7,7,3,4,1
"Poland",713,8,4,3,4,-1,2
"Portugal",714,2,7,3,1,2,1
"Spain",714,2,5,5,4,1,2
"Argentina",714,4,7,5,0,5,1
"Croatia",714,4,6,6,6,0,2
"Switzerland",714,5,9,11,4,7,1
"Costa Rica",714,5,6,4,6,-2,2
"England",714,7,9,6,2,4,1
"Belgium",714,7,6,7,2,5,2
"Japan",714,8,7,3,1,2,1
"Senegal",714,8,4,2,2,0,2
"Uruguay",715,1,7,8,1,7,1
"Russia",715,1,6,2,2,0,2
"Spain",715,2,7,5,0,5,1
"Portugal",715,2,6,3,4,-1,2
"Peru",715,3,9,4,1,3,1
"France",715,3,6,5,3,2,2
"Argentina",715,4,9,8,1,7,1
"Croatia",715,4,6,4,3,1,2
"Germany",715,6,7,7,2,5,1
"South Korea",715,6,6,4,2,2,2
"Colombia",715,8,7,5,2,3,1
"Poland",715,8,4,3,3,0,2
"Russia",716,1,5,3,1,2,1
"Uruguay",716,1,4,4,5,-1,2
"Spain",716,2,9,6,2,4,1
"Portugal",716,2,6,5,3,2,2
"France",716,3,9,6,2,4,1
"Denmark",716,3,6,5,3,2,2
"Brazil",716,5,9,3,0,3,1
"Serbia",716,5,4,3,3,0,2
"England",716,7,7,5,2,3,1
"Panama",716,7,4,4,4,0,2
"Colombia",716,8,7,5,1,4,1
"Poland",716,8,6,5,5,0,2
"Uruguay",717,1,7,5,1,4,1
"Russia",717,1,5,5,2,3,2
"Spain",717,2,7,4,2,2,1
"Portugal",717,2,6,3,2,1,2
"Peru",717,3,9,9,4,5,1
"France",717,3,6,4,4,0,2
"Iceland",717,4,6,6,5,1,1
"Argentina",717,4,5,5,3,2,2
"Brazil",717,5,9,6,1,5,1
"Switzerland",717,5,4,4,5,-1,2
"England",717,7,7,6,2,4,1
"Belgium",717,7,4,2,1,1,2
"Poland",717,8,7,4,1,3,1
"Colombia",717,8,6,4,2,2,2
"Argentina",718,4,9,3,0,3,1
"Croatia",718,4,6,5,3,2,2
"Costa Rica",718,5,7,3,1,2,1
"Brazil",718,5,6,8,4,4,2
"Belgium",718,7,7,5,1,4,1
"Tunisia",718,7,4,1,1,0,2
"Portugal",719,2,9,9,3,6,1
"Spain",719,2,6,6,8,-2,2
"Argentina",719,4,7,4,0,4,1
"Croatia",719,4,6,5,3,2,2
"Mexico",719,6,7,5,2,3,1
"Germany",719,6,5,5,2,3,2
"Panama",719,7,7,4,1,3,1
"Belgium",719,7,6,2,1,1,2
"Spain",720,2,7,3,1,2,1
"Iran",720,2,6,5,2,3,2
"Argentina",720,4,7,12,4,8,1
"Nigeria",720,4,4,6,9,-3,2
"Switzerland",720,5,7,4,1,3,1
"Serbia",720,5,4,2,2,0,2
"Germany",720,6,7,4,2,2,1
"Sweden",720,6,4,3,3,0,2
"Japan",720,8,5,3,1,2,1
"Colombia",720,8,4,5,4,1,2
"Uruguay",721,1,9,8,3,5,1
"Saudi Arabia",721,1,6,4,4,0,2
"Iran",721,2,9,5,1,4,1
"Spain",721,2,6,3,2,1,2
"Denmark",721,3,7,4,1,3,1
"France",721,3,5,6,2,4,2
"Croatia",721,4,7,4,1,3,1
"Argentina",721,4,6,7,4,3,2
"Germany",721,6,9,7,1,6,1
"Sweden",721,6,6,6,4,2,2
"Belgium",721,7,9,8,3,5,1
"England",721,7,6,8,4,4,2
"Poland",721,8,7,3,1,2,1
"Colombia",721,8,6,4,2,2,2
"Spain",722,2,9,6,0,6,1
"Portugal",722,2,6,4,2,2,2
"France",722,3,7,3,1,2,1
"Australia",722,3,5,3,2,1,2
"Brazil",722,5,9,8,2,6,1
"Serbia",722,5,6,5,3,2,2
"Colombia",722,8,9,7,2,5,1
"Japan",722,8,4,4,6,-2,2
"Uruguay",723,1,9,5,0,5,1
"Russia",723,1,6,5,3,2,2
"Portugal",723,2,7,3,0,3,1
"Spain",723,2,6,4,4,0,2
"Croatia",723,4,7,6,0,6,1
"Iceland",723,4,4,2,3,-1,2
"Germany",723,6,7,3,1,2,1
"Sweden",723,6,5,3,2,1,2
"England",723,7,7,4,2,2,1
"Tunisia",723,7,4,4,3,1,2
"Japan",723,8,7,4,0,4,1
"Colombia",723,8,4,3,3,0,2
"Portugal",724,2,7,5,0,5,1
"Iran",724,2,4,6,3,3,2
"Brazil",724,5,7,6,3,3,1
"Costa Rica",724,5,5,5,4,1,2
"Germany",724,6,9,9,0,9,1
"Mexico",724,6,6,5,5,0,2
"England",724,7,7,6,0,6,1
"Belgium",724,7,5,2,1,1,2
"Spain",725,2,9,4,0,4,1
"Iran",725,2,4,4,3,1,2
"Denmark",725,3,7,5,2,3,1
"France",725,3,6,4,1,3,2
"Germany",725,6,7,5,3,2,1
"South Korea",725,6,4,4,2,2,2
"England",725,7,7,6,2,4,1
"Belgium",725,7,6,7,4,3,2
"Uruguay",726,1,7,5,3,2,1
"Russia",726,1,4,2,2,0,2
"France",726,3,9,7,2,5,1
"Denmark",726,3,4,2,3,-1,2
"Brazil",726,5,9,7,0,7,1
"Costa Rica",726,5,4,2,4,-2,2
"Germany",726,6,9,6,1,5,1
"Sweden",726,6,4,4,4,0,2
"Belgium",726,7,9,6,0,6,1
"England",726,7,6,9,3,6,2
"Argentina",727,4,7,5,2,3,1
"Croatia",727,4,5,3,2,1,2
"Brazil",727,5,9,9,3,6,1
"Switzerland",727,5,4,2,3,-1,2
"Germany",727,6,7,7,0,7,1
"South Korea",727,6,6,5,8,-3,2
"England",727,7,7,5,2,3,1
"Tunisia",727,7,6,2,2,0,2
"Colombia",727,8,6,3,2,1,1
"Poland",727,8,5,3,2,1,2
"Spain",728,2,7,7,0,7,1
"Iran",728,2,4,2,3,-1,2
"Argentina",728,4,9,9,1,8,1
"Nigeria",728,4,6,3,3,0,2
"Mexico",728,6,7,5,3,2,1
"Germany",728,6,6,6,3,3,2
"Belgium",728,7,9,8,1,7,1
"England",728,7,4,4,4,0,2
"Iran",729,2,7,5,2,3,1
"Morocco",729,2,6,8,5,3,2
"France",729,3,9,6,0,6,1
"Peru",729,3,4,3,2,1,2
"Argentina",729,4,6,5,3,2,1
"Iceland",729,4,5,3,2,1,2
"Brazil",729,5,9,9,2,7,1
"Costa Rica",729,5,4,5,5,0,2
"South Korea",729,6,9,5,1,4,1
"Germany",729,6,6,5,4,1,2
"England",729,7,9,9,3,6,1
"Belgium",729,7,4,3,3,0,2
"Colombia",729,8,7,3,1,2,1
"Japan",729,8,6,5,4,1,2
"Spain",730,2,7,6,2,4,1
"Portugal",730,2,6,6,4,2,2
"France",730,3,9,12,1,11,1
"Peru",730,3,4,3,4,-1,2
"Nigeria",730,4,7,4,2,2,1
"Argentina",730,4,6,7,3,4,2
"Brazil",730,5,7,9,4,5,1
"Costa Rica",730,5,4,5,5,0,2
"Japan",730,8,9,5,2,3,1
"Poland",730,8,4,5,5,0,2
"Uruguay",731,1,9,6,2,4,1
"Saudi Arabia",731,1,4,2,2,0,2
"Costa Rica",731,5,7,5,2,3,1
"Brazil",731,5,4,3,4,-1,2
"Belgium",731,7,9,6,2,4,1
"England",731,7,6,5,3,2,2
"Japan",731,8,7,3,0,3,1
"Senegal",731,8,6,4,3,1,2
"France",732,3,7,7,1,6,1
"Australia",732,3,6,3,3,0,2
"Costa Rica",732,5,7,6,4,2,1
"Brazil",732,5,6,5,3,2,2
"Mexico",732,6,7,4,2,2,1
"Germany",732,6,6,4,2,2,2
"Uruguay",733,1,7,7,3,4,1
"Russia",733,1,5,1,0,1,2
"Argentina",733,4,9,10,0,10,1
"Nigeria",733,4,6,3,5,-2,2
"Brazil",733,5,9,6,0,6,1
"Switzerland",733,5,4,3,4,-1,2
"South Korea",733,6,7,4,1,3,1
"Germany",733,6,6,6,1,5,2
"Belgium",733,7,7,5,0,5,1
"England",733,7,5,3,2,1,2
"Colombia",733,8,7,3,0,3,1
"Poland",733,8,5,4,3,1,2
"Russia",734,1,7,7,3,4,1
"Egypt",734,1,4,4,3,1,2
"Spain",734,2,7,6,3,3,1
"Morocco",734,2,6,3,3,0,2
"Peru",734,3,7,4,0,4,1
"Denmark",734,3,5,2,0,2,2
"Sweden",734,6,7,3,0,3,1
"Mexico",734,6,4,2,3,-1,2
"England",734,7,7,6,0,6,1
"Panama",734,7,6,2,5,-3,2
"Iran",735,2,5,5,2,3,1
"Morocco",735,2,4,2,4,-2,2
"France",735,3,7,7,5,2,1
"Peru",735,3,6,6,5,1,2
"Argentina",735,4,7,7,3,4,1
"Iceland",735,4,4,4,4,0,2
"Brazil",735,5,9,6,1,5,1
"Switzerland",735,5,4,3,4,-1,2
"England",735,7,7,4,1,3,1
"Tunisia",735,7,6,3,2,1,2
"Colombia",735,8,9,4,0,4,1
"Poland",735,8,4,3,2,1,2
"Uruguay",736,1,7,7,1,6,1
"Saudi Arabia",736,1,6,2,3,-1,2
"Portugal",736,2,9,6,3,3,1
"Spain",736,2,4,5,3,2,2
"England",736,7,9,5,0,5,1
"Belgium",736,7,6,7,6,1,2
"Colombia",736,8,7,9,1,8,1
"Japan",736,8,4,2,4,-2,2
"Uruguay",737,1,7,3,0,3,1
"Russia",737,1,5,3,2,1,2
"Portugal",737,2,7,5,3,2,1
"Morocco",737,2,5,3,2,1,2
"Brazil",737,5,7,6,0,6,1
"Costa Rica",737,5,6,5,4,1,2
"Belgium",737,7,7,6,3,3,1
"England",737,7,5,4,3,1,2
"Morocco",738,2,7,2,0,2,1
"Spain",738,2,4,4,3,1,2
"France",738,3,9,8,1,7,1
"Denmark",738,3,4,1,4,-3,2
"Argentina",738,4,7,4,2,2,1
"Croatia",738,4,5,4,2,2,2
"Brazil",738,5,9,4,0,4,1
"Costa Rica",738,5,4,4,4,0,2
"South Korea",738,6,7,6,2,4,1
"Germany",738,6,6,5,3,2,2
"England",738,7,6,6,2,4,1
"Panama",738,7,5,2,1,1,2
"Japan",738,8,7,3,0,3,1
"Senegal",738,8,5,2,1,1,2
"Portugal",739,2,9,8,0,8,1
"Spain",739,2,4,3,2,1,2
"Brazil",739,5,7,5,1,4,1
"Serbia",739,5,4,2,3,-1,2
"Japan",739,8,9,8,4,4,1
"Colombia",739,8,4,4,3,1,2
"Egypt",740,1,7,3,0,3,1
"Uruguay",740,1,5,4,2,2,2
"France",740,3,7,4,2,2,1
"Peru",740,3,4,2,1,1,2
"Brazil",740,5,7,9,3,6,1
"Costa Rica",740,5,4,6,5,1,2
"South Korea",740,6,9,5,1,4,1
"Germany",740,6,4,1,2,-1,2
"Panama",740,7,7,5,2,3,1
"England",740,7,6,10,4,6,2
"Senegal",740,8,9,6,2,4,1
"Japan",740,8,6,6,5,1,2
"Uruguay",741,1,7,2,0,2,1
"Egypt",741,1,4,1,1,0,2
"Iran",741,2,7,3,1,2,1
"Spain",741,2,6,4,3,1,2
"France",741,3,7,10,3,7,1
"Peru",741,3,6,5,7,-2,2
"Argentina",741,4,9,5,0,5,1
"Croatia",741,4,6,8,3,5,2
"Russia",742,1,7,6,3,3,1
"Saudi Arabia",742,1,5,7,6,1,2
"Spain",742,2,9,10,3,7,1
"Portugal",742,2,4,5,3,2,2
"Belgium",742,7,9,6,0,6,1
"England",742,7,6,4,2,2,2
"Japan",742,8,6,4,1,3,1
"Poland",742,8,5,2,1,1,2
"Egypt",743,1,7,5,1,4,1
"Uruguay",743,1,5,5,4,1,2
"France",743,3,9,6,1,5,1
"Peru",743,3,6,3,2,1,2
"Argentina",743,4,7,9,0,9,1
"Croatia",743,4,6,4,3,1,2
"Brazil",743,5,7,6,2,4,1
"Switzerland",743,5,5,3,2,1,2
"Mexico",743,6,9,6,2,4,1
"Germany",743,6,4,5,5,0,2
"Belgium",743,7,7,4,0,4,1
"Panama",743,7,4,3,4,-1,2
"Poland",743,8,9,6,2,4,1
"Colombia",743,8,6,4,3,1,2
"Russia",744,1,9,7,0,7,1
"Saudi Arabia",744,1,4,5,7,-2,2
"Iran",744,2,7,5,0,5,1
"Portugal",744,2,4,2,2,0,2
"Denmark",744,3,9,5,0,5,1
"France",744,3,4,4,1,3,2
"Poland",744,8,7,5,0,5,1
"Japan",744,8,4,4,4,0,2
"Portugal",745,2,5,2,1,1,1
"Iran",745,2,4,2,1,1,2
"France",745,3,7,4,2,2,1
"Denmark",745,3,6,3,2,1,2
"Nigeria",745,4,7,5,2,3,1
"Iceland",745,4,5,3,2,1,2
"South Korea",745,6,6,3,5,-2,1
"Mexico",745,6,5,6,2,4,2
"Tunisia",745,7,5,2,1,1,1
"England",745,7,4,2,2,0,2
"Poland",745,8,5,3,2,1,1
"Senegal",745,8,4,2,2,0,2
"Uruguay",746,1,9,7,1,6,1
"Russia",746,1,6,3,2,1,2
"Spain",746,2,7,4,1,3,1
"Iran",746,2,6,3,3,0,2
"Costa Rica",746,5,7,5,2,3,1
"Brazil",746,5,5,4,3,1,2
"South Korea",746,6,9,4,0,4,1
"Germany",746,6,6,6,1,5,2
"England",746,7,7,5,2,3,1
"Belgium",746,7,5,5,1,4,2
"Saudi Arabia",747,1,7,5,3,2,1
"Russia",747,1,4,2,1,1,2
"Portugal",747,2,7,5,2,3,1
"Iran",747,2,6,5,4,1,2
"Australia",747,3,7,4,1,3,1
"Denmark",747,3,3,2,2,0,2
"Argentina",747,4,9,8,2,6,1
"Croatia",747,4,4,4,2,2,2
"Uruguay",748,1,7,5,1,4,1
"Russia",748,1,6,4,3,1,2
"Spain",748,2,9,8,2,6,1
"Iran",748,2,6,6,2,4,2
"France",748,3,9,6,0,6,1
"Australia",748,3,4,4,4,0,2
"Argentina",748,4,9,4,0,4,1
"Croatia",748,4,4,5,4,1,2
"South Korea",748,6,7,5,3,2,1
"Sweden",748,6,3,3,3,0,2
"England",748,7,7,7,0,7,1
"Belgium",748,7,6,4,5,-1,2
"Uruguay",749,1,7,9,2,7,1
"Russia",749,1,4,3,2,1,2
"Iceland",749,4,7,4,2,2,1
"Argentina",749,4,6,4,1,3,2
"England",749,7,9,9,1,8,1
"Belgium",749,7,4,4,4,0,2
"Colombia",749,8,7,4,0,4,1
"Japan",749,8,3,3,3,0,2
"Russia",750,1,7,3,1,2,1
"Uruguay",750,1,6,4,2,2,2
"France",750,3,7,5,2,3,1
"Peru",750,3,6,3,2,1,2
"Serbia",750,5,6,2,1,1,1
"Brazil",750,5,5,2,1,1,2
"Uruguay",751,1,7,6,1,5,1
"Egypt",751,1,6,5,5,0,2
"Spain",751,2,9,10,3,7,1
"Portugal",751,2,6,4,4,0,2
"France",751,3,9,7,2,5,1
"Denmark",751,3,4,2,2,0,2
"Argentina",751,4,9,10,3,7,1
"Croatia",751,4,4,5,4,1,2
"South Korea",751,6,9,5,1,4,1
"Mexico",751,6,6,7,5,2,2
"England",751,7,7,4,1,3,1
"Panama",751,7,5,3,1,2,2
"Colombia",751,8,7,3,1,2,1
"Poland",751,8,6,2,1,1,2
"Uruguay",752,1,9,8,2,6,1
"Russia",752,1,6,6,2,4,2
"Spain",752,2,7,5,2,3,1
"Portugal",752,2,6,4,2,2,2
"Denmark",752,3,7,7,2,5,1
"France",752,3,6,6,1,5,2
"Argentina",752,4,9,7,1,6,1
"Nigeria",752,4,4,3,4,-1,2
"Brazil",752,5,9,3,0,3,1
"Costa Rica",752,5,6,2,1,1,2
"Germany",752,6,9,5,2,3,1
"Sweden",752,6,4,5,5,0,2
"England",752,7,7,9,1,8,1
"Belgium",752,7,5,3,1,2,2
"Poland",752,8,7,6,1,5,1
"Colombia",752,8,4,4,6,-2,2
"France",753,3,6,3,1,2,1
"Australia",753,3,5,2,1,1,2
"Costa Rica",753,5,5,6,4,2,1
"Serbia",753,5,4,6,7,-1,2
"South Korea",753,6,9,4,1,3,1
"Germany",753,6,4,3,3,0,2
"Belgium",753,7,7,5,2,3,1
"England",753,7,6,5,3,2,2
"Japan",753,8,9,7,3,4,1
"Colombia",753,8,6,9,5,4,2
"Russia",754,1,7,6,0,6,1
"Uruguay",754,1,5,7,4,3,2
"Spain",754,2,9,7,0,7,1
"Morocco",754,2,4,2,2,0,2
"France",754,3,7,5,1,4,1
"Peru",754,3,4,5,5,0,2
"Switzerland",754,5,9,9,1,8,1
"Brazil",754,5,6,5,1,4,2
"South Korea",754,6,7,3,1,2,1
"Germany",754,6,4,1,1,0,2
"Belgium",754,7,9,4,1,3,1
"England",754,7,4,1,1,0,2
"Uruguay",755,1,7,6,4,2,1
"Russia",755,1,6,10,5,5,2
"Iran",755,2,7,5,2,3,1
"Portugal",755,2,5,4,3,1,2
"Brazil",755,5,7,4,2,2,1
"Switzerland",755,5,5,2,1,1,2
"Uruguay",756,1,7,9,5,4,1
"Russia",756,1,6,6,3,3,2
"France",756,3,7,4,1,3,1
"Peru",756,3,6,4,3,1,2
"Iceland",756,4,9,5,1,4,1
"Argentina",756,4,6,4,2,2,2
"Brazil",756,5,9,5,2,3,1
"Costa Rica",756,5,4,4,4,0,2
"England",756,7,7,5,3,2,1
"Belgium",756,7,6,6,2,4,2
"Saudi Arabia",757,1,7,7,5,2,1
"Uruguay",757,1,3,4,4,0,2
"Croatia",757,4,9,6,2,4,1
"Argentina",757,4,6,9,3,6,2
"Brazil",757,5,9,6,1,5,1
"Switzerland",757,5,6,4,4,0,2
"Sweden",757,6,7,7,3,4,1
"Mexico",757,6,6,4,4,0,2
"Panama",757,7,7,5,2,3,1
"Belgium",757,7,5,3,2,1,2
"Iran",758,2,9,4,0,4,1
"Spain",758,2,6,7,2,5,2
"France",758,3,7,4,2,2,1
"Australia",758,3,5,3,2,1,2
"Switzerland",758,5,7,2,0,2,1
"Costa Rica",758,5,4,2,2,0,2
"Belgium",758,7,9,6,0,6,1
"England",758,7,6,4,2,2,2
"Japan",758,8,7,6,2,4,1
"Colombia",758,8,4,4,5,-1,2
"Uruguay",759,1,9,6,1,5,1
"Russia",759,1,6,7,2,5,2
"Spain",759,2,7,5,3,2,1
"Portugal",759,2,5,6,5,1,2
"Argentina",759,4,9,7,1,6,1
"Nigeria",759,4,4,2,1,1,2
"Costa Rica",759,5,7,5,2,3,1
"Switzerland",759,5,5,4,2,2,2
"Germany",759,6,9,6,0,6,1
"Sweden",759,6,4,1,2,-1,2
"England",759,7,9,7,3,4,1
"Belgium",759,7,6,6,3,3,2
"Poland",759,8,9,6,0,6,1
"Colombia",759,8,6,5,3,2,2
"Portugal",760,2,7,3,0,3,1
"Morocco",760,2,5,4,3,1,2
"Mexico",760,6,9,8,1,7,1
"Germany",760,6,6,8,5,3,2
"France",761,3,7,3,1,2,1
"Peru",761,3,6,3,2,1,2
"Switzerland",761,5,7,5,2,3,1
"Brazil",761,5,6,5,3,2,2
"Germany",761,6,6,4,2,2,1
"Mexico",761,6,5,3,2,1,2
"England",761,7,9,4,0,4,1
"Panama",761,7,4,2,2,0,2
"Japan",761,8,7,5,1,4,1
"Colombia",761,8,4,3,2,1,2
"Uruguay",762,1,9,5,0,5,1
"Saudi Arabia",762,1,4,3,3,0,2
"France",762,3,9,8,2,6,1
"Peru",762,3,6,4,2,2,2
"Argentina",762,4,7,4,1,3,1
"Iceland",762,4,5,6,3,3,2
"Switzerland",762,5,9,11,4,7,1
"Brazil",762,5,4,7,6,1,2
"Senegal",762,8,5,2,1,1,1
"Colombia",762,8,4,5,3,2,2
"Spain",763,2,9,6,2,4,1
"Portugal",763,2,4,6,4,2,2
"Peru",763,3,7,5,2,3,1
"France",763,3,6,9,4,5,2
"Germany",763,6,7,4,2,2,1
"Mexico",763,6,4,4,2,2,2
"Colombia",763,8,9,8,3,5,1
"Poland",763,8,6,5,3,2,2
"Portugal",764,2,7,6,3,3,1
"Spain",764,2,6,7,4,3,2
"South Korea",764,6,9,6,2,4,1
"Sweden",764,6,6,3,2,1,2
"Belgium",764,7,7,9,2,7,1
"England",764,7,6,4,3,1,2
"Uruguay",765,1,9,8,1,7,1
"Russia",765,1,6,2,1,1,2
"Spain",765,2,7,4,1,3,1
"Morocco",765,2,4,3,4,-1,2
"Brazil",765,5,9,12,3,9,1
"Switzerland",765,5,6,6,5,1,2
"Germany",765,6,7,6,2,4,1
"South Korea",765,6,6,7,4,3,2
"Tunisia",765,7,9,7,2,5,1
"Belgium",765,7,4,2,2,0,2
"Japan",765,8,9,3,0,3,1
"Colombia",765,8,6,6,3,3,2
"Egypt",766,1,6,2,1,1,1
"Uruguay",766,1,5,2,1,1,2
"Brazil",766,5,7,5,0,5,1
"Switzerland",766,5,6,7,4,3,2
"Germany",766,6,7,7,2,5,1
"Mexico",766,6,4,4,5,-1,2
"Belgium",766,7,7,3,1,2,1
"Panama",766,7,4,2,2,0,2
"Uruguay",767,1,7,9,6,3,1
"Russia",767,1,4,8,6,2,2
"Denmark",767,3,7,5,3,2,1
"France",767,3,4,4,3,1,2
"Germany",767,6,7,7,2,5,1
"South Korea",767,6,6,3,4,-1,2
"England",767,7,7,4,0,4,1
"Panama",767,7,6,4,3,1,2
"Poland",767,8,7,5,2,3,1
"Colombia",767,8,5,3,1,2,2
"Uruguay",768,1,9,12,3,9,1
"Saudi Arabia",768,1,4,2,8,-6,2
"France",768,3,6,6,5,1,1
"Peru",768,3,5,4,3,1,2
"Croatia",768,4,9,6,0,6,1
"Argentina",768,4,6,6,3,3,2
"Brazil",768,5,7,3,0,3,1
"Switzerland",768,5,5,3,2,1,2
"Mexico",768,6,7,3,1,2,1
"South Korea",768,6,6,4,2,2,2
"England",768,7,6,5,3,2,1
"Belgium",768,7,5,2,1,1,2
"Japan",768,8,7,6,2,4,1
"Poland",768,8,6,4,1,3,2
"Saudi Arabia",769,1,7,5,1,4,1
"Russia",769,1,4,1,1,0,2
"Croatia",769,4,7,4,2,2,1
"Iceland",769,4,5,6,5,1,2
"Brazil",769,5,7,2,0,2,1
"Costa Rica",769,5,6,4,2,2,2
"Germany",769,6,7,7,4,3,1
"Mexico",769,6,5,4,3,1,2
"Belgium",769,7,9,6,0,6,1
"England",769,7,6,5,2,3,2
"Senegal",769,8,7,9,5,4,1
"Japan",769,8,4,7,7,0,2
"Saudi Arabia",770,1,7,4,1,3,1
"Russia",770,1,5,1,0,1,2
"Brazil",770,5,7,3,1,2,1
"Costa Rica",770,5,4,3,3,0,2
"Belgium",770,7,9,7,2,5,1
"England",770,7,4,4,4,0,2
"Colombia",770,8,9,5,1,4,1
"Poland",770,8,6,4,3,1,2
"Uruguay",771,1,7,6,1,5,1
"Egypt",771,1,5,2,1,1,2
"Argentina",771,4,7,6,2,4,1
"Croatia",771,4,5,6,4,2,2
"Brazil",771,5,7,4,2,2,1
"Costa Rica",771,5,3,5,5,0,2
"Germany",771,6,7,4,1,3,1
"Sweden",771,6,5,1,0,1,2
"Senegal",771,8,7,4,2,2,1
"Colombia",771,8,6,4,2,2,2
"Uruguay",772,1,9,7,0,7,1
"Russia",772,1,4,4,4,0,2
"Iran",772,2,9,7,2,5,1
"Spain",772,2,4,7,4,3,2
"France",772,3,7,4,1,3,1
"Australia",772,3,4,4,4,0,2
"Croatia",772,4,7,5,2,3,1
"Nigeria",772,4,4,3,4,-1,2
"Serbia",772,5,7,7,5,2,1
"Brazil",772,5,5,7,5,2,2
"Mexico",772,6,7,6,4,2,1
"South Korea",772,6,6,6,4,2,2
"England",772,7,7,6,0,6,1
"Belgium",772,7,4,3,2,1,2
"Colombia",772,8,9,5,1,4,1
"Japan",772,8,4,5,2,3,2
"Uruguay",773,1,7,7,0,7,1
"Russia",773,1,6,4,3,1,2
"France",773,3,9,7,0,7,1
"Peru",773,3,4,5,3,2,2
"Argentina",773,4,7,5,2,3,1
"Croatia",773,4,6,5,4,1,2
"Germany",773,6,9,6,1,5,1
"Mexico",773,6,6,5,2,3,2
"Colombia",773,8,9,5,1,4,1
"Poland",773,8,6,6,3,3,2
"Portugal",774,2,9,11,0,11,1
"Iran",774,2,4,2,5,-3,2
"Iceland",774,4,7,7,3,4,1
"Croatia",774,4,5,5,4,1,2
"Costa Rica",774,5,7,4,1,3,1
"Brazil",774,5,4,1,3,-2,2
"Germany",774,6,7,4,0,4,1
"Mexico",774,6,4,3,2,1,2
"Panama",774,7,9,8,2,6,1
"Belgium",774,7,6,3,1,2,2
"Spain",775,2,7,4,0,4,1
"Portugal",775,2,5,3,1,2,2
"Argentina",775,4,7,4,0,4,1
"Croatia",775,4,4,3,1,2,2
"Brazil",775,5,7,6,2,4,1
"Serbia",775,5,4,2,4,-2,2
"Germany",775,6,9,7,1,6,1
"South Korea",775,6,6,6,5,1,2
"Poland",775,8,7,4,0,4,1
"Senegal",775,8,6,3,2,1,2
"Uruguay",776,1,7,3,1,2,1
"Egypt",776,1,6,2,1,1,2
"Iran",776,2,7,7,4,3,1
"Spain",776,2,6,4,3,1,2
"France",776,3,7,5,2,3,1
"Australia",776,3,6,4,3,1,2
"Croatia",776,4,7,2,0,2,1
"Argentina",776,4,6,6,2,4,2
"Mexico",776,6,9,8,1,7,1
"Germany",776,6,6,5,2,3,2
"Senegal",776,8,7,6,1,5,1
"Colombia",776,8,6,5,3,2,2
"Uruguay",777,1,7,5,3,2,1
"Egypt",777,1,6,5,3,2,2
"Argentina",777,4,9,7,2,5,1
"Croatia",777,4,4,4,4,0,2
"England",777,7,7,4,0,4,1
"Belgium",777,7,6,5,2,3,2
"Uruguay",778,1,7,6,2,4,1
"Saudi Arabia",778,1,4,5,5,0,2
"France",778,3,9,5,1,4,1
"Peru",778,3,4,1,1,0,2
"Croatia",778,4,9,7,2,5,1
"Argentina",778,4,6,3,2,1,2
"Mexico",778,6,7,5,0,5,1
"Germany",778,6,6,5,2,3,2
"England",778,7,7,4,2,2,1
"Belgium",778,7,6,5,4,1,2
"Colombia",778,8,7,4,1,3,1
"Poland",778,8,5,3,1,2,2
"Denmark",779,3,9,4,0,4,1
"Australia",779,3,4,2,2,0,2
"Costa Rica",779,5,7,4,1,3,1
"Brazil",779,5,6,4,3,1,2
"Germany",779,6,7,7,5,2,1
"Sweden",779,6,4,5,5,0,2
"England",779,7,9,10,1,9,1
"Panama",779,7,6,5,3,2,2
"Russia",780,1,7,5,1,4,1
"Uruguay",780,1,6,6,1,5,2
"Iran",780,2,9,7,1,6,1
"Morocco",780,2,4,1,3,-2,2
"Australia",780,3,7,3,1,2,1
"France",780,3,6,6,3,3,2
"Croatia",780,4,9,8,1,7,1
"Argentina",780,4,4,4,4,0,2
"Brazil",780,5,9,8,3,5,1
"Costa Rica",780,5,6,2,1,1,2
"South Korea",780,6,7,5,3,2,1
"Germany",780,6,6,6,2,4,2
"Belgium",780,7,7,4,0,4,1
"England",780,7,6,5,1,4,2
"Poland",780,8,7,6,1,5,1
"Senegal",780,8,4,3,6,-3,2
"Uruguay",781,1,9,6,0,6,1
"Egypt",781,1,4,4,4,0,2
"Portugal",781,2,9,6,1,5,1
"Iran",781,2,6,7,3,4,2
"Argentina",781,4,7,4,1,3,1
"Croatia",781,4,4,3,2,1,2
"Switzerland",781,5,6,2,2,0,1
"Costa Rica",781,5,5,3,1,2,2
"Poland",781,8,7,4,0,4,1
"Colombia",781,8,6,3,3,0,2
"Portugal",782,2,9,6,2,4,1
"Iran",782,2,6,4,2,2,2
"Argentina",782,4,9,6,2,4,1
"Nigeria",782,4,6,6,6,0,2
"Belgium",782,7,9,7,2,5,1
"England",782,7,6,8,6,2,2
"Colombia",782,8,9,6,0,6,1
"Japan",782,8,4,5,4,1,2
"Uruguay",783,1,7,3,1,2,1
"Russia",783,1,6,3,1,2,2
"Iceland",783,4,7,3,1,2,1
"Argentina",783,4,6,4,2,2,2
"Brazil",783,5,7,6,2,4,1
"Costa Rica",783,5,6,3,1,2,2
"Germany",783,6,7,6,2,4,1
"South Korea",783,6,6,4,2,2,2
"Belgium",783,7,9,8,2,6,1
"England",783,7,6,5,5,0,2
"Japan",783,8,9,7,1,6,1
"Colombia",783,8,4,3,2,1,2
"Peru",784,3,7,6,2,4,1
"France",784,3,6,5,5,0,2
"Argentina",784,4,7,5,0,5,1
"Croatia",784,4,6,2,1,1,2
"Switzerland",784,5,7,3,1,2,1
"Brazil",784,5,5,3,2,1,2
"England",784,7,9,8,0,8,1
"Belgium",784,7,6,4,3,1,2
"Colombia",784,8,7,2,0,2,1
"Poland",784,8,6,3,1,2,2
"Uruguay",785,1,9,7,2,5,1
"Egypt",785,1,6,7,4,3,2
"Croatia",785,4,7,3,1,2,1
"Argentina",785,4,5,3,1,2,2
"Brazil",785,5,7,3,1,2,1
"Switzerland",785,5,4,3,3,0,2
"England",785,7,7,5,3,2,1
"Belgium",785,7,6,7,3,4,2
"Colombia",785,8,9,7,0,7,1
"Japan",785,8,6,3,3,0,2
"Uruguay",786,1,7,6,0,6,1
"Russia",786,1,5,1,0,1,2
"Argentina",786,4,7,6,2,4,1
"Iceland",786,4,4,4,5,-1,2
"Brazil",786,5,7,4,1,3,1
"Costa Rica",786,5,5,2,1,1,2
"Germany",786,6,7,3,1,2,1
"Mexico",786,6,4,4,4,0,2
"Colombia",786,8,9,7,1,6,1
"Japan",786,8,6,4,1,3,2
"Uruguay",787,1,9,7,0,7,1
"Egypt",787,1,4,4,5,-1,2
"Croatia",787,4,7,6,1,5,1
"Argentina",787,4,5,5,4,1,2
"Switzerland",787,5,7,3,1,2,1
"Brazil",787,5,6,6,3,3,2
"Germany",787,6,7,4,1,3,1
"Mexico",787,6,4,3,2,1,2
"Senegal",787,8,5,4,2,2,1
"Colombia",787,8,4,2,3,-1,2
"Spain",788,2,9,5,1,4,1
"Iran",788,2,6,5,3,2,2
"Australia",788,3,7,6,4,2,1
"France",788,3,6,4,2,2,2
"Switzerland",788,5,7,3,1,2,1
"Costa Rica",788,5,6,4,2,2,2
"Mexico",788,6,7,5,1,4,1
"Germany",788,6,6,5,3,2,2
"Japan",788,8,7,4,2,2,1
"Poland",788,8,4,2,2,0,2
"Russia",789,1,9,5,2,3,1
"Uruguay",789,1,4,3,2,1,2
"Denmark",789,3,7,8,4,4,1
"France",789,3,5,4,3,1,2
"Brazil",789,5,9,7,0,7,1
"Costa Rica",789,5,4,4,3,1,2
"Mexico",789,6,7,4,2,2,1
"South Korea",789,6,4,5,5,0,2
"Belgium",789,7,7,5,1,4,1
"Panama",789,7,4,2,4,-2,2
"Uruguay",790,1,9,7,2,5,1
"Russia",790,1,6,5,4,1,2
"Iran",790,2,7,5,1,4,1
"Portugal",790,2,4,8,5,3,2
"Denmark",790,3,7,7,3,4,1
"Peru",790,3,4,3,2,1,2
"Poland",790,8,9,5,0,5,1
"Senegal",790,8,4,3,3,0,2
"Uruguay",791,1,9,4,0,4,1
"Egypt",791,1,4,1,1,0,2
"Iran",791,2,7,6,1,5,1
"Portugal",791,2,4,1,2,-1,2
"Australia",791,3,7,5,2,3,1
"Peru",791,3,5,4,3,1,2
"Argentina",791,4,9,8,2,6,1
"Croatia",791,4,4,5,5,0,2
"Colombia",791,8,7,5,1,4,1
"Poland",791,8,5,3,2,1,2
"Uruguay",792,1,9,6,2,4,1
"Saudi Arabia",792,1,4,3,2,1,2
"Spain",792,2,7,7,3,4,1
"Iran",792,2,5,4,3,1,2
"France",792,3,7,6,3,3,1
"Australia",792,3,5,4,3,1,2
"Brazil",792,5,7,6,2,4,1
"Costa Rica",792,5,4,5,6,-1,2
"Germany",792,6,7,8,3,5,1
"Sweden",792,6,4,4,5,-1,2
"Belgium",792,7,7,9,2,7,1
"England",792,7,5,7,4,3,2
"Uruguay",793,1,9,5,1,4,1
"Egypt",793,1,4,4,3,1,2
"Spain",793,2,7,7,4,3,1
"Portugal",793,2,5,8,3,5,2
"Peru",793,3,9,7,2,5,1
"France",793,3,6,6,5,1,2
"Argentina",793,4,7,3,1,2,1
"Iceland",793,4,6,5,4,1,2
"Belgium",793,7,6,6,4,2,1
"England",793,7,5,3,2,1,2
"Russia",794,1,7,4,2,2,1
"Saudi Arabia",794,1,4,3,2,1,2
"Portugal",794,2,9,10,6,4,1
"Iran",794,2,4,5,4,1,2
"Argentina",794,4,9,6,2,4,1
"Croatia",794,4,4,2,2,0,2
"Germany",794,6,9,7,2,5,1
"South Korea",794,6,4,4,4,0,2
"Colombia",794,8,7,7,4,3,1
"Poland",794,8,6,6,4,2,2
"Uruguay",795,1,6,3,2,1,1
"Russia",795,1,5,3,2,1,2
"Iran",795,2,7,5,1,4,1
"Portugal",795,2,6,3,3,0,2
"Croatia",795,4,7,5,2,3,1
"Argentina",795,4,5,3,2,1,2
"Brazil",795,5,7,4,0,4,1
"Switzerland",795,5,5,1,0,1,2
"Germany",795,6,7,6,1,5,1
"Mexico",795,6,4,3,2,1,2
"Uruguay",796,1,9,5,1,4,1
"Saudi Arabia",796,1,6,6,2,4,2
"Peru",796,3,9,4,0,4,1
"France",796,3,6,4,4,0,2
"Argentina",796,4,5,7,4,3,1
"Nigeria",796,4,4,3,5,-2,2
"Switzerland",796,5,7,4,2,2,1
"Brazil",796,5,4,3,2,1,2
"Germany",796,6,7,7,2,5,1
"Mexico",796,6,5,2,1,1,2
"Spain",797,2,9,9,3,6,1
"Iran",797,2,6,4,4,0,2
"Argentina",797,4,7,5,1,4,1
"Iceland",797,4,4,2,3,-1,2
"Brazil",797,5,9,8,0,8,1
"Switzerland",797,5,6,4,2,2,2
"South Korea",797,6,7,3,0,3,1
"Mexico",797,6,5,1,0,1,2
"Uruguay",798,1,7,8,4,4,1
"Egypt",798,1,6,7,7,0,2
"Spain",798,2,7,6,3,3,1
"Iran",798,2,4,5,5,0,2
"Croatia",798,4,9,7,2,5,1
"Iceland",798,4,4,1,2,-1,2
"Brazil",798,5,9,5,0,5,1
"Switzerland",798,5,6,5,2,3,2
"Belgium",798,7,9,12,4,8,1
"England",798,7,4,4,2,2,2
"Japan",798,8,7,4,1,3,1
"Poland",798,8,6,4,2,2,2
"Uruguay",799,1,7,6,2,4,1
"Saudi Arabia",799,1,4,4,3,1,2
"Peru",799,3,9,4,1,3,1
"France",799,3,6,6,2,4,2
"Belgium",799,7,9,4,0,4,1
"England",799,7,4,4,2,2,2
"Japan",799,8,9,3,0,3,1
"Poland",799,8,6,3,1,2,2
"Spain",800,2,9,5,1,4,1
"Portugal",800,2,6,3,3,0,2
"Croatia",800,4,6,6,4,2,1
"Argentina",800,4,5,5,3,2,2
"Switzerland",800,5,6,3,1,2,1
"Brazil",800,5,5,1,0,1,2
"Germany",800,6,7,5,0,5,1
"South Korea",800,6,4,2,3,-1,2
"Belgium",800,7,9,4,1,3,1
"England",800,7,4,3,3,0,2
"Uruguay",801,1,7,8,3,5,1
"Egypt",801,1,4,7,5,2,2
"Portugal",801,2,7,5,2,3,1
"Spain",801,2,6,7,2,5,2
"France",801,3,9,6,2,4,1
"Denmark",801,3,6,5,2,3,2
"Nigeria",801,4,7,7,4,3,1
"Croatia",801,4,4,4,5,-1,2
"Brazil",801,5,9,5,2,3,1
"Costa Rica",801,5,4,6,5,1,2
"Germany",801,6,9,7,2,5,1
"South Korea",801,6,6,4,3,1,2
"Poland",801,8,7,4,2,2,1
"Senegal",801,8,6,2,1,1,2
"Uruguay",802,1,9,4,0,4,1
"Russia",802,1,4,3,3,0,2
"Spain",802,2,9,6,2,4,1
"Portugal",802,2,4,7,5,2,2
"France",802,3,7,5,1,4,1
"Peru",802,3,4,6,6,0,2
"Argentina",802,4,7,7,2,5,1
"Croatia",802,4,4,3,2,1,2
"Germany",802,6,7,6,1,5,1
"Mexico",802,6,6,4,4,0,2
"England",802,7,9,8,2,6,1
"Belgium",802,7,4,3,3,0,2
"Egypt",803,1,7,5,3,2,1
"Uruguay",803,1,5,6,2,4,2
"Morocco",803,2,7,3,1,2,1
"Spain",803,2,5,2,0,2,2
"Peru",803,3,7,5,1,4,1
"Australia",803,3,5,3,1,2,2
"Nigeria",803,4,7,6,3,3,1
"Croatia",803,4,5,4,3,1,2
"Mexico",803,6,9,5,1,4,1
"Germany",803,6,6,3,1,2,2
"Belgium",803,7,9,6,0,6,1
"England",803,7,6,4,2,2,2
"Spain",804,2,9,8,1,7,1
"Portugal",804,2,6,6,6,0,2
"France",804,3,9,4,0,4,1
"Peru",804,3,6,5,2,3,2
"Brazil",804,5,7,5,2,3,1
"Switzerland",804,5,4,4,5,-1,2
"Belgium",804,7,7,7,2,5,1
"Tunisia",804,7,4,3,5,-2,2
"Poland",804,8,6,6,2,4,1
"Colombia",804,8,5,6,4,2,2
"Uruguay",805,1,7,6,3,3,1
"Russia",805,1,4,3,3,0,2
"Australia",805,3,7,5,3,2,1
"France",805,3,6,7,4,3,2
"Argentina",805,4,9,8,3,5,1
"Croatia",805,4,4,3,1,2,2
"Brazil",805,5,9,7,1,6,1
"Serbia",805,5,4,3,4,-1,2
"Belgium",805,7,6,9,2,7,1
"England",805,7,5,4,3,1,2
"Colombia",805,8,7,5,2,3,1
"Poland",805,8,4,3,4,-1,2
"Uruguay",806,1,5,1,0,1,1
"Saudi Arabia",806,1,4,2,2,0,2
"Argentina",806,4,9,8,1,7,1
"Iceland",806,4,6,3,2,1,2
"Switzerland",806,5,7,2,0,2,1
"Brazil",806,5,6,3,1,2,2
"Germany",806,6,7,5,3,2,1
"Sweden",806,6,4,4,2,2,2
"Japan",806,8,9,9,0,9,1
"Colombia",806,8,4,3,3,0,2
"Egypt",807,1,7,5,2,3,1
"Russia",807,1,5,4,2,2,2
"Spain",807,2,6,4,3,1,1
"Iran",807,2,5,1,0,1,2
"France",807,3,6,4,2,2,1
"Denmark",807,3,5,3,1,2,2
"Brazil",807,5,9,6,2,4,1
"Serbia",807,5,4,2,3,-1,2
"England",807,7,7,8,3,5,1
"Belgium",807,7,6,6,4,2,2
"Iran",808,2,9,7,2,5,1
"Spain",808,2,6,5,5,0,2
"France",808,3,9,5,1,4,1
"Peru",808,3,6,8,4,4,2
"Argentina",808,4,7,7,3,4,1
"Nigeria",808,4,4,1,3,-2,2
"Germany",808,6,7,3,1,2,1
"South Korea",808,6,5,7,5,2,2
"England",808,7,7,8,3,5,1
"Panama",808,7,4,4,5,-1,2
"Poland",808,8,7,5,3,2,1
"Japan",808,8,5,6,3,3,2
"Uruguay",809,1,9,5,1,4,1
"Saudi Arabia",809,1,4,4,3,1,2
"Portugal",809,2,7,5,1,4,1
"Spain",809,2,4,4,4,0,2
"France",809,3,7,8,4,4,1
"Australia",809,3,4,3,5,-2,2
"Russia",810,1,7,5,0,5,1
"Uruguay",810,1,5,3,2,1,2
"Spain",810,2,7,4,1,3,1
"Portugal",810,2,5,4,3,1,2
"France",810,3,9,5,1,4,1
"Peru",810,3,4,6,3,3,2
"Brazil",810,5,9,9,2,7,1
"Costa Rica",810,5,6,7,4,3,2
"Mexico",810,6,7,6,3,3,1
"South Korea",810,6,4,4,4,0,2
"Poland",810,8,9,8,3,5,1
"Japan",810,8,6,4,3,1,2
"Uruguay",811,1,9,8,1,7,1
"Saudi Arabia",811,1,6,3,3,0,2
"Portugal",811,2,7,9,4,5,1
"Spain",811,2,6,2,3,-1,2
"Croatia",811,4,5,3,2,1,1
"Argentina",811,4,4,6,2,4,2
"Egypt",812,1,6,4,5,-1,1
"Uruguay",812,1,5,5,2,3,2
"Argentina",812,4,9,7,0,7,1
"Croatia",812,4,4,5,2,3,2
"South Korea",812,6,7,4,2,2,1
"Germany",812,6,6,8,3,5,2
"Belgium",812,7,9,8,1,7,1
"Tunisia",812,7,6,2,3,-1,2
"Iran",813,2,7,5,3,2,1
"Spain",813,2,4,4,3,1,2
"Croatia",813,4,7,4,1,3,1
"Iceland",813,4,6,3,2,1,2
"Brazil",813,5,9,11,3,8,1
"Costa Rica",813,5,6,7,7,0,2
"South Korea",813,6,7,5,2,3,1
"Mexico",813,6,5,3,2,1,2
"Colombia",813,8,7,4,1,3,1
"Japan",813,8,6,4,3,1,2
"France",814,3,7,6,1,5,1
"Australia",814,3,5,3,1,2,2
"Iceland",814,4,7,5,0,5,1
"Argentina",814,4,5,1,0,1,2
"Brazil",814,5,7,4,1,3,1
"Serbia",814,5,6,5,2,3,2
"Germany",814,6,9,5,0,5,1
"Sweden",814,6,4,1,3,-2,2
"Japan",814,8,7,3,1,2,1
"Colombia",814,8,5,6,2,4,2
"Morocco",815,2,7,5,2,3,1
"Spain",815,2,5,2,1,1,2
"Peru",815,3,7,4,1,3,1
"France",815,3,5,3,2,1,2
"Croatia",815,4,7,5,3,2,1
"Iceland",815,4,5,5,3,2,2
"Brazil",815,5,7,3,1,2,1
"Costa Rica",815,5,6,7,3,4,2
"Germany",815,6,9,7,2,5,1
"South Korea",815,6,6,2,3,-1,2
"England",815,7,9,8,2,6,1
"Panama",815,7,6,5,3,2,2
"Uruguay",816,1,6,2,1,1,1
"Saudi Arabia",816,1,5,4,3,1,2
"Portugal",816,2,9,9,5,4,1
"Iran",816,2,6,5,4,1,2
"Croatia",816,4,7,3,0,3,1
"Argentina",816,4,6,6,1,5,2
"Brazil",816,5,7,6,3,3,1
"Costa Rica",816,5,5,6,4,2,2
"Panama",816,7,7,5,2,3,1
"Belgium",816,7,5,4,3,1,2
"Uruguay",817,1,7,5,3,2,1
"Russia",817,1,4,3,3,0,2
"Portugal",817,2,9,6,1,5,1
"Morocco",817,2,6,7,4,3,2
"France",817,3,9,10,4,6,1
"Australia",817,3,6,5,4,1,2
"Brazil",817,5,7,3,0,3,1
"Serbia",817,5,4,2,2,0,2
"Colombia",817,8,9,12,1,11,1
"Poland",817,8,4,3,4,-1,2
"France",818,3,7,7,3,4,1
"Peru",818,3,4,4,3,1,2
"Argentina",818,4,7,6,0,6,1
"Croatia",818,4,5,3,2,1,2
"Costa Rica",818,5,7,7,4,3,1
"Brazil",818,5,5,4,2,2,2
"Mexico",818,6,7,6,4,2,1
"Germany",818,6,6,4,1,3,2
"England",818,7,7,7,2,5,1
"Belgium",818,7,6,5,2,3,2
"Uruguay",819,1,7,6,2,4,1
"Egypt",819,1,6,4,4,0,2
"Spain",819,2,9,8,1,7,1
"Iran",819,2,4,7,5,2,2
"France",819,3,9,10,1,9,1
"Peru",819,3,4,2,3,-1,2
"Argentina",819,4,9,9,2,7,1
"Nigeria",819,4,4,6,7,-1,2
"Switzerland",819,5,7,6,3,3,1
"Brazil",819,5,4,3,3,0,2
"Belgium",819,7,9,5,0,5,1
"England",819,7,6,8,3,5,2
"Colombia",819,8,7,6,3,3,1
"Japan",819,8,4,3,2,1,2
"Saudi Arabia",820,1,6,4,3,1,1
"Uruguay",820,1,5,4,3,1,2
"Iran",820,2,9,5,1,4,1
"Spain",820,2,6,6,4,2,2
"France",820,3,9,11,3,8,1
"Denmark",820,3,6,6,5,1,2
"Nigeria",820,4,7,4,2,2,1
"Croatia",820,4,6,4,2,2,2
"Belgium",820,7,9,6,0,6,1
"Panama",820,7,4,4,3,1,2
"Russia",821,1,7,4,2,2,1
"Uruguay",821,1,4,3,2,1,2
"Spain",821,2,7,4,1,3,1
"Iran",821,2,4,3,3,0,2
"Croatia",821,4,6,6,3,3,1
"Nigeria",821,4,5,3,2,1,2
"Brazil",821,5,9,5,1,4,1
"Switzerland",821,5,4,3,3,0,2
"Poland",821,8,9,7,0,7,1
"Colombia",821,8,4,1,1,0,2
"Spain",822,2,7,3,0,3,1
"Portugal",822,2,6,3,2,1,2
"France",822,3,7,6,0,6,1
"Denmark",822,3,6,4,6,-2,2
"Argentina",822,4,7,6,2,4,1
"Iceland",822,4,6,5,4,1,2
"Costa Rica",822,5,7,6,4,2,1
"Brazil",822,5,5,5,2,3,2
"Russia",823,1,6,4,3,1,1
"Egypt",823,1,5,3,2,1,2
"Iran",823,2,7,5,1,4,1
"Spain",823,2,6,4,2,2,2
"Iceland",823,4,7,7,1,6,1
"Argentina",823,4,6,2,2,0,2
"Costa Rica",823,5,7,4,2,2,1
"Switzerland",823,5,6,4,1,3,2
"England",823,7,7,4,2,2,1
"Tunisia",823,7,5,6,5,1,2
"Colombia",823,8,9,7,1,6,1
"Poland",823,8,6,4,3,1,2
"Uruguay",824,1,9,7,1,6,1
"Russia",824,1,6,2,3,-1,2
"Portugal",824,2,9,7,1,6,1
"Iran",824,2,6,5,2,3,2
"France",824,3,6,3,4,-1,1
"Peru",824,3,5,3,0,3,2
"Argentina",824,4,7,7,4,3,1
"Iceland",824,4,6,5,2,3,2
"Mexico",824,6,9,6,3,3,1
"Germany",824,6,6,4,3,1,2
"England",824,7,9,9,3,6,1
"Belgium",824,7,6,7,3,4,2
"Poland",824,8,9,5,1,4,1
"Colombia",824,8,4,3,4,-1,2
"Uruguay",825,1,7,6,2,4,1
"Saudi Arabia",825,1,4,3,4,-1,2
"France",825,3,9,11,2,9,1
"Australia",825,3,6,7,6,1,2
"Nigeria",825,4,6,5,8,-3,1
"Argentina",825,4,5,6,1,5,2
"South Korea",825,6,7,6,2,4,1
"Germany",825,6,6,4,3,1,2
"Belgium",826,7,9,6,0,6,1
"England",826,7,6,6,2,4,2
"Poland",826,8,7,5,2,3,1
"Senegal",826,8,4,3,4,-1,2
"Spain",827,2,7,5,0,5,1
"Portugal",827,2,6,4,4,0,2
"Brazil",827,5,9,9,1,8,1
"Costa Rica",827,5,4,3,4,-1,2
"South Korea",827,6,9,6,1,5,1
"Mexico",827,6,6,5,3,2,2
"England",827,7,9,7,0,7,1
"Belgium",827,7,6,3,3,0,2
"Colombia",827,8,9,6,1,5,1
"Japan",827,8,4,2,2,0,2
"Egypt",828,1,9,4,0,4,1
"Uruguay",828,1,4,2,2,0,2
"Spain",828,2,9,7,2,5,1
"Iran",828,2,4,2,4,-2,2
"France",828,3,7,4,0,4,1
"Australia",828,3,6,4,2,2,2
"Croatia",828,4,7,10,3,7,1
"Argentina",828,4,5,1,0,1,2
"Switzerland",828,5,7,4,1,3,1
"Brazil",828,5,4,4,2,2,2
"England",828,7,7,5,1,4,1
"Panama",828,7,6,4,4,0,2
"Spain",829,2,7,3,0,3,1
"Iran",829,2,4,3,3,0,2
"France",829,3,9,7,0,7,1
"Denmark",829,3,4,2,5,-3,2
"Croatia",829,4,7,4,2,2,1
"Iceland",829,4,6,5,4,1,2
"Brazil",829,5,7,6,3,3,1
"Costa Rica",829,5,6,2,2,0,2
"Colombia",829,8,7,3,1,2,1
"Poland",829,8,5,4,3,1,2
"Uruguay",830,1,9,6,2,4,1
"Russia",830,1,4,2,2,0,2
"Spain",830,2,7,5,1,4,1
"Iran",830,2,6,3,2,1,2
"Brazil",830,5,7,5,3,2,1
"Switzerland",830,5,5,4,2,2,2
"Germany",830,6,7,5,1,4,1
"South Korea",830,6,6,4,2,2,2
"Belgium",830,7,7,4,2,2,1
"Panama",830,7,4,5,5,0,2
"Poland",830,8,7,4,1,3,1
"Japan",830,8,5,5,4,1,2
"Russia",831,1,9,5,0,5,1
"Uruguay",831,1,4,3,3,0,2
"Peru",831,3,6,5,3,2,1
"Australia",831,3,5,4,3,1,2
"Croatia",831,4,7,6,3,3,1
"Argentina",831,4,6,5,3,2,2
"Brazil",831,5,9,8,0,8,1
"Costa Rica",831,5,6,4,3,1,2
"Colombia",831,8,5,6,2,4,1
"Senegal",831,8,4,3,6,-3,2
"Portugal",832,2,7,4,0,4,1
"Spain",832,2,6,4,4,0,2
"Denmark",832,3,7,8,4,4,1
"France",832,3,5,4,2,2,2
"Argentina",832,4,7,3,0,3,1
"Croatia",832,4,5,3,1,2,2
"Costa Rica",832,5,9,3,0,3,1
"Brazil",832,5,4,4,2,2,2
"Mexico",832,6,7,3,1,2,1
"South Korea",832,6,6,5,2,3,2
"Belgium",832,7,7,9,2,7,1
"England",832,7,4,4,5,-1,2
"Senegal",832,8,9,7,2,5,1
"Colombia",832,8,6,3,2,1,2
"Russia",833,1,7,5,2,3,1
"Uruguay",833,1,6,3,1,2,2
"Spain",833,2,7,8,2,6,1
"Portugal",833,2,6,5,3,2,2
"Croatia",833,4,6,5,3,2,1
"Argentina",833,4,5,4,2,2,2
"Uruguay",834,1,7,3,1,2,1
"Egypt",834,1,6,5,2,3,2
"France",834,3,9,6,0,6,1
"Peru",834,3,4,3,3,0,2
"Germany",834,6,9,7,0,7,1
"Mexico",834,6,4,2,4,-2,2
"Spain",835,2,7,9,1,8,1
"Portugal",835,2,5,2,1,1,2
"Croatia",835,4,7,6,1,5,1
"Argentina",835,4,6,3,1,2,2
"Belgium",835,7,7,7,1,6,1
"England",835,7,5,5,1,4,2
"France",836,3,7,10,6,4,1
"Peru",836,3,6,4,4,0,2
"Argentina",836,4,7,4,1,3,1
"Iceland",836,4,6,5,1,4,2
"Brazil",836,5,7,5,3,2,1
"Switzerland",836,5,6,5,3,2,2
"Russia",837,1,7,5,0,5,1
"Egypt",837,1,5,3,2,1,2
"France",837,3,7,6,3,3,1
"Australia",837,3,5,5,4,1,2
"Nigeria",837,4,7,5,2,3,1
"Argentina",837,4,4,2,1,1,2
"England",837,7,7,5,1,4,1
"Belgium",837,7,4,6,5,1,2
"Japan",837,8,7,9,1,8,1
"Colombia",837,8,6,3,3,0,2
"Saudi Arabia",838,1,7,4,2,2,1
"Uruguay",838,1,6,5,3,2,2
"Australia",838,3,9,5,1,4,1
"Peru",838,3,6,5,4,1,2
"Argentina",838,4,7,5,2,3,1
"Iceland",838,4,4,4,4,0,2
"Brazil",838,5,9,5,0,5,1
"Costa Rica",838,5,6,4,3,1,2
"Japan",838,8,7,5,3,2,1
"Colombia",838,8,5,7,4,3,2
"Russia",839,1,7,7,4,3,1
"Saudi Arabia",839,1,4,2,2,0,2
"Portugal",839,2,7,2,0,2,1
"Iran",839,2,6,7,4,3,2
"Brazil",839,5,7,3,0,3,1
"Switzerland",839,5,4,1,1,0,2
"Japan",839,8,7,2,0,2,1
"Poland",839,8,4,4,2,2,2
"Saudi Arabia",840,1,7,2,0,2,1
"Uruguay",840,1,6,6,2,4,2
"Spain",840,2,6,5,3,2,1
"Portugal",840,2,5,6,4,2,2
"Australia",840,3,6,4,3,1,1
"France",840,3,5,3,1,2,2
"Brazil",840,5,9,12,1,11,1
"Costa Rica",840,5,4,6,9,-3,2
"England",840,7,7,3,0,3,1
"Belgium",840,7,4,2,2,0,2
"Uruguay",841,1,7,5,1,4,1
"Egypt",841,1,6,3,3,0,2
"France",841,3,9,5,0,5,1
"Australia",841,3,4,5,3,2,2
"Argentina",841,4,9,6,1,5,1
"Nigeria",841,4,6,2,1,1,2
"Germany",841,6,7,6,3,3,1
"Mexico",841,6,6,7,5,2,2
"France",842,3,7,4,1,3,1
"Denmark",842,3,4,3,3,0,2
"Brazil",842,5,7,7,3,4,1
"Costa Rica",842,5,5,4,3,1,2
"Germany",842,6,9,8,1,7,1
"Sweden",842,6,4,5,4,1,2
"Belgium",842,7,9,7,3,4,1
"England",842,7,4,7,4,3,2
"Uruguay",843,1,9,11,1,10,1
"Egypt",843,1,4,3,4,-1,2
"Iran",843,2,7,4,1,3,1
"Spain",843,2,5,4,0,4,2
"France",843,3,7,6,1,5,1
"Denmark",843,3,6,2,4,-2,2
"South Korea",843,6,9,6,1,5,1
"Germany",843,6,6,4,1,3,2
"England",843,7,9,7,2,5,1
"Belgium",843,7,6,7,5,2,2
"Spain",844,2,7,7,3,4,1
"Portugal",844,2,5,1,0,1,2
"France",844,3,7,2,0,2,1
"Peru",844,3,4,5,4,1,2
"Argentina",844,4,7,5,1,4,1
"Nigeria",844,4,4,2,4,-2,2
"Germany",844,6,9,5,2,3,1
"South Korea",844,6,6,6,4,2,2
"Belgium",844,7,9,11,3,8,1
"England",844,7,4,5,5,0,2
"Japan",844,8,9,5,0,5,1
"Poland",844,8,4,4,6,-2,2
"Portugal",845,2,7,5,0,5,1
"Iran",845,2,3,1,1,0,2
"Peru",845,3,9,8,2,6,1
"Denmark",845,3,4,4,4,0,2
"Argentina",845,4,9,10,0,10,1
"Iceland",845,4,6,4,4,0,2
"Costa Rica",845,5,7,4,2,2,1
"Brazil",845,5,5,2,1,1,2
"England",845,7,9,7,3,4,1
"Tunisia",845,7,6,6,5,1,2
"Colombia",845,8,9,6,2,4,1
"Poland",845,8,4,4,4,0,2
"Portugal",846,2,5,4,3,1,1
"Iran",846,2,4,2,2,0,2
"Croatia",846,4,9,4,1,3,1
"Argentina",846,4,6,4,3,1,2
"Germany",846,6,9,7,1,6,1
"Mexico",846,6,6,8,7,1,2
"Brazil",847,5,7,7,2,5,1
"Costa Rica",847,5,4,2,3,-1,2
"Mexico",847,6,9,4,1,3,1
"Germany",847,6,4,1,1,0,2
"Belgium",847,7,7,4,2,2,1
"England",847,7,5,7,4,3,2
"Spain",848,2,7,7,3,4,1
"Iran",848,2,4,2,2,0,2
"Nigeria",848,4,9,7,3,4,1
"Croatia",848,4,6,7,3,4,2
"Mexico",848,6,9,5,2,3,1
"Germany",848,6,4,4,2,2,2
"England",848,7,9,5,0,5,1
"Belgium",848,7,4,2,2,0,2
"Colombia",848,8,9,6,1,5,1
"Poland",848,8,4,2,2,0,2
"Russia",849,1,7,3,0,3,1
"Uruguay",849,1,6,6,5,1,2
"Spain",849,2,9,9,1,8,1
"Iran",849,2,6,5,5,0,2
"France",849,3,9,9,1,8,1
"Australia",849,3,6,4,2,2,2
"Brazil",849,5,9,9,2,7,1
"Serbia",849,5,6,4,2,2,2
"Germany",849,6,7,3,1,2,1
"Mexico",849,6,6,4,2,2,2
"England",849,7,7,5,2,3,1
"Tunisia",849,7,6,5,3,2,2
"Colombia",849,8,9,5,0,5,1
"Japan",849,8,6,3,2,1,2
"Uruguay",850,1,7,7,2,5,1
"Saudi Arabia",850,1,6,5,3,2,2
"Spain",850,2,7,5,2,3,1
"Portugal",850,2,6,6,3,3,2
"France",850,3,9,6,0,6,1
"Peru",850,3,4,2,2,0,2
"Mexico",850,6,9,5,0,5,1
"South Korea",850,6,6,4,4,0,2
"England",850,7,6,6,2,4,1
"Belgium",850,7,5,3,2,1,2
"Spain",851,2,7,5,2,3,1
"Portugal",851,2,4,2,2,0,2
"South Korea",851,6,7,3,1,2,1
"Sweden",851,6,6,3,1,2,2
"Japan",851,8,6,4,4,0,1
"Colombia",851,8,5,4,2,2,2
"Argentina",852,4,9,7,4,3,1
"Croatia",852,4,6,4,2,2,2
"Serbia",852,5,6,3,2,1,1
"Brazil",852,5,5,6,5,1,2
"Germany",852,6,7,10,1,9,1
"Mexico",852,6,4,4,3,1,2
"England",852,7,7,5,0,5,1
"Belgium",852,7,5,2,1,1,2
"Uruguay",853,1,9,5,1,4,1
"Russia",853,1,4,1,1,0,2
"Portugal",853,2,7,8,4,4,1
"Spain",853,2,6,4,3,1,2
"Peru",853,3,7,8,3,5,1
"France",853,3,5,4,2,2,2
"Brazil",853,5,9,5,2,3,1
"Costa Rica",853,5,6,4,3,1,2
"Mexico",853,6,7,4,2,2,1
"Germany",853,6,5,6,5,1,2
"Panama",853,7,9,8,4,4,1
"Tunisia",853,7,6,4,4,0,2
"Colombia",853,8,7,2,0,2,1
"Senegal",853,8,4,1,1,0,2
"Russia",854,1,7,5,2,3,1
"Uruguay",854,1,4,5,3,2,2
"Portugal",854,2,9,8,1,7,1
"Iran",854,2,6,2,2,0,2
"Peru",854,3,7,4,1,3,1
"France",854,3,5,3,1,2,2
"Germany",854,6,7,6,3,3,1
"Mexico",854,6,6,5,2,3,2
"Belgium",854,7,7,7,4,3,1
"England",854,7,6,4,1,3,2
"Iran",855,2,7,4,2,2,1
"Spain",855,2,6,3,2,1,2
"Brazil",855,5,9,9,2,7,1
"Costa Rica",855,5,6,4,3,1,2
"Mexico",855,6,9,6,1,5,1
"Germany",855,6,6,5,4,1,2
"Uruguay",856,1,7,6,1,5,1
"Egypt",856,1,4,5,5,0,2
"Peru",856,3,7,5,1,4,1
"Australia",856,3,4,2,3,-1,2
"Croatia",856,4,7,4,0,4,1
"Nigeria",856,4,5,2,1,1,2
"Germany",856,6,7,7,2,5,1
"Sweden",856,6,5,3,2,1,2
"England",856,7,7,5,2,3,1
"Panama",856,7,6,3,2,1,2
"Egypt",857,1,7,5,1,4,1
"Uruguay",857,1,5,4,1,3,2
"Spain",857,2,9,7,2,5,1
"Portugal",857,2,6,6,4,2,2
"Brazil",857,5,9,9,2,7,1
"Switzerland",857,5,6,8,5,3,2
"South Korea",857,6,7,4,1,3,1
"Mexico",857,6,6,3,2,1,2
"England",857,7,7,4,1,3,1
"Belgium",857,7,3,2,2,0,2
"Japan",857,8,7,7,1,6,1
"Poland",857,8,4,2,3,-1,2
"Spain",858,2,9,11,3,8,1
"Portugal",858,2,6,7,2,5,2
"France",858,3,7,5,2,3,1
"Australia",858,3,5,3,2,1,2
"Argentina",858,4,7,6,1,5,1
"Nigeria",858,4,3,2,2,0,2
"Switzerland",858,5,7,4,2,2,1
"Brazil",858,5,5,5,2,3,2
"Mexico",858,6,7,5,1,4,1
"Germany",858,6,5,4,3,1,2
"Russia",859,1,7,7,1,6,1
"Uruguay",859,1,5,3,2,1,2
"France",859,3,9,7,0,7,1
"Denmark",859,3,6,3,2,1,2
"Croatia",859,4,9,6,2,4,1
"Iceland",859,4,4,3,3,0,2
"Brazil",859,5,9,6,0,6,1
"Switzerland",859,5,4,2,1,1,2
"Mexico",859,6,7,3,1,2,1
"Germany",859,6,6,6,3,3,2
"Tunisia",859,7,7,4,1,3,1
"Belgium",859,7,5,5,3,2,2
"Colombia",859,8,7,9,3,6,1
"Japan",859,8,4,4,3,1,2
"Saudi Arabia",860,1,7,3,1,2,1
"Uruguay",860,1,5,3,2,1,2
"Iran",860,2,9,7,1,6,1
"Spain",860,2,6,7,5,2,2
"Australia",860,3,9,4,0,4,1
"France",860,3,4,4,3,1,2
"Argentina",860,4,7,5,2,3,1
"Iceland",860,4,6,4,3,1,2
"Costa Rica",860,5,9,7,0,7,1
"Brazil",860,5,6,8,2,6,2
"Colombia",860,8,7,2,0,2,1
"Poland",860,8,4,1,1,0,2
"Argentina",861,4,9,6,1,5,1
"Croatia",861,4,4,2,2,0,2
"Costa Rica",861,5,7,5,1,4,1
"Brazil",861,5,5,4,2,2,2
"Sweden",861,6,9,4,1,3,1
"South Korea",861,6,4,1,1,0,2
"Colombia",861,8,6,6,3,3,1
"Poland",861,8,5,5,4,1,2
"Uruguay",862,1,7,5,2,3,1
"Russia",862,1,5,3,2,1,2
"Iran",862,2,7,2,0,2,1
"Spain",862,2,4,3,3,0,2
"Peru",862,3,9,6,3,3,1
"France",862,3,4,5,3,2,2
"Argentina",862,4,9,4,1,3,1
"Nigeria",862,4,4,4,3,1,2
"Brazil",862,5,7,4,0,4,1
"Costa Rica",862,5,4,3,2,1,2
"South Korea",862,6,7,4,1,3,1
"Sweden",862,6,4,3,3,0,2
"Panama",862,7,7,5,2,3,1
"England",862,7,5,4,1,3,2
"Portugal",863,2,7,4,2,2,1
"Spain",863,2,5,4,2,2,2
"Croatia",863,4,7,4,0,4,1
"Argentina",863,4,6,6,6,0,2
"Switzerland",863,5,7,3,1,2,1
"Brazil",863,5,5,6,5,1,2
"Mexico",863,6,7,2,0,2,1
"Germany",863,6,5,2,0,2,2
"Belgium",863,7,9,6,1,5,1
"England",863,7,6,10,3,7,2
"Portugal",864,2,9,8,1,7,1
"Spain",864,2,6,5,3,2,2
"France",864,3,7,6,3,3,1
"Denmark",864,3,4,5,4,1,2
"Brazil",864,5,9,5,1,4,1
"Costa Rica",864,5,6,7,3,4,2
"Mexico",864,6,7,3,1,2,1
"Germany",864,6,6,4,3,1,2
"England",864,7,7,6,3,3,1
"Belgium",864,7,6,7,3,4,2
"Poland",864,8,6,3,2,1,1
"Colombia",864,8,5,3,2,1,2
"Egypt",865,1,7,6,2,4,1
"Uruguay",865,1,4,2,3,-1,2
"Iran",865,2,7,4,0,4,1
"Spain",865,2,5,4,3,1,2
"France",865,3,9,5,1,4,1
"Peru",865,3,6,4,3,1,2
"Brazil",865,5,9,6,2,4,1
"Switzerland",865,5,4,3,4,-1,2
"England",865,7,9,7,2,5,1
"Belgium",865,7,4,4,3,1,2
"Japan",865,8,7,2,0,2,1
"Poland",865,8,5,1,0,1,2
"Russia",866,1,7,4,2,2,1
"Saudi Arabia",866,1,6,6,2,4,2
"Argentina",866,4,7,6,3,3,1
"Croatia",866,4,6,6,1,5,2
"Switzerland",866,5,9,6,1,5,1
"Costa Rica",866,5,6,5,3,2,2
"Sweden",866,6,6,4,5,-1,1
"South Korea",866,6,5,4,1,3,2
"England",866,7,7,5,0,5,1
"Panama",866,7,4,3,3,0,2
"Portugal",867,2,9,4,0,4,1
"Iran",867,2,4,2,2,0,2
"France",867,3,9,5,1,4,1
"Peru",867,3,6,8,1,7,2
"Croatia",867,4,7,6,3,3,1
"Argentina",867,4,5,3,2,1,2
"Costa Rica",867,5,9,3,0,3,1
"Brazil",867,5,4,4,2,2,2
"Colombia",867,8,7,5,2,3,1
"Japan",867,8,4,4,4,0,2
"Russia",868,1,9,10,3,7,1
"Uruguay",868,1,4,6,4,2,2
"Peru",868,3,6,6,2,4,1
"France",868,3,5,4,3,1,2
"Argentina",868,4,7,7,2,5,1
"Nigeria",868,4,6,4,5,-1,2
"Brazil",868,5,7,3,1,2,1
"Switzerland",868,5,4,2,2,0,2
"Germany",868,6,7,4,1,3,1
"Mexico",868,6,6,3,2,1,2
"England",868,7,9,8,1,7,1
"Panama",868,7,6,4,4,0,2
"Uruguay",869,1,9,9,2,7,1
"Russia",869,1,4,3,2,1,2
"Portugal",869,2,7,4,2,2,1
"Spain",869,2,6,4,2,2,2
"Argentina",869,4,9,7,0,7,1
"Iceland",869,4,4,2,4,-2,2
"Brazil",869,5,9,7,1,6,1
"Costa Rica",869,5,6,5,2,3,2
"Colombia",869,8,9,6,1,5,1
"Poland",869,8,6,2,2,0,2
"Portugal",870,2,7,3,1,2,1
"Iran",870,2,5,7,2,5,2
"France",870,3,9,8,1,7,1
"Denmark",870,3,4,2,6,-4,2
"Switzerland",870,5,7,3,1,2,1
"Brazil",870,5,6,3,2,1,2
"Belgium",870,7,7,3,1,2,1
"Tunisia",870,7,6,4,2,2,2
"Egypt",871,1,6,4,3,1,1
"Uruguay",871,1,5,4,2,2,2
"Spain",871,2,9,5,1,4,1
"Iran",871,2,6,3,1,2,2
"Argentina",871,4,9,8,1,7,1
"Iceland",871,4,6,5,4,1,2
"Brazil",871,5,7,3,0,3,1
"Costa Rica",871,5,4,3,2,1,2
"Germany",871,6,6,4,2,2,1
"Mexico",871,6,5,4,3,1,2
"Belgium",871,7,9,11,3,8,1
"England",871,7,6,6,4,2,2
"France",872,3,9,7,2,5,1
"Peru",872,3,4,4,4,0,2
"Germany",872,6,7,5,1,4,1
"Mexico",872,6,5,5,4,1,2
"Belgium",872,7,7,7,4,3,1
"England",872,7,5,3,2,1,2
"Japan",872,8,7,10,6,4,1
"Poland",872,8,4,9,6,3,2
"Uruguay",873,1,7,6,4,2,1
"Egypt",873,1,5,3,2,1,2
"Spain",873,2,7,6,0,6,1
"Iran",873,2,5,3,0,3,2
"Iceland",873,4,7,6,2,4,1
"Croatia",873,4,5,7,2,5,2
"Sweden",873,6,7,5,1,4,1
"Germany",873,6,4,3,4,-1,2
"Colombia",873,8,7,7,3,4,1
"Japan",873,8,5,6,4,2,2
"Uruguay",874,1,6,4,1,3,1
"Saudi Arabia",874,1,5,3,2,1,2
"Portugal",874,2,9,5,1,4,1
"Spain",874,2,6,7,1,6,2
"France",874,3,9,4,0,4,1
"Denmark",874,3,4,1,1,0,2
"Brazil",874,5,7,8,2,6,1
"Switzerland",874,5,4,4,6,-2,2
"England",874,7,7,5,2,3,1
"Panama",874,7,4,2,2,0,2
"Uruguay",875,1,9,9,3,6,1
"Russia",875,1,4,4,4,0,2
"Spain",875,2,9,4,0,4,1
"Portugal",875,2,4,1,2,-1,2
"Australia",875,3,7,4,2,2,1
"France",875,3,4,3,2,1,2
"Croatia",875,4,7,4,0,4,1
"Argentina",875,4,5,7,0,7,2
"Costa Rica",875,5,9,6,1,5,1
"Switzerland",875,5,6,3,2,1,2
"Sweden",875,6,7,5,2,3,1
"Germany",875,6,6,2,2,0,2
"Belgium",875,7,7,4,2,2,1
"Tunisia",875,7,4,2,2,0,2
"Poland",875,8,9,6,1,5,1
"Japan",875,8,4,5,3,2,2
"Australia",876,3,7,3,0,3,1
"Denmark",876,3,3,3,3,0,2
"Argentina",876,4,7,7,3,4,1
"Iceland",876,4,5,5,4,1,2
"Sweden",876,6,6,4,3,1,1
"South Korea",876,6,5,5,3,2,2
"Belgium",876,7,6,6,1,5,1
"England",876,7,5,2,1,1,2
"Poland",876,8,6,3,3,0,1
"Colombia",876,8,5,5,3,2,2
"Uruguay",877,1,9,6,0,6,1
"Russia",877,1,4,3,3,0,2
"Spain",877,2,7,5,2,3,1
"Iran",877,2,5,3,1,2,2
"France",877,3,7,4,1,3,1
"Denmark",877,3,6,4,2,2,2
"Brazil",877,5,9,6,0,6,1
"Switzerland",877,5,4,2,2,0,2
"Germany",877,6,7,6,2,4,1
"South Korea",877,6,6,6,5,1,2
"Uruguay",878,1,7,4,2,2,1
"Russia",878,1,6,2,1,1,2
"Spain",878,2,5,6,4,2,1
"Morocco",878,2,4,4,5,-1,2
"Argentina",878,4,7,4,1,3,1
"Iceland",878,4,5,3,1,2,2
"Costa Rica",878,5,7,7,4,3,1
"Brazil",878,5,4,8,5,3,2
"Germany",878,6,9,7,0,7,1
"Mexico",878,6,6,7,3,4,2
"England",878,7,9,4,1,3,1
"Belgium",878,7,4,3,3,0,2
"Russia",879,1,7,5,1,4,1
"Uruguay",879,1,4,2,1,1,2
"Portugal",879,2,7,3,0,3,1
"Iran",879,2,6,8,2,6,2
"Argentina",879,4,9,10,3,7,1
"Iceland",879,4,4,9,8,1,2
"Brazil",879,5,9,7,1,6,1
"Costa Rica",879,5,6,4,2,2,2
"Mexico",879,6,9,4,0,4,1
"Germany",879,6,6,3,2,1,2
"England",879,7,9,6,2,4,1
"Belgium",879,7,6,4,2,2,2
"Saudi Arabia",880,1,7,5,1,4,1
"Russia",880,1,6,2,3,-1,2
"Portugal",880,2,7,4,2,2,1
"Iran",880,2,5,3,1,2,2
"Peru",880,3,9,7,2,5,1
"France",880,3,6,4,1,3,2
"Argentina",880,4,7,3,1,2,1
"Iceland",880,4,6,3,2,1,2
"Brazil",880,5,9,5,2,3,1
"Switzerland",880,5,4,3,3,0,2
"Germany",880,6,7,8,3,5,1
"South Korea",880,6,5,3,2,1,2
"England",880,7,7,8,4,4,1
"Panama",880,7,4,5,7,-2,2
"Uruguay",881,1,7,7,3,4,1
"Egypt",881,1,3,2,2,0,2
"Iran",881,2,7,3,0,3,1
"Portugal",881,2,5,1,0,1,2
"Argentina",881,4,7,8,1,7,1
"Iceland",881,4,4,4,4,0,2
"Uruguay",882,1,9,7,1,6,1
"Egypt",882,1,6,5,6,-1,2
"Iran",882,2,7,5,1,4,1
"Portugal",882,2,6,2,1,1,2
"England",882,7,7,6,0,6,1
"Panama",882,7,5,6,1,5,2
"France",883,3,9,11,2,9,1
"Peru",883,3,4,1,5,-4,2
"Brazil",883,5,7,4,0,4,1
"Switzerland",883,5,4,4,6,-2,2
"England",883,7,7,3,1,2,1
"Belgium",883,7,4,4,1,3,2
"Japan",883,8,7,4,1,3,1
"Colombia",883,8,6,4,2,2,2
"Portugal",884,2,6,9,3,6,1
"Spain",884,2,5,3,2,1,2
"France",884,3,9,4,1,3,1
"Peru",884,3,6,5,3,2,2
"Argentina",884,4,9,8,2,6,1
"Croatia",884,4,6,4,3,1,2
"Brazil",884,5,7,3,0,3,1
"Costa Rica",884,5,4,4,3,1,2
"Poland",884,8,7,4,1,3,1
"Senegal",884,8,4,4,5,-1,2
"Portugal",885,2,7,6,2,4,1
"Iran",885,2,4,3,3,0,2
"Argentina",885,4,7,6,4,2,1
"Croatia",885,4,4,4,5,-1,2
"Switzerland",885,5,7,5,2,3,1
"Costa Rica",885,5,5,4,2,2,2
"Japan",885,8,9,6,2,4,1
"Colombia",885,8,4,2,2,0,2
"Uruguay",886,1,9,6,0,6,1
"Russia",886,1,6,3,1,2,2
"Brazil",886,5,9,5,0,5,1
"Switzerland",886,5,6,6,2,4,2
"Iran",887,2,9,5,2,3,1
"Spain",887,2,4,5,3,2,2
"France",887,3,9,8,1,7,1
"Australia",887,3,4,1,1,0,2
"Costa Rica",887,5,7,5,1,4,1
"Brazil",887,5,6,6,2,4,2
"England",887,7,9,10,1,9,1
"Tunisia",887,7,4,6,9,-3,2
"Russia",888,1,7,6,3,3,1
"Egypt",888,1,6,5,4,1,2
"Peru",888,3,7,5,3,2,1
"France",888,3,6,5,3,2,2
"Argentina",888,4,9,6,0,6,1
"Nigeria",888,4,4,3,3,0,2
"Mexico",888,6,7,4,1,3,1
"South Korea",888,6,4,3,2,1,2
"Egypt",889,1,7,2,0,2,1
"Uruguay",889,1,6,7,3,4,2
"Portugal",889,2,7,3,0,3,1
"Spain",889,2,6,7,2,5,2
"France",889,3,7,6,2,4,1
"Peru",889,3,4,5,5,0,2
"Brazil",889,5,9,9,1,8,1
"Switzerland",889,5,4,6,4,2,2
"Germany",889,6,7,5,2,3,1
"Mexico",889,6,4,5,6,-1,2
"Belgium",889,7,6,3,3,0,1
"England",889,7,5,4,2,2,2
"Japan",889,8,9,6,0,6,1
"Colombia",889,8,6,6,2,4,2
"Spain",890,2,7,4,2,2,1
"Morocco",890,2,4,3,6,-3,2
"Croatia",890,4,7,6,3,3,1
"Argentina",890,4,5,5,3,2,2
"Brazil",890,5,9,9,1,8,1
"Costa Rica",890,5,6,2,2,0,2
"Germany",890,6,7,6,1,5,1
"South Korea",890,6,6,5,2,3,2
"England",890,7,9,11,0,11,1
"Belgium",890,7,6,3,1,2,2
"Uruguay",891,1,9,4,0,4,1
"Russia",891,1,4,3,3,0,2
"Portugal",891,2,9,6,1,5,1
"Spain",891,2,6,5,3,2,2
"Argentina",891,4,9,11,2,9,1
"Iceland",891,4,4,1,4,-3,2
"Mexico",891,6,7,4,2,2,1
"South Korea",891,6,6,4,2,2,2
"Belgium",891,7,7,7,2,5,1
"England",891,7,6,7,6,1,2
"Saudi Arabia",892,1,7,4,2,2,1
"Uruguay",892,1,4,5,4,1,2
"Iran",892,2,7,3,1,2,1
"Spain",892,2,6,4,1,3,2
"Costa Rica",892,5,7,5,3,2,1
"Brazil",892,5,5,5,2,3,2
"Germany",892,6,9,8,3,5,1
"Mexico",892,6,4,4,3,1,2
"England",892,7,5,3,1,2,1
"Tunisia",892,7,4,2,3,-1,2
"Colombia",892,8,7,6,2,4,1
"Poland",892,8,5,4,3,1,2
"Uruguay",893,1,7,4,2,2,1
"Saudi Arabia",893,1,6,4,1,3,2
"Iran",893,2,6,5,3,2,1
"Spain",893,2,5,5,4,1,2
"France",893,3,7,6,1,5,1
"Peru",893,3,6,7,3,4,2
"Croatia",893,4,7,3,1,2,1
"Argentina",893,4,4,4,3,1,2
"Brazil",893,5,9,8,0,8,1
"Costa Rica",893,5,4,3,5,-2,2
"France",894,3,9,9,2,7,1
"Peru",894,3,4,1,1,0,2
"Tunisia",894,7,6,2,3,-1,1
"Panama",894,7,5,5,2,3,2
"Russia",895,1,7,5,3,2,1
"Uruguay",895,1,6,4,3,1,2
"Brazil",895,5,9,12,1,11,1
"Costa Rica",895,5,4,5,6,-1,2
"South Korea",895,6,9,8,3,5,1
"Mexico",895,6,6,4,4,0,2
"Uruguay",896,1,9,6,1,5,1
"Russia",896,1,6,4,3,1,2
"Germany",896,6,9,4,1,3,1
"South Korea",896,6,4,4,4,0,2
"England",896,7,7,5,2,3,1
"Belgium",896,7,5,3,2,1,2
"Colombia",896,8,6,5,1,4,1
"Japan",896,8,5,4,3,1,2
"France",897,3,7,6,3,3,1
"Peru",897,3,4,4,2,2,2
"Croatia",897,4,9,6,2,4,1
"Iceland",897,4,4,3,2,1,2
"Brazil",897,5,7,7,2,5,1
"Switzerland",897,5,4,6,8,-2,2
"Belgium",897,7,7,8,3,5,1
"England",897,7,5,2,1,1,2
"Japan",897,8,7,6,0,6,1
"Colombia",897,8,5,1,0,1,2
"Russia",898,1,7,4,0,4,1
"Saudi Arabia",898,1,6,5,3,2,2
"France",898,3,9,5,1,4,1
"Australia",898,3,4,5,3,2,2
"Croatia",898,4,7,4,2,2,1
"Argentina",898,4,4,4,2,2,2
"Colombia",898,8,7,6,3,3,1
"Poland",898,8,5,5,4,1,2
"Russia",899,1,7,5,2,3,1
"Uruguay",899,1,4,1,1,0,2
"Portugal",899,2,7,6,3,3,1
"Spain",899,2,5,6,3,3,2
"France",899,3,7,5,2,3,1
"Denmark",899,3,4,2,3,-1,2
"Iceland",899,4,7,4,0,4,1
"Croatia",899,4,6,6,5,1,2
"Germany",899,6,7,6,2,4,1
"Mexico",899,6,6,5,1,4,2
"England",899,7,7,5,2,3,1
"Panama",899,7,6,6,3,3,2
"Egypt",900,1,7,4,1,3,1
"Uruguay",900,1,4,4,3,1,2
"Spain",900,2,7,5,2,3,1
"Portugal",900,2,6,3,1,2,2
"Australia",900,3,9,6,1,5,1
"France",900,3,4,3,3,0,2
"Argentina",900,4,9,13,2,11,1
"Nigeria",900,4,4,3,2,1,2
"Brazil",900,5,9,6,0,6,1
"Switzerland",900,5,4,2,3,-1,2
"Mexico",900,6,7,3,0,3,1
"South Korea",900,6,6,5,4,1,2
"England",900,7,7,6,1,5,1
"Belgium",900,7,5,2,1,1,2
"France",901,3,9,7,1,6,1
"Denmark",901,3,4,5,5,0,2
"Argentina",901,4,6,6,5,1,1
"Nigeria",901,4,5,3,2,1,2
"Costa Rica",901,5,7,4,1,3,1
"Brazil",901,5,6,6,4,2,2
"South Korea",901,6,9,5,2,3,1
"Germany",901,6,6,4,2,2,2
"Belgium",901,7,7,6,2,4,1
"Tunisia",901,7,4,2,2,0,2
"Russia",902,1,9,4,1,3,1
"Saudi Arabia",902,1,4,1,1,0,2
"Spain",902,2,7,8,5,3,1
"Portugal",902,2,5,5,3,2,2
"Argentina",902,4,7,4,2,2,1
"Croatia",902,4,6,5,4,1,2
"Brazil",902,5,7,6,1,5,1
"Serbia",902,5,4,4,6,-2,2
"England",902,7,7,3,1,2,1
"Belgium",902,7,5,4,2,2,2
"Egypt",903,1,7,7,3,4,1
"Uruguay",903,1,6,4,4,0,2
"Iran",903,2,7,4,1,3,1
"Spain",903,2,4,4,3,1,2
"France",903,3,9,7,1,6,1
"Peru",903,3,6,5,2,3,2
"Brazil",903,5,7,5,3,2,1
"Switzerland",903,5,6,6,2,4,2
"Russia",904,1,9,7,3,4,1
"Uruguay",904,1,6,4,3,1,2
"France",904,3,7,5,1,4,1
"Peru",904,3,5,5,1,4,2
"Brazil",904,5,7,5,1,4,1
"Switzerland",904,5,5,2,1,1,2
"Germany",904,6,7,6,3,3,1
"Sweden",904,6,4,4,4,0,2
"Colombia",904,8,6,9,8,1,1
"Poland",904,8,5,4,1,3,2
"Spain",905,2,7,7,3,4,1
"Iran",905,2,5,4,2,2,2
"France",905,3,6,7,2,5,1
"Peru",905,3,5,4,3,1,2
"Croatia",905,4,7,6,3,3,1
"Argentina",905,4,6,8,2,6,2
"Brazil",905,5,6,7,5,2,1
"Costa Rica",905,5,5,5,2,3,2
"England",905,7,7,8,4,4,1
"Belgium",905,7,6,3,3,0,2
"France",906,3,9,10,0,10,1
"Denmark",906,3,4,4,4,0,2
"Uruguay",907,1,9,4,0,4,1
"Egypt",907,1,4,4,4,0,2
"Spain",907,2,7,3,1,2,1
"Portugal",907,2,6,8,2,6,2
"Argentina",907,4,7,5,0,5,1
"Croatia",907,4,5,2,1,1,2
"Sweden",907,6,7,4,0,4,1
"Germany",907,6,4,1,3,-2,2
"Iran",908,2,7,5,3,2,1
"Spain",908,2,6,6,3,3,2
"France",908,3,7,4,0,4,1
"Denmark",908,3,6,6,3,3,2
"Argentina",908,4,7,4,1,3,1
"Croatia",908,4,5,6,3,3,2
"Brazil",908,5,6,8,6,2,1
"Costa Rica",908,5,5,4,2,2,2
"Belgium",908,7,7,4,1,3,1
"Panama",908,7,5,5,3,2,2
"Poland",908,8,6,4,2,2,1
"Colombia",908,8,5,5,3,2,2
"Uruguay",909,1,7,3,1,2,1
"Saudi Arabia",909,1,6,4,3,1,2
"Argentina",909,4,7,4,1,3,1
"Croatia",909,4,5,4,1,3,2
"Brazil",909,5,9,5,1,4,1
"Costa Rica",909,5,6,6,2,4,2
"South Korea",909,6,7,5,3,2,1
"Germany",909,6,6,9,3,6,2
"England",909,7,9,10,1,9,1
"Belgium",909,7,6,5,5,0,2
"Colombia",909,8,9,6,3,3,1
"Poland",909,8,6,4,3,1,2
"Russia",910,1,9,6,1,5,1
"Egypt",910,1,4,3,4,-1,2
"Iran",910,2,7,3,1,2,1
"Portugal",910,2,6,8,2,6,2
"Tunisia",910,7,7,3,1,2,1
"Panama",910,7,6,3,2,1,2
"Colombia",910,8,7,8,1,7,1
"Poland",910,8,4,1,4,-3,2
"Iran",911,2,7,9,2,7,1
"Morocco",911,2,6,4,5,-1,2
"France",911,3,9,5,0,5,1
"Australia",911,3,4,6,3,3,2
"Argentina",911,4,9,5,0,5,1
"Croatia",911,4,6,4,3,1,2
"Brazil",911,5,9,8,1,7,1
"Serbia",911,5,6,3,4,-1,2
"Mexico",911,6,7,5,1,4,1
"Germany",911,6,5,3,1,2,2
"England",911,7,7,8,3,5,1
"Belgium",911,7,5,4,3,1,2
"Colombia",911,8,6,3,2,1,1
"Japan",911,8,5,2,1,1,2
"Uruguay",912,1,9,5,0,5,1
"Saudi Arabia",912,1,4,2,4,-2,2
"Portugal",912,2,9,7,1,6,1
"Spain",912,2,6,5,3,2,2
"Uruguay",913,1,9,6,1,5,1
"Russia",913,1,4,3,3,0,2
"Iran",913,2,7,5,1,4,1
"Morocco",913,2,4,4,6,-2,2
"France",913,3,7,7,1,6,1
"Australia",913,3,4,2,5,-3,2
"Mexico",913,6,7,6,2,4,1
"Germany",913,6,5,7,2,5,2
"England",913,7,6,4,3,1,1
"Panama",913,7,5,2,1,1,2
"Poland",913,8,9,4,1,3,1
"Colombia",913,8,4,2,1,1,2
"France",914,3,9,6,1,5,1
"Peru",914,3,4,3,3,0,2
"Iceland",914,4,7,3,1,2,1
"Argentina",914,4,4,2,1,1,2
"Brazil",914,5,7,6,2,4,1
"Costa Rica",914,5,6,5,5,0,2
"Germany",914,6,9,6,1,5,1
"South Korea",914,6,6,3,2,1,2
"England",914,7,7,3,1,2,1
"Belgium",914,7,6,4,2,2,2
"Egypt",915,1,7,5,2,3,1
"Uruguay",915,1,5,3,2,1,2
"Australia",915,3,9,6,1,5,1
"France",915,3,4,6,4,2,2
"Argentina",915,4,9,6,1,5,1
"Croatia",915,4,6,3,1,2,2
"Egypt",916,1,7,5,3,2,1
"Uruguay",916,1,6,7,3,4,2
"Spain",916,2,7,3,1,2,1
"Iran",916,2,6,3,1,2,2
"Nigeria",916,4,7,3,1,2,1
"Argentina",916,4,5,3,2,1,2
"Brazil",916,5,9,10,3,7,1
"Costa Rica",916,5,4,3,3,0,2
"Belgium",916,7,9,7,1,6,1
"England",916,7,4,4,3,1,2
"Poland",916,8,9,5,1,4,1
"Colombia",916,8,6,7,6,1,2
"Spain",917,2,7,5,1,4,1
"Portugal",917,2,5,3,1,2,2
"Peru",917,3,7,4,2,2,1
"France",917,3,5,4,2,2,2
"Iceland",917,4,7,4,1,3,1
"Argentina",917,4,5,4,3,1,2
"Serbia",917,5,9,3,0,3,1
"Brazil",917,5,6,5,2,3,2
"Germany",917,6,9,7,0,7,1
"Mexico",917,6,4,3,4,-1,2
"Colombia",917,8,7,4,1,3,1
"Senegal",917,8,6,5,4,1,2
"Russia",918,1,7,5,2,3,1
"Uruguay",918,1,4,4,2,2,2
"Peru",918,3,9,12,2,10,1
"Denmark",918,3,6,3,8,-5,2
"Argentina",918,4,7,6,3,3,1
"Croatia",918,4,4,4,6,-2,2
"Brazil",918,5,7,5,3,2,1
"Switzerland",918,5,6,3,1,2,2
"South Korea",918,6,9,6,1,5,1
"Germany",918,6,6,5,3,2,2
"Belgium",918,7,7,3,1,2,1
"Tunisia",918,7,3,3,3,0,2
"Saudi Arabia",919,1,7,4,2,2,1
"Russia",919,1,5,5,2,3,2
"Peru",919,3,9,4,0,4,1
"Australia",919,3,4,3,2,1,2
"Iceland",919,4,6,4,3,1,1
"Argentina",919,4,5,4,2,2,2
"Costa Rica",919,5,9,6,2,4,1
"Switzerland",919,5,6,6,5,1,2
"Sweden",919,6,6,4,4,0,1
"Mexico",919,6,5,3,1,2,2
"England",919,7,9,7,2,5,1
"Belgium",919,7,6,5,3,2,2
"Russia",920,1,7,3,1,2,1
"Uruguay",920,1,4,4,3,1,2
"Spain",920,2,9,7,1,6,1
"Iran",920,2,4,2,5,-3,2
"Croatia",920,4,9,9,3,6,1
"Argentina",920,4,6,5,4,1,2
"South Korea",920,6,7,4,0,4,1
"Germany",920,6,6,3,2,1,2
"Belgium",920,7,7,6,3,3,1
"England",920,7,5,4,2,2,2
"Portugal",921,2,9,4,0,4,1
"Iran",921,2,6,2,1,1,2
"France",921,3,7,7,3,4,1
"Australia",921,3,6,9,9,0,2
"Argentina",921,4,7,7,1,6,1
"Croatia",921,4,6,4,3,1,2
"Mexico",921,6,7,6,1,5,1
"South Korea",921,6,5,3,1,2,2
"Belgium",921,7,7,4,0,4,1
"England",921,7,6,5,2,3,2
"Colombia",921,8,7,6,1,5,1
"Japan",921,8,5,7,3,4,2
"Iran",922,2,7,4,1,3,1
"Portugal",922,2,4,4,3,1,2
"Denmark",922,3,9,4,1,3,1
"France",922,3,4,5,5,0,2
"Brazil",922,5,9,9,2,7,1
"Switzerland",922,5,6,8,2,6,2
"Mexico",922,6,7,5,2,3,1
"Germany",922,6,4,4,4,0,2
"Belgium",922,7,7,5,2,3,1
"England",922,7,6,7,6,1,2
"Poland",922,8,7,6,3,3,1
"Japan",922,8,5,5,2,3,2
"Spain",923,2,6,3,2,1,1
"Iran",923,2,5,4,2,2,2
"Croatia",923,4,9,8,0,8,1
"Argentina",923,4,6,6,4,2,2
"Brazil",923,5,9,7,2,5,1
"Switzerland",923,5,6,8,5,3,2
"Belgium",923,7,7,6,3,3,1
"England",923,7,6,3,2,1,2
"Russia",924,1,9,5,0,5,1
"Egypt",924,1,4,4,4,0,2
"France",924,3,7,6,1,5,1
"Denmark",924,3,6,3,4,-1,2
"Croatia",924,4,9,10,1,9,1
"Argentina",924,4,4,5,3,2,2
"Germany",924,6,7,6,1,5,1
"South Korea",924,6,4,4,5,-1,2
"Belgium",924,7,7,5,0,5,1
"Panama",924,7,5,3,2,1,2
"Japan",924,8,7,4,2,2,1
"Colombia",924,8,5,2,0,2,2
"Russia",925,1,7,4,1,3,1
"Saudi Arabia",925,1,6,6,4,2,2
"Spain",925,2,9,7,0,7,1
"Portugal",925,2,4,8,7,1,2
"Croatia",925,4,9,7,1,6,1
"Argentina",925,4,6,6,3,3,2
"Brazil",925,5,9,9,3,6,1
"Serbia",925,5,4,2,2,0,2
"Germany",925,6,7,3,0,3,1
"Sweden",925,6,4,2,2,0,2
"Belgium",925,7,7,7,2,5,1
"Panama",925,7,3,5,5,0,2
"Japan",925,8,7,7,2,5,1
"Colombia",925,8,6,5,3,2,2
"Uruguay",926,1,7,6,3,3,1
"Russia",926,1,6,5,5,0,2
"France",926,3,9,10,3,7,1
"Peru",926,3,4,2,5,-3,2
"Costa Rica",926,5,9,6,1,5,1
"Brazil",926,5,4,3,4,-1,2
"Germany",926,6,7,3,1,2,1
"Mexico",926,6,5,3,0,3,2
"Belgium",926,7,9,5,0,5,1
"England",926,7,6,5,2,3,2
"Russia",927,1,6,5,5,0,1
"Egypt",927,1,5,5,3,2,2
"France",927,3,7,9,1,8,1
"Peru",927,3,4,3,3,0,2
"Argentina",927,4,7,3,1,2,1
"Iceland",927,4,5,6,4,2,2
"Mexico",927,6,7,5,3,2,1
"Germany",927,6,6,11,7,4,2
"England",927,7,9,7,2,5,1
"Belgium",927,7,6,5,4,1,2
"Poland",927,8,7,3,1,2,1
"Senegal",927,8,4,4,4,0,2
"Uruguay",928,1,9,8,1,7,1
"Russia",928,1,6,3,4,-1,2
"Iran",928,2,9,5,1,4,1
"Portugal",928,2,4,4,2,2,2
"Argentina",928,4,9,10,2,8,1
"Croatia",928,4,6,4,5,-1,2
"Brazil",928,5,7,3,1,2,1
"Costa Rica",928,5,6,7,2,5,2
"England",928,7,7,6,3,3,1
"Belgium",928,7,5,3,2,1,2
"Russia",929,1,7,7,5,2,1
"Egypt",929,1,4,4,4,0,2
"Belgium",929,7,7,7,1,6,1
"England",929,7,5,2,1,1,2
"Spain",930,2,7,7,2,5,1
"Morocco",930,2,4,1,2,-1,2
"France",930,3,9,8,2,6,1
"Peru",930,3,4,1,2,-1,2
"Japan",930,8,7,3,1,2,1
"Colombia",930,8,4,4,3,1,2
"France",931,3,7,7,3,4,1
"Australia",931,3,6,4,1,3,2
"Costa Rica",931,5,6,5,3,2,1
"Brazil",931,5,5,2,0,2,2
"Belgium",931,7,9,5,0,5,1
"England",931,7,6,3,1,2,2
"Spain",932,2,6,4,2,2,1
"Portugal",932,2,5,4,2,2,2
"France",932,3,7,5,2,3,1
"Peru",932,3,4,3,3,0,2
"Nigeria",932,4,7,4,1,3,1
"Croatia",932,4,6,5,3,2,2
"Costa Rica",932,5,9,4,0,4,1
"Switzerland",932,5,6,3,2,1,2
"Germany",932,6,7,9,5,4,1
"South Korea",932,6,5,5,4,1,2
"Tunisia",932,7,7,6,3,3,1
"Belgium",932,7,6,4,3,1,2
"Japan",932,8,9,6,1,5,1
"Poland",932,8,4,4,5,-1,2
"Spain",933,2,7,8,3,5,1
"Portugal",933,2,4,5,5,0,2
"France",933,3,9,12,2,10,1
"Peru",933,3,4,2,3,-1,2
"Argentina",933,4,7,7,3,4,1
"Iceland",933,4,4,4,4,0,2
"Brazil",933,5,7,4,2,2,1
"Costa Rica",933,5,4,5,3,2,2
"Germany",933,6,6,3,1,2,1
"Mexico",933,6,5,2,1,1,2
"Belgium",933,7,7,3,1,2,1
"Tunisia",933,7,4,1,1,0,2
"Poland",933,8,9,5,0,5,1
"Colombia",933,8,4,2,1,1,2
"Portugal",934,2,7,6,2,4,1
"Iran",934,2,5,6,2,4,2
"France",934,3,7,5,2,3,1
"Denmark",934,3,4,6,5,1,2
"Brazil",934,5,9,8,3,5,1
"Costa Rica",934,5,4,4,3,1,2
"Germany",934,6,9,8,1,7,1
"Mexico",934,6,6,3,3,0,2
"England",934,7,7,5,3,2,1
"Tunisia",934,7,5,5,4,1,2
"France",935,3,7,7,2,5,1
"Australia",935,3,6,5,4,1,2
"Argentina",935,4,9,6,1,5,1
"Croatia",935,4,6,6,3,3,2
"Costa Rica",935,5,9,8,4,4,1
"Brazil",935,5,6,4,3,1,2
"Mexico",935,6,9,4,1,3,1
"Germany",935,6,4,4,3,1,2
"England",935,7,6,3,1,2,1
"Panama",935,7,5,5,4,1,2
"Japan",935,8,9,7,0,7,1
"Colombia",935,8,6,4,1,3,2
"Iceland",936,4,7,3,1,2,1
"Argentina",936,4,5,3,2,1,2
"Uruguay",937,1,7,5,2,3,1
"Egypt",937,1,6,7,6,1,2
"Portugal",937,2,7,3,0,3,1
"Spain",937,2,6,3,2,1,2
"France",937,3,7,5,2,3,1
"Peru",937,3,4,6,5,1,2
"Croatia",937,4,7,4,0,4,1
"Nigeria",937,4,6,2,2,0,2
"Brazil",937,5,9,7,3,4,1
"Switzerland",937,5,4,4,4,0,2
"Mexico",937,6,7,5,2,3,1
"South Korea",937,6,6,4,3,1,2
"England",937,7,7,4,1,3,1
"Panama",937,7,5,2,1,1,2
"Colombia",937,8,7,4,2,2,1
"Poland",937,8,6,7,1,6,2
"Spain",938,2,7,7,2,5,1
"Iran",938,2,6,5,3,2,2
"France",938,3,7,3,1,2,1
"Peru",938,3,5,3,2,1,2
"Argentina",938,4,9,4,1,3,1
"Croatia",938,4,6,6,3,3,2
"Brazil",938,5,7,2,0,2,1
"Costa Rica",938,5,6,4,1,3,2
"Sweden",938,6,6,3,5,-2,1
"South Korea",938,6,5,4,0,4,2
"Belgium",938,7,9,7,2,5,1
"England",938,7,4,6,4,2,2
"Senegal",938,8,7,3,0,3,1
"Poland",938,8,4,3,3,0,2
"Saudi Arabia",939,1,9,7,3,4,1
"Uruguay",939,1,6,6,3,3,2
"Iran",939,2,7,6,2,4,1
"Spain",939,2,5,6,2,4,2
"Croatia",939,4,7,6,2,4,1
"Argentina",939,4,4,3,2,1,2
"England",939,7,7,4,0,4,1
"Belgium",939,7,4,2,2,0,2
"Japan",939,8,7,5,2,3,1
"Colombia",939,8,6,6,2,4,2
"Uruguay",940,1,7,4,0,4,1
"Egypt",940,1,6,4,4,0,2
"Portugal",940,2,7,3,0,3,1
"Spain",940,2,5,4,0,4,2
"England",940,7,7,7,1,6,1
"Belgium",940,7,4,3,2,1,2
"Poland",940,8,7,6,2,4,1
"Japan",940,8,3,2,2,0,2
"Uruguay",941,1,9,7,2,5,1
"Egypt",941,1,6,4,2,2,2
"Portugal",941,2,7,3,0,3,1
"Spain",941,2,6,3,1,2,2
"Argentina",941,4,9,7,3,4,1
"Nigeria",941,4,6,5,2,3,2
"Switzerland",941,5,7,4,1,3,1
"Brazil",941,5,6,5,3,2,2
"Germany",941,6,9,6,0,6,1
"Mexico",941,6,4,2,4,-2,2
"Belgium",941,7,5,3,2,1,1
"England",941,7,4,9,6,3,2
"Uruguay",942,1,7,5,2,3,1
"Saudi Arabia",942,1,6,5,3,2,2
"Argentina",942,4,9,8,1,7,1
"Croatia",942,4,6,6,6,0,2
"Costa Rica",942,5,7,6,4,2,1
"Brazil",942,5,6,9,3,6,2
"Belgium",942,7,9,10,2,8,1
"England",942,7,4,5,4,1,2
"Uruguay",943,1,7,7,1,6,1
"Russia",943,1,5,2,1,1,2
"Iran",943,2,9,7,3,4,1
"Portugal",943,2,6,7,5,2,2
"Argentina",943,4,7,7,2,5,1
"Croatia",943,4,5,3,2,1,2
"England",943,7,7,4,2,2,1
"Panama",943,7,5,4,2,2,2
"Poland",943,8,9,4,1,3,1
"Colombia",943,8,6,6,3,3,2
"Spain",944,2,7,5,1,4,1
"Iran",944,2,6,2,2,0,2
"France",944,3,7,6,1,5,1
"Australia",944,3,5,2,1,1,2
"Argentina",945,4,7,4,1,3,1
"Iceland",945,4,4,5,3,2,2
"Mexico",945,6,7,6,3,3,1
"Germany",945,6,4,4,3,1,2
"Japan",945,8,9,6,3,3,1
"Colombia",945,8,4,3,3,0,2
"Russia",946,1,6,2,1,1,1
"Egypt",946,1,5,3,2,1,2
"Portugal",946,2,7,3,1,2,1
"Spain",946,2,5,4,2,2,2
"France",946,3,7,7,2,5,1
"Denmark",946,3,5,5,3,2,2
"Serbia",946,5,7,5,0,5,1
"Brazil",946,5,6,4,2,2,2
"Colombia",946,8,7,6,3,3,1
"Japan",946,8,5,3,2,1,2
"Belgium",947,7,7,8,4,4,1
"England",947,7,6,4,2,2,2
"Saudi Arabia",948,1,7,6,4,2,1
"Egypt",948,1,6,4,3,1,2
"Portugal",948,2,7,6,2,4,1
"Spain",948,2,5,4,2,2,2
"Argentina",948,4,9,5,0,5,1
"Iceland",948,4,4,3,4,-1,2
"Mexico",948,6,9,6,1,5,1
"Sweden",948,6,4,4,5,-1,2
"England",948,7,7,4,2,2,1
"Belgium",948,7,6,5,3,2,2
"Japan",948,8,9,7,0,7,1
"Poland",948,8,6,7,3,4,2
"Spain",949,2,6,4,2,2,1
"Morocco",949,2,5,3,2,1,2
"Argentina",949,4,9,13,1,12,1
"Croatia",949,4,4,3,4,-1,2
"Brazil",949,5,7,6,2,4,1
"Switzerland",949,5,6,3,1,2,2
"England",949,7,7,5,2,3,1
"Belgium",949,7,6,9,3,6,2
"Colombia",949,8,7,9,2,7,1
"Senegal",949,8,4,3,4,-1,2
"Peru",950,3,7,3,1,2,1
"France",950,3,6,5,2,3,2
"Argentina",950,4,6,9,2,7,1
"Croatia",950,4,5,3,2,1,2
"Brazil",950,5,7,5,1,4,1
"Costa Rica",950,5,6,5,5,0,2
"Colombia",950,8,6,5,3,2,1
"Poland",950,8,5,4,2,2,2
"Russia",951,1,7,5,3,2,1
"Uruguay",951,1,5,4,2,2,2
"Portugal",951,2,7,8,4,4,1
"Spain",951,2,5,3,1,2,2
"Brazil",951,5,7,3,1,2,1
"Switzerland",951,5,6,5,4,1,2
"Belgium",951,7,9,4,0,4,1
"England",951,7,6,7,1,6,2
"Japan",951,8,9,7,1,6,1
"Poland",951,8,4,4,4,0,2
"Russia",952,1,7,2,0,2,1
"Uruguay",952,1,4,4,4,0,2
"England",952,7,9,8,1,7,1
"Belgium",952,7,4,5,3,2,2
"Colombia",952,8,9,6,0,6,1
"Poland",952,8,6,3,2,1,2
"Portugal",953,2,9,6,1,5,1
"Iran",953,2,4,2,2,0,2
"Argentina",953,4,7,5,0,5,1
"Iceland",953,4,4,3,4,-1,2
"Mexico",953,6,9,5,0,5,1
"South Korea",953,6,4,4,3,1,2
"Uruguay",954,1,9,7,0,7,1
"Russia",954,1,6,2,3,-1,2
"Spain",954,2,7,5,0,5,1
"Portugal",954,2,5,3,2,1,2
"Argentina",954,4,7,5,1,4,1
"Croatia",954,4,4,7,5,2,2
"Brazil",954,5,9,12,1,11,1
"Switzerland",954,5,4,4,4,0,2
"Russia",955,1,7,3,0,3,1
"Uruguay",955,1,4,3,2,1,2
"Spain",955,2,7,6,1,5,1
"Portugal",955,2,3,2,2,0,2
"France",955,3,7,4,1,3,1
"Australia",955,3,4,1,1,0,2
"Argentina",955,4,7,5,2,3,1
"Iceland",955,4,4,1,2,-1,2
"Brazil",955,5,9,5,0,5,1
"Costa Rica",955,5,6,4,3,1,2
"Belgium",955,7,9,8,3,5,1
"England",955,7,6,7,2,5,2
"Poland",955,8,9,5,0,5,1
"Japan",955,8,6,5,4,1,2
"Spain",956,2,7,6,1,5,1
"Iran",956,2,5,5,2,3,2
"Argentina",956,4,6,9,5,4,1
"Iceland",956,4,5,4,3,1,2
"Serbia",956,5,7,3,1,2,1
"Brazil",956,5,6,4,2,2,2
"Germany",956,6,7,6,2,4,1
"South Korea",956,6,4,4,3,1,2
"Belgium",956,7,9,6,1,5,1
"England",956,7,6,9,2,7,2
"Poland",956,8,6,5,5,0,1
"Colombia",956,8,5,3,0,3,2
"Uruguay",957,1,9,8,0,8,1
"Saudi Arabia",957,1,4,2,3,-1,2
"Iran",957,2,7,3,1,2,1
"Portugal",957,2,5,3,1,2,2
"Brazil",957,5,7,8,4,4,1
"Costa Rica",957,5,5,6,4,2,2
"Belgium",957,7,7,5,3,2,1
"England",957,7,6,6,3,3,2
"Spain",958,2,7,4,1,3,1
"Portugal",958,2,4,4,3,1,2
"France",958,3,7,5,1,4,1
"Australia",958,3,5,2,1,1,2
"Mexico",958,6,7,4,2,2,1
"South Korea",958,6,4,7,5,2,2
"England",958,7,7,4,1,3,1
"Panama",958,7,4,4,3,1,2
"Japan",958,8,6,4,2,2,1
"Colombia",958,8,5,3,2,1,2
"Spain",959,2,9,6,2,4,1
"Portugal",959,2,6,3,1,2,2
"France",959,3,7,6,3,3,1
"Denmark",959,3,6,3,2,1,2
"South Korea",959,6,7,7,2,5,1
"Germany",959,6,5,5,2,3,2
"England",959,7,9,9,3,6,1
"Panama",959,7,6,3,2,1,2
"Uruguay",960,1,9,4,0,4,1
"Saudi Arabia",960,1,4,3,3,0,2
"France",960,3,7,8,4,4,1
"Peru",960,3,4,2,2,0,2
"Argentina",960,4,6,4,4,0,1
"Croatia",960,4,5,6,4,2,2
"Poland",960,8,9,6,1,5,1
"Japan",960,8,6,4,2,2,2
"Portugal",961,2,7,6,2,4,1
"Spain",961,2,6,4,2,2,2
"France",961,3,9,5,1,4,1
"Peru",961,3,6,6,2,4,2
"Brazil",961,5,9,10,1,9,1
"Switzerland",961,5,6,5,1,4,2
"Germany",961,6,9,6,2,4,1
"South Korea",961,6,4,2,3,-1,2
"Belgium",961,7,6,6,3,3,1
"England",961,7,5,5,3,2,2
"Croatia",962,4,7,4,2,2,1
"Argentina",962,4,6,4,3,1,2
"Mexico",962,6,7,4,1,3,1
"Germany",962,6,5,3,2,1,2
"Uruguay",963,1,7,8,1,7,1
"Russia",963,1,5,5,2,3,2
"Spain",963,2,9,6,1,5,1
"Portugal",963,2,6,6,3,3,2
"France",963,3,7,4,1,3,1
"Peru",963,3,6,5,3,2,2
"Argentina",963,4,9,5,1,4,1
"Croatia",963,4,6,6,3,3,2
"Brazil",963,5,7,4,1,3,1
"Costa Rica",963,5,5,5,2,3,2
"Germany",963,6,9,8,2,6,1
"Mexico",963,6,6,5,3,2,2
"Panama",963,7,7,6,4,2,1
"Belgium",963,7,6,4,2,2,2
"Colombia",963,8,7,5,2,3,1
"Poland",963,8,6,5,2,3,2
"Uruguay",964,1,7,4,2,2,1
"Saudi Arabia",964,1,6,6,2,4,2
"France",964,3,9,10,2,8,1
"Peru",964,3,6,6,5,1,2
"Argentina",964,4,7,5,1,4,1
"Nigeria",964,4,6,5,2,3,2
"France",965,3,9,5,2,3,1
"Denmark",965,3,6,5,3,2,2
"Brazil",965,5,7,4,0,4,1
"Serbia",965,5,5,2,0,2,2
"Mexico",965,6,7,6,3,3,1
"Germany",965,6,4,3,4,-1,2
"Poland",965,8,7,3,0,3,1
"Colombia",965,8,6,5,1,4,2
"France",966,3,7,6,4,2,1
"Peru",966,3,4,4,4,0,2
"Brazil",966,5,9,9,2,7,1
"Switzerland",966,5,6,6,4,2,2
"Germany",966,6,9,5,2,3,1
"Mexico",966,6,6,6,4,2,2
"Belgium",966,7,9,7,1,6,1
"Panama",966,7,4,4,3,1,2
"Colombia",966,8,7,4,2,2,1
"Senegal",966,8,5,5,4,1,2
"Spain",967,2,9,7,2,5,1
"Iran",967,2,6,5,2,3,2
"Iceland",967,4,7,4,1,3,1
"Nigeria",967,4,4,6,6,0,2
"Brazil",967,5,9,10,1,9,1
"Costa Rica",967,5,4,4,9,-5,2
"Germany",967,6,7,4,0,4,1
"Sweden",967,6,4,1,2,-1,2
"Belgium",967,7,7,5,3,2,1
"England",967,7,6,4,3,1,2
"France",968,3,7,7,2,5,1
"Australia",968,3,4,4,4,0,2
"Sweden",968,6,7,5,2,3,1
"Germany",968,6,6,6,1,5,2
"England",968,7,7,6,2,4,1
"Belgium",968,7,4,5,5,0,2
"Croatia",969,4,9,7,2,5,1
"Argentina",969,4,6,3,2,1,2
"Germany",969,6,9,5,0,5,1
"Sweden",969,6,6,5,2,3,2
"Belgium",969,7,7,7,2,5,1
"England",969,7,5,6,5,1,2
"Japan",969,8,7,6,1,5,1
"Senegal",969,8,4,4,5,-1,2
"France",970,3,7,7,1,6,1
"Australia",970,3,6,4,5,-1,2
"Croatia",970,4,9,5,0,5,1
"Iceland",970,4,6,4,3,1,2
"Brazil",970,5,6,7,3,4,1
"Costa Rica",970,5,5,4,3,1,2
"South Korea",970,6,7,4,2,2,1
"Germany",970,6,5,2,1,1,2
"England",970,7,7,7,0,7,1
"Belgium",970,7,4,3,3,0,2
"Spain",971,2,9,6,0,6,1
"Iran",971,2,6,6,2,4,2
"Brazil",971,5,7,7,2,5,1
"Switzerland",971,5,6,4,4,0,2
"Mexico",971,6,7,6,2,4,1
"South Korea",971,6,6,5,3,2,2
"Uruguay",972,1,9,5,1,4,1
"Saudi Arabia",972,1,6,3,3,0,2
"Spain",972,2,7,5,2,3,1
"Iran",972,2,6,6,4,2,2
"France",972,3,9,12,0,12,1
"Australia",972,3,6,3,6,-3,2
"Brazil",972,5,6,6,5,1,1
"Costa Rica",972,5,5,3,2,1,2
"England",972,7,9,6,2,4,1
"Tunisia",972,7,6,3,2,1,2
"Poland",972,8,6,4,5,-1,1
"Japan",972,8,5,9,5,4,2
"Argentina",973,4,7,7,2,5,1
"Croatia",973,4,5,5,3,2,2
"Brazil",973,5,7,3,1,2,1
"Costa Rica",973,5,6,3,2,1,2
"England",973,7,9,7,2,5,1
"Panama",973,7,6,6,5,1,2
"Colombia",973,8,7,9,2,7,1
"Poland",973,8,6,4,4,0,2
"Argentina",974,4,7,3,0,3,1
"Iceland",974,4,4,4,4,0,2
"Brazil",974,5,7,5,1,4,1
"Costa Rica",974,5,4,3,3,0,2
"South Korea",974,6,9,6,2,4,1
"Germany",974,6,4,5,4,1,2
"Japan",974,8,7,5,2,3,1
"Colombia",974,8,5,2,1,1,2
"Uruguay",975,1,9,5,2,3,1
"Russia",975,1,4,1,1,0,2
"Portugal",975,2,7,5,1,4,1
"Spain",975,2,4,3,2,1,2
"France",975,3,9,6,2,4,1
"Australia",975,3,4,3,3,0,2
"Costa Rica",975,5,7,6,2,4,1
"Brazil",975,5,5,4,2,2,2
"South Korea",975,6,7,6,2,4,1
"Sweden",975,6,5,3,2,1,2
"Egypt",976,1,7,4,2,2,1
"Saudi Arabia",976,1,6,4,3,1,2
"France",976,3,7,5,1,4,1
"Peru",976,3,6,4,2,2,2
"Argentina",976,4,7,9,2,7,1
"Iceland",976,4,4,5,4,1,2
"Brazil",976,5,7,4,1,3,1
"Serbia",976,5,4,4,4,0,2
"England",976,7,9,7,0,7,1
"Belgium",976,7,4,2,3,-1,2
"Japan",976,8,7,5,1,4,1
"Colombia",976,8,6,5,1,4,2
"Uruguay",977,1,9,8,0,8,1
"Egypt",977,1,6,8,7,1,2
"Portugal",977,2,7,2,0,2,1
"Spain",977,2,6,4,1,3,2
"Argentina",977,4,7,5,0,5,1
"Nigeria",977,4,4,4,6,-2,2
"Germany",977,6,7,6,2,4,1
"Mexico",977,6,6,6,5,1,2
"Belgium",977,7,9,7,3,4,1
"England",977,7,6,5,2,3,2
"Poland",977,8,9,6,1,5,1
"Colombia",977,8,4,3,3,0,2
"Egypt",978,1,6,3,3,0,1
"Uruguay",978,1,5,5,2,3,2
"Iran",978,2,7,4,2,2,1
"Spain",978,2,4,3,2,1,2
"Argentina",978,4,7,5,3,2,1
"Iceland",978,4,6,6,5,1,2
"Brazil",978,5,9,11,2,9,1
"Costa Rica",978,5,6,3,2,1,2
"Belgium",978,7,7,5,2,3,1
"England",978,7,5,4,2,2,2
"Poland",978,8,7,5,0,5,1
"Japan",978,8,5,1,0,1,2
"Uruguay",979,1,7,8,2,6,1
"Egypt",979,1,4,3,5,-2,2
"Iran",979,2,7,5,3,2,1
"Spain",979,2,5,4,2,2,2
"Peru",979,3,7,4,0,4,1
"France",979,3,4,1,1,0,2
"Argentina",979,4,9,11,5,6,1
"Iceland",979,4,4,4,4,0,2
"England",979,7,7,3,0,3,1
"Belgium",979,7,4,5,6,-1,2
"Poland",979,8,9,7,1,6,1
"Colombia",979,8,6,4,1,3,2
"Egypt",980,1,6,4,2,2,1
"Uruguay",980,1,5,2,1,1,2
"France",980,3,7,7,1,6,1
"Denmark",980,3,4,1,2,-1,2
"Argentina",980,4,7,2,0,2,1
"Iceland",980,4,6,4,3,1,2
"Brazil",980,5,9,12,0,12,1
"Switzerland",980,5,6,6,5,1,2
"Mexico",980,6,7,4,2,2,1
"Germany",980,6,5,3,1,2,2
"Belgium",980,7,9,5,2,3,1
"Panama",980,7,4,2,2,0,2
"Colombia",980,8,9,5,1,4,1
"Poland",980,8,4,2,2,0,2
"Saudi Arabia",981,1,7,6,3,3,1
"Russia",981,1,4,5,5,0,2
"France",981,3,7,4,1,3,1
"Denmark",981,3,6,4,3,1,2
"Croatia",981,4,5,4,2,2,1
"Argentina",981,4,4,4,4,0,2
"Germany",981,6,7,3,0,3,1
"Mexico",981,6,6,2,1,1,2
"Belgium",981,7,7,3,0,3,1
"England",981,7,6,5,1,4,2
"Poland",981,8,7,3,1,2,1
"Colombia",981,8,4,4,4,0,2
"France",982,3,7,8,4,4,1
"Australia",982,3,6,7,5,2,2
"Nigeria",982,4,7,5,3,2,1
"Croatia",982,4,6,4,2,2,2
"Brazil",982,5,9,7,0,7,1
"Costa Rica",982,5,6,3,3,0,2
"Poland",982,8,9,7,3,4,1
"Colombia",982,8,6,5,4,1,2
"Spain",983,2,9,8,3,5,1
"Portugal",983,2,4,6,3,3,2
"France",983,3,9,6,0,6,1
"Denmark",983,3,4,1,2,-1,2
"Switzerland",983,5,7,4,2,2,1
"Brazil",983,5,5,5,3,2,2
"Belgium",983,7,7,4,1,3,1
"England",983,7,6,2,1,1,2
"Poland",983,8,7,4,2,2,1
"Senegal",983,8,5,6,4,2,2
"Portugal",984,2,6,7,4,3,1
"Spain",984,2,5,4,3,1,2
"Argentina",984,4,9,8,2,6,1
"Iceland",984,4,6,6,5,1,2
"Germany",984,6,7,6,4,2,1
"South Korea",984,6,5,3,2,1,2
"Belgium",984,7,7,5,2,3,1
"England",984,7,5,4,1,3,2
"Uruguay",985,1,7,5,2,3,1
"Egypt",985,1,6,4,3,1,2
"Argentina",985,4,9,9,0,9,1
"Croatia",985,4,4,3,5,-2,2
"Brazil",985,5,9,9,1,8,1
"Serbia",985,5,4,3,3,0,2
"Germany",985,6,9,10,2,8,1
"Mexico",985,6,6,5,6,-1,2
"England",985,7,7,8,5,3,1
"Belgium",985,7,5,6,3,3,2
"Egypt",986,1,7,4,1,3,1
"Uruguay",986,1,6,9,6,3,2
"Spain",986,2,7,4,1,3,1
"Morocco",986,2,4,3,2,1,2
"Brazil",986,5,7,6,2,4,1
"Switzerland",986,5,6,5,3,2,2
"England",986,7,9,9,1,8,1
"Belgium",986,7,6,4,4,0,2
"Poland",986,8,6,5,4,1,1
"Japan",986,8,5,5,3,2,2
"Uruguay",987,1,9,7,2,5,1
"Saudi Arabia",987,1,4,2,3,-1,2
"Iran",987,2,6,3,2,1,1
"Portugal",987,2,5,2,1,1,2
"Argentina",987,4,7,6,3,3,1
"Iceland",987,4,3,3,3,0,2
"Germany",987,6,9,9,1,8,1
"South Korea",987,6,6,4,2,2,2
"Belgium",987,7,7,5,3,2,1
"Panama",987,7,4,2,2,0,2
"Spain",988,2,6,4,2,2,1
"Iran",988,2,5,4,3,1,2
"Brazil",988,5,9,4,1,3,1
"Costa Rica",988,5,6,2,1,1,2
"Argentina",989,4,7,5,1,4,1
"Iceland",989,4,5,6,5,1,2
"Spain",990,2,7,8,3,5,1
"Iran",990,2,6,6,5,1,2
"Australia",990,3,7,5,1,4,1
"Peru",990,3,6,4,1,3,2
"Croatia",990,4,9,6,3,3,1
"Iceland",990,4,4,2,2,0,2
"Brazil",990,5,9,10,1,9,1
"Serbia",990,5,4,5,9,-4,2
"Germany",990,6,7,8,4,4,1
"Mexico",990,6,6,3,2,1,2
"Belgium",990,7,9,4,1,3,1
"England",990,7,6,5,3,2,2
"Japan",990,8,7,7,1,6,1
"Poland",990,8,6,5,4,1,2
"Uruguay",991,1,7,3,1,2,1
"Russia",991,1,5,1,0,1,2
"Serbia",991,5,7,4,1,3,1
"Switzerland",991,5,4,2,2,0,2
"England",991,7,9,6,2,4,1
"Belgium",991,7,4,4,3,1,2
"Colombia",991,8,7,5,3,2,1
"Japan",991,8,4,4,3,1,2
"Spain",992,2,7,6,3,3,1
"Portugal",992,2,6,9,4,5,2
"France",992,3,9,7,3,4,1
"Australia",992,3,4,5,5,0,2
"Croatia",992,4,7,8,3,5,1
"Argentina",992,4,6,7,2,5,2
"Sweden",992,6,6,3,2,1,1
"Mexico",992,6,5,3,1,2,2
"England",992,7,7,7,3,4,1
"Belgium",992,7,5,5,2,3,2
"Poland",992,8,7,4,2,2,1
"Colombia",992,8,6,4,1,3,2
"Iran",993,2,9,6,2,4,1
"Spain",993,2,6,6,1,5,2
"Argentina",993,4,9,7,2,5,1
"Croatia",993,4,4,4,4,0,2
"Serbia",993,5,7,11,7,4,1
"Brazil",993,5,5,5,4,1,2
"England",993,7,9,8,0,8,1
"Belgium",993,7,6,5,1,4,2
"Poland",993,8,7,8,2,6,1
"Colombia",993,8,4,3,4,-1,2
"Saudi Arabia",994,1,7,3,1,2,1
"Uruguay",994,1,4,5,2,3,2
"Iran",994,2,7,5,3,2,1
"Portugal",994,2,4,4,3,1,2
"France",994,3,9,4,1,3,1
"Australia",994,3,4,3,3,0,2
"Iceland",994,4,7,3,1,2,1
"Argentina",994,4,4,4,2,2,2
"England",994,7,9,7,1,6,1
"Belgium",994,7,4,3,4,-1,2
"Russia",995,1,7,4,1,3,1
"Egypt",995,1,4,3,3,0,2
"Spain",995,2,9,8,2,6,1
"Iran",995,2,6,7,5,2,2
"Peru",995,3,7,4,1,3,1
"Australia",995,3,4,3,3,0,2
"Argentina",995,4,7,7,2,5,1
"Croatia",995,4,6,3,3,0,2
"Serbia",995,5,9,4,1,3,1
"Brazil",995,5,6,5,3,2,2
"South Korea",995,6,7,5,3,2,1
"Mexico",995,6,6,6,3,3,2
"Iran",996,2,6,4,2,2,1
"Spain",996,2,5,3,2,1,2
"Iceland",996,4,7,3,1,2,1
"Argentina",996,4,5,4,2,2,2
"Belgium",996,7,7,6,3,3,1
"England",996,7,5,5,1,4,2
"Colombia",996,8,6,5,2,3,1
"Japan",996,8,5,5,3,2,2
"Portugal",997,2,9,5,0,5,1
"Spain",997,2,6,4,2,2,2
"Costa Rica",997,5,6,5,3,2,1
"Brazil",997,5,5,6,4,2,2
"Mexico",997,6,9,7,2,5,1
"Germany",997,6,4,7,6,1,2
"Belgium",997,7,7,6,2,4,1
"Tunisia",997,7,4,5,7,-2,2
"France",998,3,7,6,3,3,1
"Australia",998,3,6,3,2,1,2
"Argentina",998,4,9,7,1,6,1
"Nigeria",998,4,4,5,8,-3,2
"Brazil",998,5,7,5,3,2,1
"Switzerland",998,5,6,5,3,2,2
"Mexico",998,6,9,3,0,3,1
"Sweden",998,6,4,3,3,0,2
"England",998,7,7,4,2,2,1
"Belgium",998,7,5,4,3,1,2
"Japan",998,8,6,6,4,2,1
"Colombia",998,8,5,3,2,1,2
"Uruguay",999,1,7,6,0,6,1
"Egypt",999,1,3,1,1,0,2
"Portugal",999,2,9,6,1,5,1
"Spain",999,2,6,3,4,-1,2
"France",999,3,7,5,1,4,1
"Australia",999,3,6,5,3,2,2
"Croatia",999,4,7,6,3,3,1
"Argentina",999,4,5,3,2,1,2
"Switzerland",999,5,7,3,1,2,1
"Brazil",999,5,5,3,1,2,2
"Mexico",999,6,7,4,1,3,1
"Germany",999,6,5,5,4,1,2
"Belgium",999,7,9,7,2,5,1
"England",999,7,4,4,3,1,2
"Saudi Arabia",1000,1,7,6,3,3,1
"Uruguay",1000,1,6,6,5,1,2
"Brazil",1000,5,6,4,3,1,1
"Costa Rica",1000,5,5,5,3,2,2
"Belgium",1000,7,9,5,0,5,1
"England",1000,7,4,5,2,3,2
"Colombia",1000,8,7,7,2,5,1
"Poland",1000,8,6,8,3,5,2
"Switzerland",1,5,5,5,4,1,1
"Costa Rica",1,5,4,3,2,1,2
"France",2,3,6,4,2,2,1
"Denmark",2,3,4,2,2,0,2
"Brazil",2,5,7,7,3,4,1
"Switzerland",2,5,7,5,2,3,2
"Uruguay",3,1,7,6,3,3,2
"Russia",3,1,7,7,2,5,1
"Sweden",3,6,5,4,2,2,1
"Germany",3,6,5,3,2,1,2
"Belgium",3,7,6,3,2,1,2
"Tunisia",3,7,6,4,2,2,1
"Croatia",4,4,7,5,3,2,2
"Argentina",4,4,7,9,6,3,1
"Brazil",4,5,7,8,2,6,1
"Costa Rica",4,5,7,4,2,2,2
"Mexico",4,6,7,5,3,2,2
"Germany",4,6,7,5,1,4,1
"Colombia",4,8,5,6,3,3,1
"Japan",4,8,5,5,4,1,2
"Uruguay",5,1,6,5,2,3,1
"Saudi Arabia",5,1,6,3,3,0,2
"Spain",5,2,6,5,2,3,2
"Iran",5,2,6,8,3,5,1
"Iceland",5,4,6,4,2,2,1
"Nigeria",5,4,4,6,4,2,2
"Mexico",5,6,6,8,4,4,1
"Germany",5,6,6,4,6,-2,2
"Uruguay",6,1,7,7,3,4,1
"Russia",6,1,7,5,3,2,2
"Spain",6,2,5,3,1,2,1
"Iran",6,2,5,2,1,1,2
"Costa Rica",6,5,5,3,1,2,1
"Switzerland",6,5,4,2,2,0,2
"Croatia",9,4,9,7,4,3,1
"Iceland",9,4,3,5,4,1,2
"England",9,7,6,6,2,4,1
"Tunisia",9,7,4,3,2,1,2
"Japan",9,8,5,4,2,2,1
"Colombia",9,8,4,5,3,2,2
"Australia",12,3,6,5,4,1,1
"France",12,3,4,3,3,0,2
"Croatia",12,4,6,3,3,0,2
"Argentina",12,4,6,6,1,5,1
"Mexico",12,6,5,1,0,1,1
"South Korea",12,6,4,3,1,2,2
"Belgium",12,7,7,5,2,3,1
"England",12,7,7,5,3,2,2
"Russia",13,1,6,4,2,2,1
"Uruguay",13,1,4,5,3,2,2
"Belgium",13,7,7,8,5,3,1
"England",13,7,4,8,7,1,2
"France",14,3,6,5,2,3,1
"Peru",14,3,6,2,1,1,2
"Poland",14,8,9,10,3,7,1
"Japan",14,8,3,2,3,-1,2
"Uruguay",15,1,5,3,2,1,1
"Russia",15,1,4,5,2,3,2
"Argentina",15,4,7,8,1,7,1
"Croatia",15,4,4,3,5,-2,2
"Brazil",15,5,6,5,3,2,2
"Costa Rica",15,5,6,6,3,3,1
"Uruguay",17,1,5,2,1,1,2
"Egypt",17,1,5,5,2,3,1
"France",17,3,6,6,4,2,2
"Denmark",17,3,6,8,5,3,1
"England",17,7,5,4,3,1,1
"Tunisia",17,7,4,5,3,2,2
"Senegal",17,8,6,4,4,0,2
"Poland",17,8,6,7,3,4,1
"South Korea",18,6,7,8,3,5,1
"Germany",18,6,7,7,3,4,2
"Poland",18,8,6,3,2,1,1
"Colombia",18,8,4,3,2,1,2
"England",20,7,7,8,4,4,1
"Belgium",20,7,4,6,3,3,2
"Poland",21,8,6,3,3,0,1
"Japan",21,8,4,4,3,1,2
"France",22,3,9,7,2,5,1
"Peru",22,3,4,3,2,1,2
"Mexico",22,6,6,6,4,2,2
"Germany",22,6,6,10,3,7,1
"Spain",23,2,5,4,1,3,1
"Portugal",23,2,5,5,3,2,2
"Peru",23,3,6,4,3,1,1
"Australia",23,3,4,4,3,1,2
"Belgium",23,7,6,7,3,4,1
"England",23,7,6,5,6,-1,2
"Spain",24,2,7,5,2,3,2
"Iran",24,2,7,8,0,8,1
"Mexico",24,6,7,6,3,3,2
"South Korea",24,6,7,4,0,4,1
"Uruguay",25,1,7,3,0,3,1
"Egypt",25,1,4,3,2,1,2
"Portugal",25,2,6,4,2,2,2
"Iran",25,2,6,8,5,3,1
"Brazil",25,5,7,9,4,5,1
"Switzerland",25,5,4,6,6,0,2
"Uruguay",26,1,5,4,1,3,1
"Saudi Arabia",26,1,5,2,1,1,2
"Spain",26,2,9,6,1,5,1
"Iran",26,2,2,3,4,-1,2
"Uruguay",27,1,7,5,0,5,2
"Russia",27,1,7,7,1,6,1
"Belgium",27,7,9,7,2,5,1
"Panama",27,7,3,4,5,-1,2
"Colombia",27,8,6,4,3,1,2
"Japan",27,8,6,6,4,2,1
"Portugal",28,2,5,6,3,3,1
"Iran",28,2,5,4,2,2,2
"Brazil",28,5,7,6,1,5,1
"Serbia",28,5,4,4,3,1,2
"Spain",29,2,4,4,2,2,1
"Morocco",29,2,4,2,2,0,2
"Germany",29,6,6,8,2,6,1
"Mexico",29,6,4,4,4,0,2
"Belgium",29,7,5,2,1,1,1
"England",29,7,4,5,3,2,2
"Colombia",29,8,9,10,1,9,1
"Poland",29,8,4,2,3,-1,2
"Spain",30,2,7,5,3,2,2
"Iran",30,2,7,6,3,3,1
"France",30,3,7,6,0,6,1
"Peru",30,3,4,1,1,0,2
"Colombia",31,8,6,5,5,0,1
"Poland",31,8,4,4,2,2,2
"Saudi Arabia",32,1,6,5,2,3,1
"Egypt",32,1,6,4,3,1,2
"Argentina",32,4,6,5,3,2,1
"Croatia",32,4,4,4,3,1,2
"Belgium",32,7,9,10,2,8,1
"England",32,7,3,4,5,-1,2
"Poland",32,8,7,4,0,4,1
"Colombia",32,8,4,4,3,1,2
"Croatia",34,4,7,2,0,2,1
"Argentina",34,4,4,4,1,3,2
"Colombia",34,8,7,2,0,2,1
"Japan",34,8,4,4,2,2,2
"Portugal",35,2,6,7,5,2,2
"Iran",35,2,6,6,3,3,1
"Portugal",36,2,9,7,3,4,1
"Iran",36,2,3,7,5,2,2
"France",36,3,6,7,5,2,1
"Australia",36,3,4,6,6,0,2
"Sweden",36,6,6,2,1,1,2
"Germany",36,6,6,6,2,4,1
"England",36,7,6,2,1,1,2
"Panama",36,7,6,4,2,2,1
"Spain",37,2,7,5,1,4,1
"Portugal",37,2,4,2,2,0,2
"Brazil",38,5,7,7,1,6,1
"Costa Rica",38,5,7,7,3,4,2
"Mexico",38,6,6,5,4,1,1
"South Korea",38,6,4,5,4,1,2
"Spain",39,2,5,3,1,2,1
"Portugal",39,2,5,2,1,1,2
"Mexico",39,6,6,5,5,0,1
"Germany",39,6,4,4,3,1,2
"Iran",40,2,5,5,4,1,1
"Portugal",40,2,4,5,3,2,2
"Switzerland",40,5,6,5,6,-1,1
"Brazil",40,5,4,4,1,3,2
"South Korea",40,6,7,5,2,3,2
"Germany",40,6,7,5,1,4,1
"Uruguay",41,1,6,3,4,-1,1
"Saudi Arabia",41,1,4,4,3,1,2
"Croatia",41,4,6,3,2,1,1
"Argentina",41,4,4,2,1,1,2
"Brazil",42,5,7,4,1,3,2
"Costa Rica",42,5,7,4,0,4,1
"Belgium",42,7,7,4,2,2,2
"England",42,7,7,6,3,3,1
"Japan",42,8,6,4,2,2,1
"Colombia",42,8,4,3,1,2,2
"Croatia",43,4,6,4,4,0,2
"Argentina",43,4,6,5,3,2,1
"Uruguay",44,1,7,7,5,2,2
"Russia",44,1,7,3,0,3,1
"Colombia",44,8,9,7,3,4,1
"Poland",44,8,4,3,2,1,2
"Russia",45,1,6,5,4,1,1
"Saudi Arabia",45,1,4,2,3,-1,2
"Spain",45,2,9,7,3,4,1
"Portugal",45,2,4,6,5,1,2
"Peru",45,3,6,5,3,2,1
"France",45,3,4,4,3,1,2
"Croatia",45,4,9,7,2,5,1
"Argentina",45,4,4,2,2,0,2
"Brazil",45,5,9,5,2,3,1
"Serbia",45,5,4,3,2,1,2
"Panama",45,7,6,3,2,1,1
"Belgium",45,7,4,4,1,3,2
"Spain",47,2,5,7,4,3,1
"Portugal",47,2,5,4,3,1,2
"Denmark",47,3,6,6,5,1,2
"Australia",47,3,6,6,4,2,1
"Nigeria",47,4,5,5,3,2,1
"Argentina",47,4,4,4,4,0,2
"Colombia",47,8,7,5,2,3,2
"Poland",47,8,7,6,1,5,1
"Uruguay",49,1,6,3,2,1,2
"Russia",49,1,6,5,2,3,1
"Spain",49,2,6,5,2,3,1
"Iran",49,2,4,3,3,0,2
"France",49,3,9,7,2,5,1
"Peru",49,3,4,2,1,1,2
"Argentina",49,4,7,6,0,6,1
"Iceland",49,4,7,2,0,2,2
"Germany",49,6,6,3,2,1,1
"Sweden",49,6,4,5,5,0,2
"England",49,7,9,5,1,4,1
"Panama",49,7,4,3,2,1,2
"Senegal",49,8,6,3,3,0,2
"Poland",49,8,6,3,2,1,1
"Portugal",50,2,6,3,2,1,2
"Iran",50,2,6,3,1,2,1
"Colombia",50,8,6,7,2,5,1
"Poland",50,8,6,6,5,1,2
"Uruguay",51,1,6,3,3,0,2
"Saudi Arabia",51,1,6,4,3,1,1
"Germany",51,6,9,12,2,10,1
"Mexico",51,6,4,3,4,-1,2
"Belgium",51,7,6,5,2,3,1
"Tunisia",51,7,4,4,4,0,2
"Colombia",51,8,6,4,4,0,1
"Japan",51,8,4,3,2,1,2
"Uruguay",52,1,9,5,1,4,1
"Russia",52,1,4,4,3,1,2
"Iran",52,2,5,4,2,2,1
"Spain",52,2,4,5,3,2,2
"Denmark",52,3,6,3,2,1,1
"Peru",52,3,4,4,3,1,2
"Switzerland",52,5,9,9,2,7,1
"Brazil",52,5,4,2,2,0,2
"South Korea",52,6,5,3,2,1,1
"Germany",52,6,4,3,2,1,2
"Belgium",52,7,7,6,3,3,2
"England",52,7,7,4,0,4,1
"Germany",53,6,5,4,2,2,1
"Mexico",53,6,4,6,5,1,2
"Brazil",54,5,6,6,2,4,1
"Switzerland",54,5,6,2,3,-1,2
"Japan",54,8,9,5,2,3,1
"Colombia",54,8,4,4,2,2,2
"Iran",55,2,7,7,2,5,1
"Spain",55,2,4,6,4,2,2
"Colombia",55,8,6,4,3,1,2
"Poland",55,8,6,6,3,3,1
"Iran",56,2,9,3,0,3,1
"Portugal",56,2,4,4,1,3,2
"Spain",57,2,5,4,2,2,2
"Iran",57,2,5,5,0,5,1
"Colombia",57,8,9,7,2,5,1
"Poland",57,8,3,6,6,0,2
"Portugal",58,2,7,9,1,8,1
"Spain",58,2,4,3,3,0,2
"Argentina",58,4,6,5,4,1,2
"Nigeria",58,4,6,3,1,2,1
"Argentina",59,4,6,2,2,0,2
"Iceland",59,4,6,5,4,1,1
"Brazil",59,5,9,9,1,8,1
"Serbia",59,5,4,3,3,0,2
"Mexico",59,6,6,5,2,3,1
"South Korea",59,6,6,4,2,2,2
"Belgium",60,7,7,9,2,7,1
"England",60,7,7,7,1,6,2
"Brazil",61,5,5,4,2,2,2
"Switzerland",61,5,5,7,1,6,1
"Mexico",61,6,6,5,4,1,2
"Germany",61,6,6,4,2,2,1
"Tunisia",61,7,6,6,4,2,1
"Panama",61,7,6,4,4,0,2
"Uruguay",62,1,6,4,3,1,1
"Russia",62,1,4,2,1,1,2
"Portugal",62,2,9,9,3,6,1
"Iran",62,2,4,6,4,2,2
"Argentina",62,4,9,8,1,7,1
"Croatia",62,4,4,3,4,-1,2
"Belgium",62,7,7,6,2,4,2
"England",62,7,7,6,1,5,1
"France",64,3,6,3,2,1,2
"Australia",64,3,6,3,1,2,1
"Croatia",64,4,7,5,2,3,1
"Argentina",64,4,7,4,2,2,2
"Brazil",64,5,6,4,1,3,1
"Serbia",64,5,4,2,2,0,2
"Sweden",64,6,6,3,3,0,2
"Germany",64,6,6,3,1,2,1
"England",64,7,6,4,4,0,2
"Panama",64,7,6,7,4,3,1
"Portugal",65,2,7,6,3,3,1
"Morocco",65,2,4,3,2,1,2
"Brazil",65,5,6,8,2,6,1
"Switzerland",65,5,6,5,2,3,2
"Mexico",65,6,7,8,3,5,1
"Germany",65,6,4,7,5,2,2
"Brazil",66,5,6,6,2,4,1
"Costa Rica",66,5,4,2,2,0,2
"Germany",66,6,9,5,0,5,1
"South Korea",66,6,4,2,2,0,2
"France",67,3,7,6,2,4,1
"Australia",67,3,4,4,2,2,2
"Mexico",67,6,7,6,2,4,1
"Germany",67,6,7,5,3,2,2
"Japan",67,8,6,3,2,1,2
"Poland",67,8,6,4,2,2,1
"Russia",68,1,6,7,3,4,1
"Uruguay",68,1,4,3,3,0,2
"Argentina",68,4,7,7,5,2,1
"Nigeria",68,4,4,4,3,1,2
"Belgium",68,7,7,4,2,2,2
"England",68,7,7,8,3,5,1
"Portugal",69,2,9,4,0,4,1
"Iran",69,2,4,3,1,2,2
"France",69,3,5,4,3,1,2
"Peru",69,3,5,7,4,3,1
"Germany",69,6,9,7,1,6,1
"Mexico",69,6,4,3,3,0,2
"Uruguay",70,1,6,6,4,2,1
"Egypt",70,1,4,5,3,2,2
"Spain",71,2,7,4,1,3,1
"Iran",71,2,7,4,2,2,2
"Brazil",71,5,6,2,2,0,1
"Costa Rica",71,5,4,3,2,1,2
"Spain",72,2,6,4,5,-1,2
"Portugal",72,2,6,4,3,1,1
"Colombia",72,8,6,5,2,3,1
"Japan",72,8,6,3,1,2,2
"France",73,3,6,5,3,2,1
"Peru",73,3,6,3,2,1,2
"Brazil",73,5,9,7,0,7,1
"Costa Rica",73,5,2,2,3,-1,2
"Argentina",74,4,6,8,2,6,1
"Iceland",74,4,4,3,4,-1,2
"Belgium",74,7,6,7,5,2,2
"England",74,7,6,8,5,3,1
"Russia",75,1,5,3,1,2,1
"Saudi Arabia",75,1,5,2,1,1,2
"Japan",75,8,9,4,0,4,1
"Senegal",75,8,4,3,2,1,2
"Argentina",76,4,6,7,1,6,1
"Nigeria",76,4,6,2,5,-3,2
"Brazil",76,5,9,5,0,5,1
"Switzerland",76,5,4,5,3,2,2
"Uruguay",77,1,6,4,3,1,1
"Egypt",77,1,4,4,2,2,2
"Argentina",77,4,5,2,1,1,1
"Croatia",77,4,4,2,1,1,2
"France",78,3,5,4,2,2,1
"Peru",78,3,4,4,3,1,2
"Belgium",78,7,5,3,1,2,1
"England",78,7,5,4,3,1,2
"Japan",78,8,6,5,4,1,1
"Senegal",78,8,6,5,5,0,2
"Spain",79,2,7,5,2,3,2
"Iran",79,2,7,7,2,5,1
"France",79,3,6,6,4,2,1
"Australia",79,3,6,4,4,0,2
"Uruguay",80,1,6,9,5,4,1
"Saudi Arabia",80,1,6,5,3,2,2
"Croatia",80,4,7,4,2,2,1
"Argentina",80,4,4,4,3,1,2
"Japan",80,8,5,2,1,1,2
"Poland",80,8,5,6,4,2,1
"Uruguay",82,1,9,5,2,3,1
"Egypt",82,1,3,4,4,0,2
"Brazil",82,5,9,11,1,10,1
"Costa Rica",82,5,3,3,4,-1,2
"France",83,3,9,9,1,8,1
"Australia",83,3,3,5,5,0,2
"Colombia",83,8,6,4,4,0,2
"Japan",83,8,6,3,2,1,1
"Saudi Arabia",84,1,6,3,2,1,1
"Egypt",84,1,6,3,6,-3,2
"Spain",84,2,6,7,3,4,1
"Portugal",84,2,6,3,2,1,2
"Iceland",84,4,7,3,1,2,1
"Argentina",84,4,4,5,2,3,2
"Japan",84,8,5,9,4,5,1
"Colombia",84,8,4,4,3,1,2
"Iceland",85,4,5,5,2,3,1
"Croatia",85,4,4,5,2,3,2
"Colombia",85,8,7,6,2,4,1
"Senegal",85,8,4,4,4,0,2
"Belgium",86,7,6,5,4,1,1
"Panama",86,7,4,2,2,0,2
"Colombia",86,8,6,4,3,1,1
"Poland",86,8,6,3,4,-1,2
"Russia",87,1,5,4,3,1,1
"Uruguay",87,1,4,4,2,2,2
"Portugal",87,2,7,5,1,4,2
"Iran",87,2,7,8,3,5,1
"Brazil",87,5,6,4,2,2,1
"Costa Rica",87,5,6,3,2,1,2
"Sweden",87,6,6,3,2,1,1
"Mexico",87,6,4,3,3,0,2
"Iran",88,2,5,3,1,2,1
"Spain",88,2,4,4,2,2,2
"Spain",89,2,9,9,1,8,1
"Iran",89,2,4,6,2,4,2
"Costa Rica",89,5,9,6,2,4,1
"Brazil",89,5,4,4,4,0,2
"Mexico",89,6,9,6,0,6,1
"Sweden",89,6,2,0,1,-1,2
"Belgium",89,7,7,5,2,3,2
"England",89,7,7,9,1,8,1
"Russia",92,1,6,4,2,2,1
"Egypt",92,1,4,4,4,0,2
"Japan",92,8,7,4,2,2,1
"Colombia",92,8,4,5,2,3,2
"Russia",93,1,5,5,3,2,1
"Uruguay",93,1,4,6,4,2,2
"France",93,3,7,8,3,5,1
"Peru",93,3,7,4,2,2,2
"Belgium",93,7,6,6,3,3,1
"Panama",93,7,4,5,5,0,2
"Switzerland",94,5,5,2,1,1,2
"Serbia",94,5,5,4,2,2,1
"Spain",95,2,7,4,1,3,1
"Portugal",95,2,7,3,1,2,2
"Brazil",95,5,9,10,1,9,1
"Switzerland",95,5,3,4,5,-1,2
"Sweden",95,6,6,4,5,-1,2
"South Korea",95,6,6,3,3,0,1
"Mexico",96,6,6,6,1,5,1
"Germany",96,6,6,3,1,2,2
"Japan",96,8,5,6,4,2,1
"Poland",96,8,5,5,4,1,2
"Portugal",97,2,6,3,3,0,2
"Iran",97,2,6,7,6,1,1
"Brazil",97,5,5,2,1,1,2
"Switzerland",97,5,5,2,0,2,1
"Mexico",97,6,6,5,3,2,1
"Sweden",97,6,4,5,5,0,2
"Uruguay",99,1,9,6,1,5,1
"Egypt",99,1,4,5,4,1,2
"Denmark",99,3,6,4,6,-2,2
"Peru",99,3,6,6,3,3,1
"Brazil",99,5,6,6,3,3,1
"Switzerland",99,5,4,3,2,1,2
"Germany",99,6,6,8,3,5,1
"Sweden",99,6,4,5,6,-1,2
"Uruguay",100,1,5,4,1,3,2
"Russia",100,1,5,5,1,4,1
"France",100,3,6,5,5,0,2
"Peru",100,3,6,6,3,3,1
"South Korea",100,6,7,5,2,3,2
"Germany",100,6,7,5,1,4,1
"Belgium",100,7,9,7,2,5,1
"England",100,7,4,6,4,2,2
"Japan",100,8,7,3,1,2,1
"Colombia",100,8,4,4,3,1,2
"Iran",101,2,5,4,2,2,1
"Spain",101,2,4,4,3,1,2
"Japan",101,8,6,4,3,1,2
"Poland",101,8,6,5,3,2,1
"France",102,3,5,3,0,3,1
"Peru",102,3,4,2,2,0,2
"Brazil",102,5,5,5,1,4,1
"Costa Rica",102,5,5,2,1,1,2
"Belgium",102,7,9,11,5,6,1
"England",102,7,3,6,6,0,2
"South Korea",104,6,6,4,1,3,1
"Germany",104,6,6,3,5,-2,2
"Egypt",105,1,6,7,6,1,1
"Saudi Arabia",105,1,4,2,1,1,2
"Australia",105,3,9,3,0,3,1
"Denmark",105,3,3,4,3,1,2
"Tunisia",105,7,7,4,2,2,1
"England",105,7,4,3,2,1,2
"Colombia",105,8,6,5,3,2,1
"Poland",105,8,6,4,3,1,2
"Uruguay",106,1,6,6,3,3,1
"Russia",106,1,6,4,2,2,2
"Portugal",106,2,9,8,1,7,1
"Iran",106,2,4,2,2,0,2
"Russia",107,1,5,5,2,3,1
"Uruguay",107,1,4,4,4,0,2
"England",107,7,7,6,1,5,1
"Panama",107,7,7,4,1,3,2
"France",108,3,9,8,1,7,1
"Australia",108,3,3,3,4,-1,2
"Costa Rica",108,5,5,6,3,3,1
"Brazil",108,5,4,7,4,3,2
"South Korea",108,6,7,6,4,2,2
"Germany",108,6,7,9,3,6,1
"Panama",108,7,7,4,2,2,1
"England",108,7,4,4,2,2,2
"Colombia",108,8,7,7,2,5,1
"Poland",108,8,7,4,2,2,2
"Uruguay",109,1,6,4,2,2,1
"Russia",109,1,6,5,4,1,2
"France",109,3,6,9,5,4,1
"Australia",109,3,4,5,5,0,2
"Japan",109,8,6,5,2,3,1
"Poland",109,8,6,2,1,1,2
"Brazil",110,5,9,8,4,4,1
"Costa Rica",110,5,4,5,3,2,2
"Uruguay",112,1,6,9,3,6,1
"Russia",112,1,4,6,6,0,2
"France",112,3,6,7,1,6,1
"Denmark",112,3,4,3,3,0,2
"Belgium",112,7,6,5,5,0,1
"Panama",112,7,4,6,5,1,2
"Portugal",113,2,5,5,4,1,2
"Iran",113,2,5,6,4,2,1
"Peru",113,3,6,7,4,3,1
"Australia",113,3,4,5,5,0,2
"Belgium",113,7,7,7,2,5,1
"England",113,7,4,4,4,0,2
"France",114,3,5,6,3,3,1
"Australia",114,3,5,5,3,2,2
"Uruguay",115,1,6,5,4,1,2
"Russia",115,1,6,5,2,3,1
"Denmark",115,3,5,2,1,1,1
"France",115,3,4,4,3,1,2
"Colombia",115,8,6,6,3,3,1
"Japan",115,8,6,3,1,2,2
"Uruguay",116,1,7,5,2,3,2
"Russia",116,1,7,7,2,5,1
"Portugal",116,2,6,4,4,0,1
"Spain",116,2,4,5,4,1,2
"Croatia",116,4,7,7,5,2,1
"Iceland",116,4,4,8,5,3,2
"Brazil",116,5,5,7,5,2,1
"Switzerland",116,5,5,4,3,1,2
"Poland",116,8,5,4,0,4,1
"Colombia",116,8,4,4,3,1,2
"Brazil",117,5,5,5,2,3,1
"Costa Rica",117,5,5,3,1,2,2
"Spain",118,2,7,2,0,2,2
"Iran",118,2,7,5,1,4,1
"Mexico",118,6,6,7,3,4,2
"Germany",118,6,6,7,2,5,1
"Belgium",118,7,9,5,0,5,1
"England",118,7,3,5,4,1,2
"Colombia",118,8,5,3,1,2,1
"Japan",118,8,4,5,2,3,2
"South Korea",119,6,6,5,5,0,2
"Germany",119,6,6,8,3,5,1
"Uruguay",120,1,6,4,3,1,1
"Egypt",120,1,6,3,5,-2,2
"Belgium",120,7,6,5,4,1,2
"England",120,7,6,6,3,3,1
"Colombia",120,8,6,8,3,5,1
"Japan",120,8,4,3,3,0,2
"Uruguay",121,1,6,7,4,3,1
"Russia",121,1,6,7,5,2,2
"Argentina",121,4,6,9,5,4,1
"Iceland",121,4,6,4,2,2,2
"Brazil",121,5,9,8,0,8,1
"Switzerland",121,5,4,3,4,-1,2
"Sweden",121,6,6,4,3,1,2
"Germany",121,6,6,6,3,3,1
"Egypt",122,1,5,2,1,1,1
"Russia",122,1,4,5,5,0,2
"France",122,3,6,4,3,1,2
"Peru",122,3,6,8,3,5,1
"Brazil",123,5,6,6,2,4,1
"Costa Rica",123,5,4,4,3,1,2
"Colombia",123,8,9,5,1,4,1
"Senegal",123,8,3,5,5,0,2
"Portugal",124,2,7,3,0,3,1
"Spain",124,2,4,4,2,2,2
"Brazil",124,5,6,6,2,4,1
"Costa Rica",124,5,6,4,1,3,2
"Colombia",125,8,6,7,4,3,1
"Poland",125,8,4,4,4,0,2
"Brazil",126,5,6,4,2,2,1
"Costa Rica",126,5,4,4,3,1,2
"England",126,7,6,8,2,6,1
"Belgium",126,7,4,2,2,0,2
"Argentina",127,4,6,3,2,1,1
"Iceland",127,4,6,2,3,-1,2
"Sweden",128,6,6,6,4,2,2
"South Korea",128,6,6,6,1,5,1
"Uruguay",129,1,6,5,1,4,1
"Egypt",129,1,6,2,2,0,2
"Saudi Arabia",130,1,5,6,5,1,2
"Egypt",130,1,5,5,3,2,1
"Spain",130,2,6,6,3,3,1
"Iran",130,2,6,4,2,2,2
"France",130,3,6,6,6,0,2
"Australia",130,3,6,5,4,1,1
"Belgium",130,7,5,2,1,1,2
"England",130,7,5,2,0,2,1
"Brazil",131,5,6,7,3,4,1
"Serbia",131,5,4,3,2,1,2
"Germany",131,6,7,3,0,3,1
"South Korea",131,6,4,3,3,0,2
"Uruguay",132,1,5,2,1,1,1
"Russia",132,1,4,3,3,0,2
"England",132,7,7,6,1,5,1
"Belgium",132,7,4,3,3,0,2
"Poland",133,8,5,2,1,1,1
"Colombia",133,8,4,5,4,1,2
"Russia",134,1,6,3,3,0,1
"Saudi Arabia",134,1,4,4,1,3,2
"Brazil",134,5,6,6,2,4,1
"Switzerland",134,5,4,4,4,0,2
"Belgium",134,7,5,6,3,3,1
"England",134,7,5,5,3,2,2
"Switzerland",135,5,9,5,2,3,1
"Serbia",135,5,4,5,3,2,2
"South Korea",135,6,5,4,3,1,2
"Germany",135,6,5,5,3,2,1
"Japan",136,8,7,4,1,3,1
"Senegal",136,8,4,4,3,1,2
"Portugal",137,2,5,3,1,2,1
"Morocco",137,2,4,2,2,0,2
"Brazil",137,5,6,6,3,3,1
"Costa Rica",137,5,6,4,3,1,2
"Japan",137,8,6,4,3,1,2
"Poland",137,8,6,4,1,3,1
"Uruguay",138,1,5,6,3,3,1
"Egypt",138,1,5,5,3,2,2
"Spain",138,2,7,3,0,3,1
"Portugal",138,2,7,3,1,2,2
"Uruguay",139,1,5,4,2,2,2
"Egypt",139,1,5,4,1,3,1
"Costa Rica",139,5,6,5,2,3,1
"Brazil",139,5,4,4,4,0,2
"Colombia",139,8,7,6,1,5,1
"Japan",139,8,7,6,2,4,2
"Brazil",140,5,6,7,2,5,1
"Switzerland",140,5,6,4,4,0,2
"Mexico",141,6,6,7,3,4,1
"Germany",141,6,6,5,2,3,2
"Colombia",141,8,9,9,2,7,1
"Poland",141,8,4,3,3,0,2
"Mexico",142,6,7,5,2,3,2
"Germany",142,6,7,4,0,4,1
"Belgium",142,7,6,6,1,5,1
"England",142,7,6,4,4,0,2
"Spain",144,2,7,3,0,3,1
"Portugal",144,2,4,3,3,0,2
"France",144,3,9,6,1,5,1
"Peru",144,3,3,2,3,-1,2
"England",144,7,5,5,2,3,1
"Tunisia",144,7,5,4,3,1,2
"Argentina",146,4,7,5,1,4,1
"Iceland",146,4,7,5,3,2,2
"France",147,3,6,6,2,4,1
"Peru",147,3,6,5,4,1,2
"Argentina",147,4,6,4,2,2,1
"Iceland",147,4,6,3,3,0,2
"Poland",147,8,5,8,2,6,1
"Colombia",147,8,4,2,4,-2,2
"Uruguay",148,1,7,4,1,3,2
"Russia",148,1,7,6,2,4,1
"Australia",148,3,5,4,3,1,1
"Peru",148,3,4,4,3,1,2
"Croatia",148,4,7,2,0,2,1
"Argentina",148,4,4,5,3,2,2
"Brazil",148,5,9,9,0,9,1
"Serbia",148,5,4,3,3,0,2
"France",149,3,9,6,1,5,1
"Australia",149,3,4,4,4,0,2
"Mexico",149,6,6,5,3,2,1
"Sweden",149,6,4,3,3,0,2
"Belgium",149,7,7,3,1,2,2
"England",149,7,7,8,2,6,1
"Portugal",150,2,6,5,2,3,1
"Spain",150,2,4,3,3,0,2
"Uruguay",151,1,6,7,6,1,1
"Saudi Arabia",151,1,4,5,5,0,2
"France",151,3,4,4,3,1,2
"Denmark",151,3,4,4,2,2,1
"Iran",152,2,9,3,0,3,1
"Portugal",152,2,3,4,4,0,2
"France",153,3,6,5,5,0,2
"Denmark",153,3,6,4,2,2,1
"Brazil",153,5,7,7,2,5,1
"Serbia",153,5,7,6,3,3,2
"South Korea",153,6,6,4,2,2,1
"Germany",153,6,4,2,2,0,2
"Portugal",154,2,9,9,1,8,1
"Spain",154,2,4,3,3,0,2
"England",154,7,6,4,2,2,2
"Panama",154,7,6,7,4,3,1
"Poland",154,8,6,3,1,2,1
"Senegal",154,8,4,2,2,0,2
"Argentina",155,4,7,5,2,3,1
"Croatia",155,4,4,4,2,2,2
"Brazil",155,5,9,11,5,6,1
"Costa Rica",155,5,2,4,5,-1,2
"France",156,3,5,3,2,1,2
"Denmark",156,3,5,5,2,3,1
"Croatia",156,4,7,3,1,2,2
"Argentina",156,4,7,5,2,3,1
"Brazil",156,5,9,9,0,9,1
"Costa Rica",156,5,4,3,4,-1,2
"Japan",156,8,6,4,1,3,1
"Senegal",156,8,6,4,4,0,2
"Sweden",157,6,5,5,4,1,2
"Germany",157,6,5,6,4,2,1
"Spain",158,2,7,4,2,2,2
"Portugal",158,2,7,3,0,3,1
"Colombia",158,8,7,3,1,2,2
"Japan",158,8,7,5,2,3,1
"Morocco",159,2,7,6,3,3,1
"Portugal",159,2,4,3,3,0,2
"Germany",159,6,9,6,0,6,1
"South Korea",159,6,4,2,3,-1,2
"England",159,7,9,4,0,4,1
"Tunisia",159,7,4,4,3,1,2
"Colombia",159,8,9,10,2,8,1
"Japan",159,8,3,3,4,-1,2
"Spain",160,2,7,6,0,6,1
"Iran",160,2,7,3,1,2,2
"Poland",160,8,6,4,2,2,1
"Colombia",160,8,4,3,1,2,2
"Spain",161,2,7,4,0,4,1
"Morocco",161,2,4,3,3,0,2
"France",161,3,7,6,1,5,1
"Denmark",161,3,7,6,3,3,2
"Switzerland",161,5,6,5,3,2,1
"Costa Rica",161,5,4,4,4,0,2
"England",161,7,4,3,2,1,1
"Panama",161,7,4,1,1,0,2
"France",162,3,7,11,4,7,1
"Denmark",162,3,4,6,8,-2,2
"Argentina",162,4,7,3,0,3,1
"Croatia",162,4,4,2,2,0,2
"Colombia",162,8,6,5,3,2,1
"Senegal",162,8,6,3,3,0,2
"Brazil",163,5,5,5,1,4,1
"Costa Rica",163,5,5,6,4,2,2
"South Korea",163,6,6,6,3,3,1
"Germany",163,6,4,6,4,2,2
"England",163,7,6,7,4,3,1
"Belgium",163,7,4,4,3,1,2
"France",165,3,9,6,0,6,1
"Australia",165,3,2,0,1,-1,2
"Germany",165,6,9,9,2,7,1
"Mexico",165,6,4,4,3,1,2
"Argentina",166,4,7,8,2,6,1
"Iceland",166,4,4,1,1,0,2
"Mexico",166,6,5,2,1,1,2
"Germany",166,6,5,4,2,2,1
"Belgium",166,7,6,7,4,3,1
"England",166,7,6,4,2,2,2
"Colombia",166,8,6,2,1,1,1
"Japan",166,8,6,3,4,-1,2
"Uruguay",167,1,7,6,2,4,1
"Saudi Arabia",167,1,4,1,1,0,2
"Spain",167,2,6,7,2,5,1
"Portugal",167,2,6,4,2,2,2
"France",167,3,7,8,4,4,1
"Peru",167,3,4,3,3,0,2
"Brazil",167,5,6,4,2,2,1
"Costa Rica",167,5,4,2,2,0,2
"Uruguay",168,1,5,3,2,1,2
"Russia",168,1,5,6,3,3,1
"Argentina",168,4,9,6,1,5,1
"Croatia",168,4,3,3,4,-1,2
"Colombia",168,8,6,6,3,3,1
"Poland",168,8,6,3,3,0,2
"Egypt",169,1,5,4,2,2,1
"Uruguay",169,1,4,2,1,1,2
"Argentina",169,4,7,10,3,7,1
"Croatia",169,4,4,7,6,1,2
"Brazil",169,5,9,6,1,5,1
"Switzerland",169,5,4,3,3,0,2
"Uruguay",170,1,6,6,3,3,1
"Russia",170,1,4,4,4,0,2
"Brazil",170,5,6,5,1,4,1
"Costa Rica",170,5,6,6,7,-1,2
"Mexico",170,6,6,5,2,3,1
"Germany",170,6,6,3,2,1,2
"Japan",170,8,5,3,1,2,1
"Poland",170,8,4,2,1,1,2
"Brazil",171,5,6,8,1,7,1
"Costa Rica",171,5,6,5,3,2,2
"Spain",172,2,6,2,1,1,2
"Portugal",172,2,6,3,1,2,1
"Spain",173,2,5,6,3,3,1
"Portugal",173,2,4,4,4,0,2
"Argentina",174,4,9,8,1,7,1
"Croatia",174,4,4,10,4,6,2
"Belgium",174,7,9,7,4,3,1
"Panama",174,7,3,6,6,0,2
"France",175,3,6,4,2,2,1
"Peru",175,3,4,4,4,0,2
"Denmark",176,3,5,4,3,1,1
"France",176,3,4,4,3,1,2
"Argentina",176,4,7,6,2,4,1
"Iceland",176,4,4,3,3,0,2
"Brazil",176,5,5,4,2,2,1
"Switzerland",176,5,5,3,2,1,2
"Portugal",177,2,5,3,1,2,1
"Iran",177,2,5,3,2,1,2
"Brazil",177,5,9,6,0,6,1
"Switzerland",177,5,3,5,3,2,2
"Argentina",178,4,5,3,1,2,1
"Iceland",178,4,5,2,1,1,2
"Switzerland",178,5,6,4,4,0,2
"Costa Rica",178,5,6,3,1,2,1
"Croatia",179,4,9,6,1,5,1
"Iceland",179,4,4,4,4,0,2
"Brazil",179,5,7,5,2,3,1
"Serbia",179,5,7,5,3,2,2
"Mexico",179,6,7,6,3,3,1
"Sweden",179,6,4,3,3,0,2
"Belgium",179,7,6,6,6,0,2
"Tunisia",179,7,6,6,3,3,1
"Denmark",180,3,7,5,2,3,1
"Peru",180,3,4,5,2,3,2
"Costa Rica",180,5,5,4,3,1,1
"Serbia",180,5,4,3,2,1,2
"Colombia",180,8,5,3,1,2,1
"Japan",180,8,5,3,2,1,2
"France",181,3,5,4,3,1,2
"Peru",181,3,5,3,1,2,1
"England",181,7,5,5,1,4,1
"Tunisia",181,7,5,2,1,1,2
"Japan",181,8,9,8,3,5,1
"Poland",181,8,4,3,2,1,2
"Uruguay",182,1,7,7,2,5,1
"Russia",182,1,7,8,4,4,2
"Denmark",182,3,6,2,2,0,2
"Australia",182,3,6,6,4,2,1
"Egypt",183,1,6,3,3,0,1
"Russia",183,1,4,3,1,2,2
"Croatia",183,4,7,3,0,3,1
"Iceland",183,4,7,4,2,2,2
"Belgium",184,7,6,4,2,2,1
"England",184,7,4,3,2,1,2
"Senegal",184,8,9,6,1,5,1
"Poland",184,8,3,5,3,2,2
"France",185,3,6,7,3,4,1
"Peru",185,3,6,2,1,1,2
"South Korea",185,6,5,4,2,2,2
"Germany",185,6,5,5,2,3,1
"Croatia",186,4,6,5,3,2,1
"Iceland",186,4,6,3,3,0,2
"Switzerland",186,5,9,7,1,6,1
"Serbia",186,5,2,0,1,-1,2
"Germany",186,6,7,7,1,6,1
"Sweden",186,6,4,5,4,1,2
"Croatia",187,4,7,5,1,4,2
"Argentina",187,4,7,10,1,9,1
"England",187,7,6,3,1,2,1
"Belgium",187,7,4,2,3,-1,2
"Brazil",188,5,9,8,2,6,1
"Costa Rica",188,5,4,3,2,1,2
"Colombia",189,8,6,5,4,1,2
"Poland",189,8,6,4,2,2,1
"Sweden",190,6,6,4,4,0,2
"Mexico",190,6,6,6,1,5,1
"Argentina",191,4,6,8,1,7,1
"Iceland",191,4,4,2,3,-1,2
"Colombia",191,8,6,7,4,3,1
"Japan",191,8,4,5,5,0,2
"Uruguay",192,1,4,6,5,1,1
"Russia",192,1,4,5,5,0,2
"Spain",192,2,6,6,5,1,1
"Iran",192,2,4,5,3,2,2
"Argentina",192,4,9,7,0,7,1
"Croatia",192,4,4,3,3,0,2
"England",192,7,5,3,2,1,2
"Panama",192,7,5,4,2,2,1
"Senegal",192,8,7,5,2,3,1
"Colombia",192,8,4,5,3,2,2
"France",193,3,6,3,1,2,1
"Peru",193,3,6,2,2,0,2
"Mexico",193,6,6,7,4,3,2
"Germany",193,6,6,11,7,4,1
"Belgium",193,7,6,3,2,1,2
"England",193,7,6,5,2,3,1
"Costa Rica",194,5,7,4,2,2,1
"Serbia",194,5,4,3,2,1,2
"Spain",195,2,9,8,0,8,1
"Iran",195,2,4,2,1,1,2
"Brazil",195,5,5,3,1,2,1
"Costa Rica",195,5,4,1,1,0,2
"Brazil",196,5,6,9,6,3,2
"Switzerland",196,5,6,8,4,4,1
"South Korea",197,6,6,4,4,0,2
"Germany",197,6,6,7,4,3,1
"South Korea",198,6,9,5,1,4,1
"Germany",198,6,4,7,2,5,2
"Uruguay",199,1,9,7,2,5,1
"Russia",199,1,3,3,3,0,2
"Iran",199,2,9,10,3,7,1
"Spain",199,2,4,3,1,2,2
"Peru",199,3,7,2,0,2,1
"France",199,3,4,4,2,2,2
"Belgium",199,7,6,5,3,2,1
"England",199,7,6,3,2,1,2
"Iran",200,2,6,7,2,5,1
"Spain",200,2,4,2,2,0,2
"Brazil",200,5,7,5,1,4,1
"Costa Rica",200,5,7,5,3,2,2
"Uruguay",201,1,6,7,2,5,1
"Egypt",201,1,4,2,3,-1,2
"Spain",201,2,7,5,2,3,1
"Portugal",201,2,4,6,3,3,2
"Costa Rica",201,5,7,5,0,5,1
"Brazil",201,5,4,5,2,3,2
"Belgium",201,7,7,7,4,3,1
"England",201,7,4,5,4,1,2
"Uruguay",202,1,7,4,2,2,1
"Saudi Arabia",202,1,4,3,1,2,2
"Australia",202,3,9,7,3,4,1
"France",202,3,4,3,2,1,2
"Argentina",202,4,6,7,5,2,1
"Croatia",202,4,4,3,2,1,2
"Japan",202,8,6,3,2,1,1
"Senegal",202,8,4,3,2,1,2
"Argentina",203,4,9,7,0,7,1
"Croatia",203,4,4,1,2,-1,2
"Colombia",203,8,6,4,2,2,1
"Poland",203,8,6,4,3,1,2
"Uruguay",204,1,9,7,2,5,1
"Russia",204,1,4,4,3,1,2
"Colombia",204,8,7,4,2,2,2
"Poland",204,8,7,4,0,4,1
"South Korea",205,6,5,4,2,2,1
"Sweden",205,6,4,3,2,1,2
"Portugal",206,2,6,4,5,-1,1
"Iran",206,2,4,6,2,4,2
"France",206,3,9,5,1,4,1
"Peru",206,3,3,3,3,0,2
"Brazil",206,5,7,6,1,5,1
"Costa Rica",206,5,7,6,2,4,2
"South Korea",206,6,6,5,3,2,2
"Germany",206,6,6,4,1,3,1
"England",206,7,6,7,7,0,1
"Belgium",206,7,4,5,3,2,2
"Iran",207,2,6,8,6,2,1
"Spain",207,2,4,6,6,0,2
"Belgium",207,7,9,6,3,3,1
"England",207,7,4,6,4,2,2
"Colombia",207,8,5,4,3,1,2
"Senegal",207,8,5,4,1,3,1
"Colombia",209,8,7,7,1,6,1
"Poland",209,8,7,4,2,2,2
"Portugal",210,2,5,4,3,1,2
"Iran",210,2,5,3,1,2,1
"France",210,3,9,8,2,6,1
"Denmark",210,3,4,4,3,1,2
"Brazil",210,5,9,6,0,6,1
"Switzerland",210,5,4,3,3,0,2
"Poland",210,8,9,5,0,5,1
"Colombia",210,8,4,2,1,1,2
"Denmark",211,3,6,4,4,0,2
"Australia",211,3,6,4,3,1,1
"England",212,7,9,11,1,10,1
"Belgium",212,7,4,1,3,-2,2
"Russia",213,1,5,6,4,2,1
"Egypt",213,1,4,3,2,1,2
"Spain",213,2,6,4,4,0,2
"Portugal",213,2,6,6,1,5,1
"Colombia",213,8,6,5,3,2,1
"Japan",213,8,6,6,5,1,2
"Croatia",214,4,7,5,1,4,2
"Argentina",214,4,7,7,2,5,1
"Switzerland",214,5,6,6,4,2,1
"Brazil",214,5,4,6,5,1,2
"Russia",215,1,7,5,2,3,2
"Saudi Arabia",215,1,7,7,1,6,1
"Argentina",215,4,7,4,1,3,1
"Nigeria",215,4,7,4,2,2,2
"Brazil",216,5,9,7,0,7,1
"Switzerland",216,5,4,2,2,0,2
"Japan",216,8,5,5,3,2,1
"Poland",216,8,5,5,4,1,2
"Japan",217,8,6,6,5,1,1
"Colombia",217,8,4,6,5,1,2
"Uruguay",218,1,9,6,1,5,1
"Saudi Arabia",218,1,2,2,3,-1,2
"Portugal",218,2,6,4,1,3,1
"Spain",218,2,4,5,3,2,2
"Serbia",218,5,5,3,2,1,1
"Switzerland",218,5,4,3,2,1,2
"Belgium",218,7,7,7,2,5,1
"England",218,7,7,5,2,3,2
"Colombia",218,8,4,3,2,1,1
"Senegal",218,8,4,4,4,0,2
"Uruguay",219,1,7,5,3,2,2
"Russia",219,1,7,5,2,3,1
"Switzerland",219,5,7,5,3,2,2
"Serbia",219,5,7,6,3,3,1
"Belgium",219,7,6,6,2,4,1
"Tunisia",219,7,4,4,2,2,2
"Portugal",220,2,7,4,0,4,1
"Iran",220,2,7,4,1,3,2
"Argentina",220,4,9,6,1,5,1
"Nigeria",220,4,3,4,5,-1,2
"Russia",221,1,7,5,2,3,1
"Uruguay",221,1,4,5,2,3,2
"Spain",221,2,7,8,2,6,1
"Iran",221,2,7,6,1,5,2
"Croatia",221,4,9,6,1,5,1
"Argentina",221,4,4,3,2,1,2
"England",221,7,6,7,3,4,1
"Panama",221,7,6,3,5,-2,2
"Colombia",221,8,7,7,4,3,1
"Poland",221,8,4,5,4,1,2
"Denmark",222,3,6,9,5,4,2
"Peru",222,3,6,6,1,5,1
"Croatia",222,4,9,5,2,3,1
"Argentina",222,4,4,6,4,2,2
"England",222,7,5,4,2,2,1
"Panama",222,7,5,4,3,1,2
"Portugal",223,2,9,7,1,6,1
"Iran",223,2,2,0,1,-1,2
"Uruguay",224,1,7,6,3,3,1
"Russia",224,1,4,2,1,1,2
"Uruguay",225,1,6,6,4,2,2
"Russia",225,1,6,10,5,5,1
"Australia",225,3,6,4,3,1,1
"Peru",225,3,4,3,2,1,2
"France",226,3,7,6,0,6,1
"Peru",226,3,7,3,1,2,2
"Costa Rica",226,5,6,4,1,3,1
"Brazil",226,5,4,7,3,4,2
"Iran",227,2,6,4,3,1,1
"Spain",227,2,4,3,3,0,2
"Costa Rica",227,5,6,4,3,1,1
"Brazil",227,5,4,7,3,4,2
"Belgium",227,7,6,6,5,1,1
"England",227,7,4,9,8,1,2
"Uruguay",228,1,9,5,1,4,1
"Russia",228,1,4,3,2,1,2
"Argentina",229,4,7,4,2,2,1
"Iceland",229,4,4,5,2,3,2
"Brazil",229,5,5,3,0,3,1
"Costa Rica",229,5,5,2,1,1,2
"Germany",230,6,9,6,1,5,1
"Mexico",230,6,4,3,1,2,2
"Spain",231,2,6,3,1,2,2
"Portugal",231,2,6,5,2,3,1
"Mexico",231,6,7,6,2,4,1
"Germany",231,6,7,3,1,2,2
"Belgium",231,7,9,4,1,3,1
"Panama",231,7,3,5,3,2,2
"Colombia",231,8,4,10,8,2,1
"Poland",231,8,4,5,5,0,2
"Argentina",232,4,6,2,1,1,1
"Iceland",232,4,6,5,5,0,2
"Colombia",232,8,5,5,3,2,1
"Japan",232,8,5,4,3,1,2
"Brazil",233,5,6,3,2,1,1
"Costa Rica",233,5,4,3,2,1,2
"Uruguay",234,1,6,3,2,1,2
"Saudi Arabia",234,1,6,5,3,2,1
"Germany",234,6,7,7,3,4,1
"South Korea",234,6,4,3,3,0,2
"Uruguay",235,1,6,4,4,0,1
"Saudi Arabia",235,1,4,6,4,2,2
"Iceland",235,4,6,6,7,-1,1
"Argentina",235,4,4,5,3,2,2
"Brazil",235,5,7,5,1,4,1
"Serbia",235,5,7,2,0,2,2
"Germany",235,6,6,6,3,3,1
"South Korea",235,6,4,4,3,1,2
"France",236,3,7,5,2,3,1
"Peru",236,3,7,6,4,2,2
"Poland",236,8,6,4,3,1,1
"Japan",236,8,4,5,3,2,2
"Iran",237,2,6,3,2,1,1
"Morocco",237,2,6,2,3,-1,2
"Croatia",237,4,5,4,2,2,1
"Nigeria",237,4,5,2,1,1,2
"Belgium",237,7,6,5,3,2,1
"England",237,7,4,3,2,1,2
"Brazil",238,5,6,7,2,5,1
"Switzerland",238,5,6,5,3,2,2
"Spain",240,2,5,2,0,2,1
"Portugal",240,2,5,4,3,1,2
"France",240,3,4,1,1,0,2
"Denmark",240,3,4,3,2,1,1
"Colombia",240,8,6,4,2,2,2
"Japan",240,8,6,7,3,4,1
"Japan",241,8,6,6,3,3,1
"Poland",241,8,4,4,3,1,2
"Saudi Arabia",242,1,7,5,2,3,1
"Russia",242,1,4,7,5,2,2
"France",242,3,6,3,3,0,2
"Denmark",242,3,6,5,4,1,1
"Uruguay",243,1,6,7,3,4,1
"Saudi Arabia",243,1,6,4,4,0,2
"France",243,3,7,4,2,2,2
"Denmark",243,3,7,6,2,4,1
"Switzerland",243,5,6,4,5,-1,2
"Costa Rica",243,5,6,6,2,4,1
"Argentina",244,4,9,7,0,7,1
"Croatia",244,4,4,3,3,0,2
"Mexico",244,6,6,5,5,0,2
"South Korea",244,6,6,7,5,2,1
"France",245,3,9,9,3,6,1
"Peru",245,3,3,5,4,1,2
"Argentina",245,4,5,4,2,2,1
"Croatia",245,4,4,3,3,0,2
"Colombia",245,8,6,7,4,3,1
"Senegal",245,8,6,3,4,-1,2
"Switzerland",247,5,6,5,4,1,1
"Serbia",247,5,4,3,3,0,2
"Uruguay",248,1,5,3,1,2,1
"Saudi Arabia",248,1,5,3,2,1,2
"Peru",248,3,6,4,3,1,1
"France",248,3,4,2,1,1,2
"England",248,7,9,3,0,3,1
"Belgium",248,7,3,4,4,0,2
"Uruguay",249,1,6,6,1,5,1
"Egypt",249,1,6,3,2,1,2
"France",249,3,9,6,0,6,1
"Denmark",249,3,4,3,2,1,2
"Brazil",249,5,6,8,3,5,1
"Switzerland",249,5,6,6,4,2,2
"France",250,3,9,9,3,6,1
"Peru",250,3,4,4,3,1,2
"Colombia",250,8,7,5,2,3,2
"Poland",250,8,7,9,3,6,1
"Uruguay",251,1,6,6,1,5,1
"Russia",251,1,6,3,2,1,2
"Argentina",251,4,7,7,2,5,1
"Iceland",251,4,7,5,1,4,2
"Serbia",251,5,5,3,2,1,1
"Brazil",251,5,4,5,3,2,2
"Japan",251,8,5,3,1,2,2
"Poland",251,8,5,4,1,3,1
"Switzerland",252,5,5,4,3,1,2
"Costa Rica",252,5,5,8,3,5,1
"Belgium",252,7,6,4,2,2,2
"England",252,7,6,8,4,4,1
"Belgium",253,7,5,3,2,1,2
"England",253,7,5,3,0,3,1
"England",254,7,5,4,2,2,1
"Belgium",254,7,4,5,4,1,2
"Poland",254,8,5,3,1,2,1
"Japan",254,8,4,3,2,1,2
"Argentina",255,4,9,8,3,5,1
"Nigeria",255,4,3,3,4,-1,2
"Brazil",255,5,9,7,2,5,1
"Costa Rica",255,5,4,5,5,0,2
"Germany",255,6,9,6,2,4,1
"Mexico",255,6,3,4,4,0,2
"Egypt",256,1,5,3,1,2,1
"Russia",256,1,4,4,2,2,2
"Argentina",256,4,9,4,0,4,1
"Croatia",256,4,4,2,2,0,2
"Peru",257,3,9,7,1,6,1
"Australia",257,3,3,4,5,-1,2
"Colombia",257,8,9,8,2,6,1
"Poland",257,8,4,2,2,0,2
"Russia",258,1,6,4,2,2,1
"Saudi Arabia",258,1,6,2,1,1,2
"Argentina",258,4,6,5,2,3,1
"Iceland",258,4,6,3,3,0,2
"South Korea",258,6,6,3,2,1,2
"Germany",258,6,6,6,2,4,1
"Uruguay",259,1,7,4,0,4,1
"Egypt",259,1,4,4,3,1,2
"Egypt",260,1,7,7,4,3,1
"Uruguay",260,1,4,5,5,0,2
"Switzerland",260,5,9,11,3,8,1
"Brazil",260,5,3,3,4,-1,2
"Colombia",260,8,6,5,4,1,1
"Senegal",260,8,4,3,2,1,2
"Russia",261,1,5,3,1,2,1
"Uruguay",261,1,4,3,3,0,2
"Brazil",261,5,9,12,0,12,1
"Switzerland",261,5,3,4,6,-2,2
"Croatia",262,4,5,3,2,1,2
"Argentina",262,4,5,5,2,3,1
"Costa Rica",262,5,6,5,2,3,1
"Brazil",262,5,4,5,5,0,2
"Brazil",263,5,6,6,2,4,1
"Costa Rica",263,5,6,4,2,2,2
"Belgium",263,7,5,6,3,3,1
"Panama",263,7,5,4,3,1,2
"Japan",263,8,6,4,4,0,2
"Poland",263,8,6,5,4,1,1
"Uruguay",264,1,9,8,1,7,1
"Russia",264,1,3,1,2,-1,2
"Australia",264,3,6,6,3,3,1
"France",264,3,4,2,2,0,2
"Panama",264,7,7,5,2,3,1
"Tunisia",264,7,4,4,4,0,2
"Spain",265,2,6,3,2,1,1
"Iran",265,2,6,4,4,0,2
"England",265,7,9,5,0,5,1
"Belgium",265,7,4,6,3,3,2
"Egypt",266,1,9,7,2,5,1
"Uruguay",266,1,3,6,5,1,2
"Croatia",266,4,7,4,1,3,1
"Argentina",266,4,7,3,1,2,2
"Belgium",266,7,7,7,3,4,1
"Tunisia",266,7,4,4,4,0,2
"Senegal",266,8,6,3,4,-1,1
"Colombia",266,8,4,4,2,2,2
"Mexico",267,6,5,2,1,1,1
"South Korea",267,6,4,3,2,1,2
"Colombia",267,8,5,4,2,2,1
"Japan",267,8,4,2,2,0,2
"Russia",268,1,5,3,2,1,2
"Saudi Arabia",268,1,5,5,3,2,1
"Mexico",268,6,6,7,2,5,1
"South Korea",268,6,6,5,3,2,2
"Belgium",268,7,7,4,0,4,2
"England",268,7,7,5,0,5,1
"Uruguay",269,1,6,5,2,3,1
"Russia",269,1,6,3,2,1,2
"France",269,3,7,5,3,2,1
"Denmark",269,3,4,7,5,2,2
"Brazil",270,5,7,6,2,4,1
"Costa Rica",270,5,7,4,1,3,2
"South Korea",270,6,6,5,4,1,2
"Germany",270,6,6,6,2,4,1
"Saudi Arabia",271,1,6,3,4,-1,1
"Egypt",271,1,4,3,1,2,2
"Sweden",271,6,6,3,1,2,1
"South Korea",271,6,6,2,3,-1,2
"Spain",272,2,7,5,1,4,1
"Iran",272,2,4,4,3,1,2
"Poland",272,8,7,6,2,4,1
"Japan",272,8,4,3,3,0,2
"Argentina",273,4,7,5,1,4,1
"Croatia",273,4,4,3,3,0,2
"Brazil",273,5,6,6,2,4,1
"Serbia",273,5,6,2,1,1,2
"South Korea",273,6,6,5,4,1,2
"Germany",273,6,6,5,2,3,1
"Colombia",273,8,6,3,5,-2,1
"Senegal",273,8,4,5,3,2,2
"Mexico",274,6,6,8,5,3,1
"South Korea",274,6,4,2,2,0,2
"Japan",274,8,6,6,3,3,1
"Poland",274,8,6,3,3,0,2
"Germany",275,6,6,4,2,2,1
"Mexico",275,6,4,2,2,0,2
"Colombia",275,8,6,5,2,3,1
"Senegal",275,8,6,4,2,2,2
"Uruguay",276,1,7,8,2,6,1
"Egypt",276,1,4,3,3,0,2
"Iran",276,2,6,3,2,1,1
"Spain",276,2,4,4,1,3,2
"Croatia",276,4,6,5,4,1,2
"Argentina",276,4,6,6,2,4,1
"Costa Rica",277,5,6,4,2,2,1
"Switzerland",277,5,4,7,5,2,2
"France",278,3,7,7,4,3,1
"Australia",278,3,7,3,1,2,2
"Mexico",280,6,6,4,2,2,1
"Germany",280,6,4,2,2,0,2
"Belgium",281,7,9,7,0,7,1
"England",281,7,4,1,1,0,2
"Nigeria",282,4,5,2,1,1,1
"Croatia",282,4,4,3,2,1,2
"France",283,3,9,6,0,6,1
"Denmark",283,3,3,2,3,-1,2
"England",283,7,6,6,2,4,1
"Tunisia",283,7,6,4,4,0,2
"Japan",283,8,6,6,4,2,1
"Colombia",283,8,4,5,5,0,2
"Germany",284,6,7,4,1,3,1
"Mexico",284,6,4,3,3,0,2
"France",285,3,6,5,2,3,1
"Denmark",285,3,6,2,3,-1,2
"Spain",286,2,6,6,2,4,1
"Portugal",286,2,4,4,3,1,2
"France",286,3,6,3,1,2,2
"Peru",286,3,6,6,3,3,1
"England",286,7,6,6,5,1,2
"Panama",286,7,6,6,4,2,1
"Spain",287,2,6,7,2,5,1
"Portugal",287,2,6,5,5,0,2
"Mexico",287,6,6,6,4,2,1
"South Korea",287,6,4,6,5,1,2
"Japan",287,8,6,5,3,2,2
"Poland",287,8,6,5,2,3,1
"Australia",288,3,7,4,1,3,1
"Denmark",288,3,4,5,3,2,2
"Croatia",288,4,6,2,2,0,2
"Nigeria",288,4,6,3,2,1,1
"Belgium",288,7,7,5,2,3,1
"Panama",288,7,4,3,3,0,2
"Iran",289,2,6,3,2,1,1
"Portugal",289,2,4,3,1,2,2
"Croatia",289,4,7,4,2,2,1
"Argentina",289,4,4,3,2,1,2
"Brazil",289,5,9,10,3,7,1
"Costa Rica",289,5,4,4,3,1,2
"England",289,7,7,3,0,3,1
"Belgium",289,7,4,4,3,1,2
"Japan",289,8,7,5,2,3,1
"Senegal",289,8,7,3,1,2,2
"Brazil",290,5,7,3,1,2,2
"Costa Rica",290,5,7,5,2,3,1
"Uruguay",292,1,6,4,3,1,2
"Egypt",292,1,6,3,1,2,1
"Iran",293,2,9,7,2,5,1
"Portugal",293,2,4,5,4,1,2
"Brazil",293,5,6,9,5,4,1
"Costa Rica",293,5,6,5,6,-1,2
"Egypt",294,1,9,8,2,6,1
"Uruguay",294,1,3,4,3,1,2
"Spain",294,2,9,10,2,8,1
"Portugal",294,2,3,5,4,1,2
"Sweden",294,6,6,7,6,1,1
"Germany",294,6,4,7,6,1,2
"Uruguay",295,1,9,9,0,9,1
"Egypt",295,1,2,2,3,-1,2
"Iran",295,2,9,9,1,8,1
"Portugal",295,2,4,5,3,2,2
"Argentina",295,4,9,9,1,8,1
"Iceland",295,4,4,2,2,0,2
"Uruguay",296,1,6,4,2,2,1
"Egypt",296,1,4,4,4,0,2
"France",296,3,9,11,1,10,1
"Peru",296,3,4,3,3,0,2
"Sweden",296,6,5,4,2,2,2
"South Korea",296,6,5,6,2,4,1
"Brazil",297,5,7,6,2,4,1
"Costa Rica",297,5,4,5,4,1,2
"Senegal",297,8,6,2,1,1,1
"Poland",297,8,6,3,3,0,2
"France",298,3,9,7,2,5,1
"Peru",298,3,4,3,3,0,2
"Brazil",298,5,5,7,2,5,1
"Switzerland",298,5,5,5,4,1,2
"Mexico",298,6,7,3,1,2,2
"Germany",298,6,7,6,0,6,1
"France",299,3,9,4,0,4,1
"Denmark",299,3,4,5,4,1,2
"Brazil",299,5,6,2,1,1,2
"Costa Rica",299,5,6,7,3,4,1
"Tunisia",299,7,6,2,3,-1,1
"Belgium",299,7,4,4,3,1,2
"Japan",299,8,6,3,2,1,2
"Senegal",299,8,6,4,1,3,1
"Uruguay",300,1,5,5,4,1,2
"Russia",300,1,5,4,2,2,1
"France",300,3,9,7,2,5,1
"Denmark",300,3,3,5,5,0,2
"Belgium",300,7,5,3,2,1,2
"Tunisia",300,7,5,3,1,2,1
"Argentina",301,4,5,3,2,1,1
"Iceland",301,4,4,4,4,0,2
"Brazil",301,5,6,5,1,4,1
"Serbia",301,5,6,2,3,-1,2
"Colombia",301,8,5,3,1,2,1
"Poland",301,8,5,4,3,1,2
"Iran",302,2,6,6,3,3,1
"Spain",302,2,4,4,4,0,2
"South Korea",302,6,5,4,3,1,1
"Germany",302,6,4,11,3,8,2
"Colombia",302,8,6,3,1,2,2
"Japan",302,8,6,6,1,5,1
"Uruguay",303,1,5,5,3,2,1
"Saudi Arabia",303,1,4,3,3,0,2
"Mexico",303,6,6,4,3,1,1
"South Korea",303,6,4,4,3,1,2
"Colombia",303,8,5,5,1,4,1
"Japan",303,8,4,3,2,1,2
"France",304,3,9,6,1,5,1
"Peru",304,3,4,2,2,0,2
"Senegal",304,8,5,1,0,1,1
"Japan",304,8,4,3,2,1,2
"Russia",305,1,6,5,4,1,2
"Egypt",305,1,6,5,2,3,1
"Spain",305,2,6,4,3,1,1
"Iran",305,2,6,5,6,-1,2
"Croatia",305,4,7,4,1,3,2
"Argentina",305,4,7,7,2,5,1
"Poland",305,8,6,7,3,4,1
"Japan",305,8,4,1,2,-1,2
"Morocco",306,2,5,3,2,1,1
"Spain",306,2,4,3,1,2,2
"Argentina",306,4,9,3,0,3,1
"Nigeria",306,4,3,3,3,0,2
"Brazil",306,5,5,4,1,3,1
"Costa Rica",306,5,5,4,2,2,2
"Argentina",307,4,7,5,1,4,1
"Iceland",307,4,7,5,3,2,2
"England",307,7,7,6,2,4,1
"Belgium",307,7,4,4,4,0,2
"France",308,3,6,5,4,1,2
"Peru",308,3,6,4,2,2,1
"Poland",308,8,6,3,3,0,1
"Japan",308,8,4,2,1,1,2
"Saudi Arabia",310,1,6,2,2,0,1
"Egypt",310,1,4,2,1,1,2
"Spain",310,2,6,6,2,4,1
"Portugal",310,2,6,5,2,3,2
"Serbia",311,5,9,4,0,4,1
"Costa Rica",311,5,3,5,4,1,2
"Uruguay",312,1,7,3,1,2,2
"Russia",312,1,7,4,1,3,1
"Croatia",312,4,7,4,1,3,1
"Argentina",312,4,4,2,1,1,2
"Mexico",312,6,6,4,2,2,1
"South Korea",312,6,4,4,3,1,2
"Poland",312,8,9,6,3,3,1
"Japan",312,8,4,5,3,2,2
"Brazil",313,5,6,4,2,2,1
"Switzerland",313,5,4,2,1,1,2
"South Korea",313,6,6,4,3,1,2
"Germany",313,6,6,8,2,6,1
"Belgium",313,7,5,2,1,1,2
"England",313,7,5,3,1,2,1
"Germany",314,6,9,10,1,9,1
"Mexico",314,6,3,5,6,-1,2
"England",315,7,6,8,1,7,1
"Belgium",315,7,4,2,2,0,2
"Uruguay",316,1,9,7,2,5,1
"Egypt",316,1,3,1,2,-1,2
"Germany",316,6,9,14,0,14,1
"Sweden",316,6,4,2,3,-1,2
"Argentina",317,4,7,5,1,4,1
"Nigeria",317,4,7,4,1,3,2
"Poland",317,8,5,2,1,1,1
"Japan",317,8,4,2,1,1,2
"Russia",318,1,6,3,2,1,1
"Egypt",318,1,6,4,4,0,2
"South Korea",318,6,6,4,4,0,2
"Germany",318,6,6,4,2,2,1
"Iran",319,2,7,10,5,5,1
"Spain",319,2,4,4,4,0,2
"Belgium",319,7,6,12,5,7,1
"England",319,7,6,6,4,2,2
"Spain",320,2,7,3,0,3,2
"Morocco",320,2,7,5,1,4,1
"France",321,3,6,4,2,2,1
"Peru",321,3,6,3,2,1,2
"Brazil",321,5,6,7,3,4,1
"Costa Rica",321,5,4,4,2,2,2
"Colombia",321,8,7,3,1,2,2
"Japan",321,8,7,5,1,4,1
"Sweden",322,6,6,3,3,0,2
"South Korea",322,6,6,5,2,3,1
"Peru",323,3,6,4,3,1,1
"France",323,3,4,4,3,1,2
"Brazil",323,5,7,5,2,3,1
"Switzerland",323,5,4,3,2,1,2
"England",324,7,5,3,2,1,1
"Belgium",324,7,4,5,3,2,2
"France",325,3,5,4,1,3,1
"Peru",325,3,5,3,1,2,2
"England",325,7,6,6,3,3,1
"Belgium",325,7,4,5,5,0,2
"Spain",327,2,6,8,1,7,1
"Portugal",327,2,6,7,2,5,2
"Brazil",327,5,7,7,0,7,1
"Switzerland",327,5,7,3,1,2,2
"Iran",328,2,5,3,2,1,1
"Portugal",328,2,4,4,2,2,2
"Argentina",328,4,6,7,2,5,1
"Nigeria",328,4,6,4,2,2,2
"Spain",329,2,5,6,3,3,1
"Portugal",329,2,5,5,3,2,2
"Colombia",329,8,6,5,2,3,1
"Poland",329,8,4,4,4,0,2
"Uruguay",330,1,9,8,2,6,1
"Russia",330,1,4,6,5,1,2
"Brazil",330,5,6,3,1,2,1
"Serbia",330,5,4,1,1,0,2
"England",331,7,6,7,4,3,1
"Belgium",331,7,4,2,1,1,2
"Japan",331,8,5,4,2,2,1
"Colombia",331,8,4,5,3,2,2
"Brazil",332,5,5,3,2,1,1
"Serbia",332,5,4,4,2,2,2
"Colombia",333,8,6,4,3,1,2
"Senegal",333,8,6,4,2,2,1
"Germany",334,6,7,5,1,4,1
"Sweden",334,6,4,3,2,1,2
"Croatia",335,4,6,4,1,3,1
"Argentina",335,4,6,2,1,1,2
"Mexico",335,6,6,8,3,5,1
"South Korea",335,6,6,4,1,3,2
"Belgium",335,7,7,7,1,6,1
"England",335,7,7,5,2,3,2
"Senegal",335,8,6,3,4,-1,1
"Poland",335,8,4,7,6,1,2
"Sweden",336,6,6,6,4,2,2
"South Korea",336,6,6,5,1,4,1
"Denmark",337,3,4,4,4,0,2
"Australia",337,3,4,5,4,1,1
"Brazil",337,5,5,4,2,2,1
"Serbia",337,5,4,4,3,1,2
"Uruguay",338,1,9,7,1,6,1
"Egypt",338,1,4,6,3,3,2
"Senegal",338,8,6,4,5,-1,1
"Colombia",338,8,4,8,4,4,2
"Uruguay",339,1,7,8,3,5,1
"Russia",339,1,7,5,3,2,2
"Croatia",339,4,4,6,5,1,1
"Nigeria",339,4,4,2,2,0,2
"South Korea",339,6,5,6,2,4,1
"Germany",339,6,5,2,1,1,2
"Panama",339,7,9,5,2,3,1
"England",339,7,4,5,4,1,2
"France",340,3,5,3,1,2,1
"Denmark",340,3,4,4,3,1,2
"Brazil",340,5,7,6,0,6,1
"Costa Rica",340,5,7,5,1,4,2
"England",340,7,7,4,1,3,1
"Tunisia",340,7,4,4,2,2,2
"Russia",341,1,6,4,3,1,1
"Egypt",341,1,6,3,3,0,2
"Spain",341,2,6,5,4,1,2
"Iran",341,2,6,6,4,2,1
"Mexico",341,6,6,3,2,1,2
"Germany",341,6,6,7,4,3,1
"Belgium",341,7,6,6,4,2,1
"England",341,7,6,3,2,1,2
"Colombia",341,8,5,4,3,1,2
"Senegal",341,8,5,4,2,2,1
"Russia",342,1,9,7,1,6,1
"Egypt",342,1,4,2,3,-1,2
"Spain",342,2,7,4,1,3,2
"Iran",342,2,7,6,2,4,1
"Serbia",342,5,6,4,4,0,1
"Brazil",342,5,4,3,1,2,2
"Sweden",342,6,9,10,2,8,1
"South Korea",342,6,4,4,4,0,2
"Colombia",343,8,6,5,3,2,2
"Japan",343,8,6,4,1,3,1
"Uruguay",344,1,6,4,1,3,1
"Russia",344,1,4,2,2,0,2
"Croatia",345,4,7,2,0,2,2
"Argentina",345,4,7,5,1,4,1
"Uruguay",346,1,6,6,4,2,2
"Egypt",346,1,6,7,4,3,1
"Spain",346,2,5,6,5,1,1
"Portugal",346,2,4,5,4,1,2
"Argentina",346,4,7,4,1,3,1
"Croatia",346,4,4,6,4,2,2
"Egypt",347,1,9,3,0,3,1
"Saudi Arabia",347,1,3,4,4,0,2
"Portugal",347,2,7,2,0,2,2
"Iran",347,2,7,3,0,3,1
"Germany",347,6,6,6,4,2,1
"Mexico",347,6,4,3,2,1,2
"England",347,7,5,4,2,2,1
"Tunisia",347,7,4,3,3,0,2
"Colombia",347,8,7,4,1,3,1
"Japan",347,8,4,3,1,2,2
"Spain",349,2,5,5,3,2,1
"Morocco",349,2,4,6,6,0,2
"Germany",350,6,9,9,3,6,1
"South Korea",350,6,4,4,4,0,2
"Russia",351,1,5,4,2,2,1
"Egypt",351,1,5,3,2,1,2
"Argentina",351,4,9,6,1,5,1
"Nigeria",351,4,2,2,3,-1,2
"Belgium",351,7,7,7,1,6,1
"England",351,7,7,7,2,5,2
"Uruguay",352,1,6,6,5,1,2
"Russia",352,1,6,5,1,4,1
"Brazil",352,5,9,10,2,8,1
"Costa Rica",352,5,4,1,1,0,2
"Mexico",352,6,5,4,3,1,2
"Germany",352,6,5,4,2,2,1
"Brazil",353,5,9,6,1,5,1
"Costa Rica",353,5,4,5,3,2,2
"Poland",353,8,7,5,1,4,1
"Japan",353,8,4,3,2,1,2
"Sweden",354,6,5,6,4,2,1
"Germany",354,6,4,5,5,0,2
"Japan",354,8,5,4,3,1,1
"Poland",354,8,4,4,3,1,2
"Russia",355,1,5,7,5,2,1
"Egypt",355,1,5,6,5,1,2
"Argentina",355,4,6,3,4,-1,2
"Iceland",355,4,6,6,2,4,1
"South Korea",355,6,6,9,3,6,1
"Mexico",355,6,4,4,4,0,2
"France",356,3,6,7,3,4,1
"Denmark",356,3,6,4,2,2,2
"Mexico",356,6,6,5,2,3,1
"South Korea",356,6,4,4,5,-1,2
"Tunisia",356,7,6,6,4,2,1
"Panama",356,7,6,4,3,1,2
"Japan",356,8,6,6,4,2,1
"Senegal",356,8,6,6,5,1,2
"Uruguay",357,1,6,4,2,2,1
"Russia",357,1,4,2,2,0,2
"France",357,3,6,4,2,2,1
"Australia",357,3,6,3,3,0,2
"Brazil",357,5,7,6,2,4,1
"Costa Rica",357,5,4,5,3,2,2
"England",357,7,6,7,3,4,1
"Panama",357,7,6,4,4,0,2
"Mexico",358,6,5,4,3,1,2
"South Korea",358,6,5,7,5,2,1
"Poland",358,8,9,7,2,5,1
"Senegal",358,8,4,4,3,1,2
"Uruguay",359,1,6,4,1,3,1
"Egypt",359,1,6,3,2,1,2
"Argentina",359,4,6,5,2,3,1
"Croatia",359,4,4,5,4,1,2
"Mexico",359,6,6,5,5,0,2
"Germany",359,6,6,8,3,5,1
"Saudi Arabia",360,1,4,6,4,2,1
"Egypt",360,1,4,4,3,1,2
"Denmark",361,3,5,1,0,1,1
"France",361,3,4,4,4,0,2
"Germany",361,6,9,6,1,5,1
"South Korea",361,6,3,6,3,3,2
"Belgium",361,7,9,8,3,5,1
"Panama",361,7,4,5,3,2,2
"Uruguay",363,1,5,3,1,2,1
"Russia",363,1,4,1,1,0,2
"Portugal",363,2,6,6,2,4,1
"Iran",363,2,6,3,3,0,2
"Germany",363,6,9,11,3,8,1
"South Korea",363,6,2,3,5,-2,2
"England",363,7,9,8,1,7,1
"Tunisia",363,7,3,2,3,-1,2
"Argentina",364,4,6,5,3,2,2
"Nigeria",364,4,6,5,2,3,1
"Uruguay",365,1,7,6,1,5,1
"Saudi Arabia",365,1,7,3,1,2,2
"Uruguay",366,1,6,6,5,1,2
"Russia",366,1,6,12,4,8,1
"France",366,3,7,3,1,2,2
"Peru",366,3,7,6,2,4,1
"Argentina",366,4,9,6,1,5,1
"Nigeria",366,4,2,1,2,-1,2
"Brazil",366,5,7,6,2,4,1
"Serbia",366,5,7,6,3,3,2
"Spain",367,2,7,4,2,2,2
"Portugal",367,2,7,6,1,5,1
"Argentina",367,4,6,4,1,3,1
"Nigeria",367,4,6,2,1,1,2
"Germany",367,6,7,4,0,4,1
"Mexico",367,6,4,5,3,2,2
"Uruguay",368,1,9,7,1,6,1
"Russia",368,1,2,3,4,-1,2
"Germany",368,6,6,6,4,2,1
"Mexico",368,6,4,3,1,2,2
"Portugal",370,2,5,3,2,1,1
"Spain",370,2,4,5,1,4,2
"Peru",370,3,7,5,1,4,1
"Denmark",370,3,4,3,2,1,2
"Croatia",370,4,7,2,0,2,2
"Argentina",370,4,7,8,1,7,1
"Brazil",370,5,6,7,2,5,1
"Costa Rica",370,5,4,3,3,0,2
"South Korea",371,6,6,4,2,2,1
"Germany",371,6,4,4,2,2,2
"Belgium",371,7,7,2,0,2,2
"England",371,7,7,5,1,4,1
"France",372,3,6,7,2,5,1
"Peru",372,3,6,5,3,2,2
"Croatia",372,4,6,7,2,5,1
"Argentina",372,4,6,2,1,1,2
"Brazil",372,5,6,5,2,3,1
"Costa Rica",372,5,4,3,3,0,2
"Germany",372,6,6,4,1,3,1
"South Korea",372,6,4,4,3,1,2
"England",373,7,9,7,0,7,1
"Belgium",373,7,3,5,6,-1,2
"Poland",373,8,6,8,3,5,1
"Colombia",373,8,4,4,3,1,2
"South Korea",374,6,5,4,3,1,2
"Germany",374,6,5,5,3,2,1
"Belgium",374,7,7,8,3,5,1
"England",374,7,7,5,1,4,2
"Colombia",374,8,6,5,3,2,1
"Japan",374,8,4,2,2,0,2
"South Korea",375,6,6,4,1,3,1
"Germany",375,6,6,4,4,0,2
"Belgium",375,7,7,7,2,5,1
"England",375,7,7,5,1,4,2
"Spain",376,2,7,5,1,4,1
"Iran",376,2,7,4,1,3,2
"Argentina",376,4,7,6,2,4,1
"Iceland",376,4,7,2,0,2,2
"Belgium",376,7,7,7,1,6,1
"England",376,7,7,4,2,2,2
"Uruguay",377,1,5,4,2,2,2
"Russia",377,1,5,8,4,4,1
"Mexico",377,6,6,5,2,3,1
"Germany",377,6,6,4,2,2,2
"Spain",378,2,6,6,3,3,1
"Portugal",378,2,4,4,4,0,2
"Brazil",379,5,9,7,2,5,1
"Switzerland",379,5,3,5,5,0,2
"Mexico",380,6,6,4,4,0,1
"South Korea",380,6,4,3,2,1,2
"Poland",380,8,5,3,2,1,1
"Colombia",380,8,4,2,1,1,2
"Uruguay",381,1,6,5,2,3,1
"Egypt",381,1,6,4,4,0,2
"Uruguay",382,1,6,3,4,-1,2
"Russia",382,1,6,2,1,1,1
"Spain",382,2,9,10,2,8,1
"Iran",382,2,3,4,5,-1,2
"Australia",382,3,5,5,4,1,1
"Peru",382,3,4,5,3,2,2
"Brazil",382,5,5,3,2,1,1
"Serbia",382,5,4,4,3,1,2
"Belgium",382,7,6,5,4,1,2
"England",382,7,6,6,3,3,1
"Uruguay",383,1,5,4,2,2,1
"Saudi Arabia",383,1,5,5,4,1,2
"Colombia",383,8,7,7,2,5,1
"Japan",383,8,4,4,3,1,2
"Argentina",384,4,9,8,2,6,1
"Croatia",384,4,4,4,2,2,2
"Belgium",384,7,6,4,3,1,2
"England",384,7,6,5,2,3,1
"Senegal",384,8,6,4,3,1,2
"Poland",384,8,6,8,5,3,1
"England",385,7,9,6,0,6,1
"Tunisia",385,7,3,1,2,-1,2
"Uruguay",386,1,9,7,1,6,1
"Russia",386,1,4,4,3,1,2
"Argentina",386,4,5,5,2,3,1
"Nigeria",386,4,5,5,4,1,2
"France",387,3,7,10,2,8,1
"Peru",387,3,7,7,3,4,2
"Brazil",387,5,6,7,3,4,1
"Costa Rica",387,5,6,4,3,1,2
"Uruguay",388,1,7,6,0,6,1
"Saudi Arabia",388,1,7,4,1,3,2
"Brazil",388,5,9,8,1,7,1
"Switzerland",388,5,3,2,3,-1,2
"Sweden",388,6,6,4,2,2,1
"South Korea",388,6,4,4,4,0,2
"Colombia",388,8,7,5,1,4,1
"Japan",388,8,7,2,0,2,2
"Spain",389,2,6,4,1,3,2
"Portugal",389,2,6,5,1,4,1
"Sweden",389,6,5,5,2,3,1
"Germany",389,6,5,4,3,1,2
"Argentina",390,4,9,9,0,9,1
"Croatia",390,4,4,2,3,-1,2
"Brazil",390,5,9,6,1,5,1
"Costa Rica",390,5,4,3,2,1,2
"Uruguay",391,1,6,2,1,1,1
"Russia",391,1,6,3,3,0,2
"Brazil",391,5,6,4,2,2,1
"Switzerland",391,5,4,3,3,0,2
"Germany",391,6,5,5,2,3,1
"Mexico",391,6,4,3,3,0,2
"England",392,7,9,7,2,5,1
"Belgium",392,7,4,4,3,1,2
"Spain",393,2,7,10,2,8,1
"Portugal",393,2,7,3,1,2,2
"Denmark",393,3,6,5,4,1,2
"Australia",393,3,6,6,3,3,1
"Mexico",393,6,6,5,2,3,1
"Germany",393,6,4,6,4,2,2
"Egypt",394,1,9,5,1,4,1
"Russia",394,1,3,4,3,1,2
"Portugal",394,2,5,4,3,1,1
"Spain",394,2,4,4,3,1,2
"Uruguay",395,1,6,4,1,3,1
"Saudi Arabia",395,1,6,2,1,1,2
"Peru",395,3,6,4,1,3,1
"Australia",395,3,4,2,1,1,2
"Croatia",395,4,6,4,4,0,2
"Argentina",395,4,6,7,4,3,1
"Spain",396,2,6,5,2,3,1
"Iran",396,2,6,2,2,0,2
"Uruguay",397,1,6,6,4,2,1
"Russia",397,1,6,3,2,1,2
"Portugal",397,2,5,1,0,1,1
"Spain",397,2,4,4,3,1,2
"Mexico",397,6,5,4,3,1,1
"Sweden",397,6,4,4,3,1,2
"Poland",397,8,6,4,1,3,1
"Colombia",397,8,4,1,1,0,2
"Uruguay",398,1,6,7,4,3,1
"Russia",398,1,6,3,3,0,2
"South Korea",398,6,5,3,1,2,1
"Germany",398,6,4,3,3,0,2
"Colombia",398,8,7,4,1,3,1
"Poland",398,8,4,3,2,1,2
"Portugal",400,2,7,5,3,2,2
"Iran",400,2,7,7,2,5,1
"Denmark",400,3,7,5,2,3,1
"Peru",400,3,7,6,4,2,2
"Croatia",400,4,7,4,2,2,2
"Argentina",400,4,7,8,0,8,1
"Denmark",401,3,5,1,0,1,2
"Peru",401,3,5,2,0,2,1
"Croatia",401,4,6,6,2,4,1
"Argentina",401,4,6,6,3,3,2
"Serbia",401,5,6,3,4,-1,2
"Costa Rica",401,5,6,3,1,2,1
"Belgium",401,7,6,6,3,3,1
"England",401,7,6,4,2,2,2
"Colombia",401,8,4,4,2,2,1
"Japan",401,8,4,4,4,0,2
"Spain",402,2,9,6,0,6,1
"Iran",402,2,3,4,5,-1,2
"England",402,7,7,7,2,5,1
"Belgium",402,7,4,5,6,-1,2
"Portugal",403,2,6,4,3,1,2
"Iran",403,2,6,4,2,2,1
"Germany",403,6,7,6,2,4,1
"Sweden",403,6,4,5,5,0,2
"Uruguay",404,1,6,7,3,4,1
"Russia",404,1,6,5,3,2,2
"Spain",404,2,9,7,3,4,1
"Iran",404,2,4,3,3,0,2
"Australia",404,3,6,4,4,0,1
"France",404,3,4,5,4,1,2
"Costa Rica",404,5,6,6,4,2,1
"Brazil",404,5,4,4,4,0,2
"South Korea",404,6,7,2,0,2,2
"Germany",404,6,7,4,1,3,1
"Spain",405,2,7,4,2,2,2
"Portugal",405,2,7,6,1,5,1
"Brazil",405,5,6,4,4,0,2
"Costa Rica",405,5,6,4,2,2,1
"Colombia",405,8,7,4,0,4,1
"Poland",405,8,4,3,2,1,2
"Croatia",408,4,6,5,1,4,1
"Argentina",408,4,4,2,2,0,2
"Mexico",408,6,6,6,6,0,2
"Germany",408,6,6,6,2,4,1
"Japan",408,8,6,6,4,2,1
"Senegal",408,8,4,2,2,0,2
"Uruguay",409,1,6,3,1,2,1
"Saudi Arabia",409,1,6,2,3,-1,2
"Spain",410,2,6,7,3,4,1
"Portugal",410,2,6,7,4,3,2
"France",411,3,7,6,2,4,1
"Peru",411,3,7,4,1,3,2
"Germany",411,6,9,8,1,7,1
"Mexico",411,6,4,4,5,-1,2
"Uruguay",412,1,7,4,2,2,2
"Egypt",412,1,7,4,1,3,1
"Spain",412,2,9,7,1,6,1
"Iran",412,2,4,2,1,1,2
"Argentina",412,4,7,7,3,4,1
"Nigeria",412,4,4,4,4,0,2
"Brazil",413,5,9,8,2,6,1
"Switzerland",413,5,4,1,1,0,2
"South Korea",413,6,5,3,2,1,2
"Germany",413,6,5,6,4,2,1
"Uruguay",414,1,5,4,3,1,2
"Russia",414,1,5,6,2,4,1
"Spain",414,2,5,6,4,2,1
"Iran",414,2,4,4,3,1,2
"Argentina",414,4,6,8,2,6,1
"Nigeria",414,4,6,3,1,2,2
"Brazil",414,5,7,5,3,2,2
"Costa Rica",414,5,7,6,2,4,1
"France",415,3,5,3,1,2,1
"Peru",415,3,5,2,1,1,2
"Spain",416,2,7,5,1,4,1
"Portugal",416,2,7,5,2,3,2
"Croatia",416,4,7,5,2,3,2
"Argentina",416,4,7,5,1,4,1
"Germany",416,6,9,7,0,7,1
"South Korea",416,6,4,4,5,-1,2
"England",416,7,9,5,1,4,1
"Tunisia",416,7,4,2,1,1,2
"France",417,3,5,4,3,1,1
"Denmark",417,3,4,6,5,1,2
"Croatia",417,4,5,5,2,3,1
"Argentina",417,4,4,4,3,1,2
"Switzerland",417,5,6,6,4,2,1
"Brazil",417,5,4,8,3,5,2
"Tunisia",417,7,7,3,1,2,1
"Belgium",417,7,4,3,1,2,2
"Costa Rica",418,5,6,4,7,-3,1
"Brazil",418,5,4,6,3,3,2
"Belgium",418,7,6,3,2,1,2
"England",418,7,6,4,2,2,1
"Colombia",419,8,9,5,1,4,1
"Japan",419,8,4,3,1,2,2
"France",420,3,9,9,2,7,1
"Peru",420,3,3,3,4,-1,2
"Croatia",420,4,7,4,2,2,2
"Argentina",420,4,7,5,0,5,1
"Croatia",421,4,7,6,1,5,1
"Argentina",421,4,7,3,0,3,2
"Uruguay",422,1,4,2,1,1,1
"Russia",422,1,4,4,4,0,2
"Brazil",422,5,6,7,1,6,1
"Switzerland",422,5,6,4,3,1,2
"England",422,7,9,9,2,7,1
"Belgium",422,7,3,3,4,-1,2
"Colombia",422,8,6,3,2,1,2
"Japan",422,8,6,5,2,3,1
"Croatia",423,4,9,5,1,4,1
"Argentina",423,4,4,5,3,2,2
"France",424,3,9,7,3,4,1
"Peru",424,3,4,4,1,3,2
"Belgium",424,7,9,7,0,7,1
"Panama",424,7,3,3,4,-1,2
"France",425,3,6,5,2,3,1
"Denmark",425,3,4,5,5,0,2
"Belgium",426,7,9,6,1,5,1
"England",426,7,3,3,4,-1,2
"Portugal",427,2,6,6,3,3,1
"Iran",427,2,6,3,2,1,2
"Japan",427,8,5,4,0,4,1
"Colombia",427,8,4,3,2,1,2
"France",428,3,7,5,0,5,1
"Denmark",428,3,7,3,0,3,2
"Belgium",429,7,7,4,2,2,2
"England",429,7,7,4,1,3,1
"Uruguay",430,1,6,6,1,5,1
"Egypt",430,1,6,5,3,2,2
"Spain",430,2,6,6,5,1,1
"Morocco",430,2,4,3,3,0,2
"France",430,3,6,3,3,0,1
"Australia",430,3,4,4,3,1,2
"Belgium",430,7,6,5,4,1,2
"England",430,7,6,6,2,4,1
"Japan",430,8,6,3,3,0,2
"Poland",430,8,6,6,5,1,1
"Egypt",431,1,7,6,2,4,1
"Saudi Arabia",431,1,4,3,3,0,2
"Colombia",431,8,9,6,2,4,1
"Poland",431,8,4,3,1,2,2
"Uruguay",432,1,6,3,2,1,1
"Saudi Arabia",432,1,4,5,3,2,2
"Brazil",432,5,6,5,3,2,1
"Switzerland",432,5,6,5,5,0,2
"Germany",432,6,9,9,0,9,1
"South Korea",432,6,2,0,1,-1,2
"Egypt",433,1,5,2,1,1,1
"Russia",433,1,4,5,3,2,2
"France",433,3,6,5,2,3,1
"Australia",433,3,6,3,3,0,2
"Sweden",433,6,7,3,1,2,2
"Germany",433,6,7,5,1,4,1
"Uruguay",434,1,5,3,1,2,1
"Russia",434,1,5,4,3,1,2
"Iran",434,2,9,6,2,4,1
"Spain",434,2,4,8,4,4,2
"Costa Rica",434,5,5,4,2,2,1
"Brazil",434,5,4,3,2,1,2
"Mexico",434,6,7,6,2,4,2
"Germany",434,6,7,8,2,6,1
"Colombia",434,8,5,4,3,1,2
"Japan",434,8,5,5,3,2,1
"Russia",435,1,5,5,2,3,1
"Egypt",435,1,5,6,4,2,2
"Spain",435,2,6,5,3,2,1
"Iran",435,2,4,4,2,2,2
"Australia",435,3,6,6,2,4,1
"Peru",435,3,4,2,1,1,2
"Switzerland",435,5,6,6,3,3,1
"Serbia",435,5,6,5,5,0,2
"Mexico",435,6,7,6,2,4,2
"Germany",435,6,7,8,2,6,1
"Spain",436,2,5,4,3,1,2
"Portugal",436,2,5,6,3,3,1
"Argentina",436,4,6,6,3,3,1
"Croatia",436,4,4,4,4,0,2
"England",436,7,5,8,4,4,1
"Panama",436,7,5,3,2,1,2
"Mexico",437,6,6,2,1,1,2
"Germany",437,6,6,6,1,5,1
"Uruguay",438,1,9,4,0,4,1
"Egypt",438,1,3,3,3,0,2
"Portugal",438,2,6,2,2,0,1
"Iran",438,2,4,5,4,1,2
"South Korea",438,6,7,7,5,2,1
"Sweden",438,6,4,7,5,2,2
"Belgium",438,7,5,4,2,2,1
"Tunisia",438,7,4,5,4,1,2
"Nigeria",439,4,6,4,2,2,1
"Croatia",439,4,4,3,3,0,2
"Uruguay",440,1,6,8,3,5,1
"Saudi Arabia",440,1,6,5,5,0,2
"Argentina",440,4,6,3,2,1,2
"Iceland",440,4,6,4,2,2,1
"Croatia",441,4,6,5,2,3,2
"Iceland",441,4,6,7,2,5,1
"Japan",441,8,7,6,4,2,2
"Poland",441,8,7,8,2,6,1
"Uruguay",442,1,9,5,1,4,1
"Russia",442,1,4,4,1,3,2
"France",442,3,5,4,3,1,2
"Denmark",442,3,5,4,2,2,1
"Panama",442,7,5,4,2,2,1
"Belgium",442,7,4,7,4,3,2
"Russia",443,1,5,2,1,1,1
"Egypt",443,1,4,2,2,0,2
"Peru",443,3,9,8,2,6,1
"Australia",443,3,3,3,3,0,2
"Croatia",443,4,7,4,2,2,1
"Iceland",443,4,4,4,1,3,2
"Brazil",443,5,6,7,4,3,1
"Costa Rica",443,5,6,4,2,2,2
"Belgium",443,7,6,6,4,2,1
"Panama",443,7,6,4,5,-1,2
"Uruguay",444,1,5,5,3,2,1
"Russia",444,1,4,5,3,2,2
"Spain",445,2,7,9,3,6,1
"Portugal",445,2,7,5,2,3,2
"Argentina",445,4,7,3,0,3,1
"Croatia",445,4,4,3,3,0,2
"Colombia",445,8,6,10,6,4,1
"Poland",445,8,6,4,6,-2,2
"Switzerland",446,5,5,5,1,4,1
"Costa Rica",446,5,5,3,1,2,2
"Mexico",446,6,7,4,1,3,2
"Germany",446,6,7,6,1,5,1
"Uruguay",447,1,7,4,2,2,1
"Saudi Arabia",447,1,4,5,3,2,2
"Spain",447,2,7,9,4,5,1
"Iran",447,2,7,7,4,3,2
"France",449,3,6,6,2,4,1
"Denmark",449,3,6,5,3,2,2
"Argentina",449,4,9,6,1,5,1
"Nigeria",449,4,4,3,3,0,2
"England",449,7,9,8,1,7,1
"Panama",449,7,4,2,1,1,2
"Portugal",450,2,6,4,3,1,2
"Iran",450,2,6,4,2,2,1
"Poland",450,8,5,4,3,1,1
"Colombia",450,8,4,5,4,1,2
"Croatia",451,4,6,4,3,1,2
"Argentina",451,4,6,6,2,4,1
"Germany",451,6,9,7,1,6,1
"Mexico",451,6,2,3,4,-1,2
"Spain",452,2,6,3,1,2,2
"Iran",452,2,6,4,1,3,1
"South Korea",453,6,6,6,1,5,1
"Germany",453,6,6,4,3,1,2
"Russia",454,1,6,4,3,1,2
"Saudi Arabia",454,1,6,5,3,2,1
"Brazil",454,5,9,8,0,8,1
"Costa Rica",454,5,3,6,8,-2,2
"South Korea",454,6,7,4,1,3,1
"Germany",454,6,4,3,3,0,2
"Spain",455,2,6,8,1,7,1
"Portugal",455,2,6,6,3,3,2
"France",455,3,5,5,1,4,1
"Peru",455,3,5,5,3,2,2
"Croatia",455,4,7,10,3,7,1
"Argentina",455,4,7,6,1,5,2
"France",457,3,7,8,0,8,1
"Peru",457,3,4,1,1,0,2
"Croatia",457,4,6,3,2,1,2
"Argentina",457,4,6,5,3,2,1
"England",457,7,7,4,1,3,1
"Panama",457,7,7,3,1,2,2
"Spain",458,2,6,6,2,4,1
"Iran",458,2,6,5,5,0,2
"Mexico",458,6,7,5,2,3,1
"South Korea",458,6,7,5,3,2,2
"Colombia",459,8,5,2,1,1,1
"Japan",459,8,4,3,2,1,2
"Egypt",460,1,5,4,3,1,1
"Russia",460,1,4,3,2,1,2
"Argentina",461,4,5,7,3,4,1
"Croatia",461,4,4,4,4,0,2
"Spain",462,2,7,6,3,3,1
"Iran",462,2,4,2,2,0,2
"Iceland",462,4,7,3,1,2,1
"Croatia",462,4,4,3,2,1,2
"Brazil",462,5,7,7,3,4,1
"Costa Rica",462,5,4,5,4,1,2
"Japan",463,8,6,3,2,1,1
"Poland",463,8,4,4,3,1,2
"France",464,3,9,10,2,8,1
"Peru",464,3,4,2,2,0,2
"Egypt",465,1,6,3,1,2,1
"Uruguay",465,1,4,6,2,4,2
"France",465,3,5,4,3,1,1
"Australia",465,3,4,4,3,1,2
"Russia",466,1,6,3,4,-1,2
"Egypt",466,1,6,3,1,2,1
"Costa Rica",466,5,7,5,1,4,1
"Switzerland",466,5,4,4,3,1,2
"Colombia",466,8,5,5,1,4,1
"Poland",466,8,5,3,1,2,2
"Uruguay",467,1,7,6,2,4,1
"Russia",467,1,7,5,2,3,2
"Spain",467,2,6,3,2,1,1
"Portugal",467,2,6,2,2,0,2
"Nigeria",467,4,5,6,5,1,1
"Croatia",467,4,4,7,6,1,2
"Saudi Arabia",468,1,6,4,3,1,1
"Russia",468,1,4,4,3,1,2
"Spain",468,2,6,8,3,5,1
"Portugal",468,2,6,5,4,1,2
"Denmark",468,3,9,5,1,4,1
"France",468,3,3,6,6,0,2
"Serbia",468,5,6,3,6,-3,1
"Brazil",468,5,4,6,2,4,2
"Colombia",468,8,9,10,1,9,1
"Poland",468,8,3,2,4,-2,2
"Egypt",469,1,6,5,6,-1,1
"Russia",469,1,4,5,3,2,2
"Peru",469,3,5,4,1,3,1
"Australia",469,3,5,3,1,2,2
"Costa Rica",469,5,5,4,2,2,1
"Serbia",469,5,4,4,2,2,2
"Nigeria",470,4,6,5,4,1,1
"Argentina",470,4,4,3,3,0,2
"Belgium",470,7,5,2,1,1,2
"England",470,7,5,5,3,2,1
"Colombia",470,8,6,3,2,1,2
"Japan",470,8,6,5,3,2,1
"Brazil",471,5,7,4,1,3,1
"Switzerland",471,5,4,4,4,0,2
"South Korea",471,6,5,6,3,3,1
"Sweden",471,6,4,5,5,0,2
"Russia",473,1,6,7,2,5,1
"Uruguay",473,1,4,3,3,0,2
"Denmark",473,3,7,4,2,2,2
"Peru",473,3,7,5,2,3,1
"Iceland",473,4,6,7,5,2,1
"Croatia",473,4,4,4,3,1,2
"England",473,7,9,7,1,6,1
"Belgium",473,7,4,6,6,0,2
"Spain",474,2,6,5,3,2,1
"Portugal",474,2,4,4,4,0,2
"Brazil",474,5,6,5,3,2,2
"Costa Rica",474,5,6,6,3,3,1
"South Korea",475,6,7,7,3,4,1
"Germany",475,6,4,6,4,2,2
"England",475,7,7,4,2,2,2
"Panama",475,7,7,8,3,5,1
"Uruguay",476,1,6,4,2,2,1
"Russia",476,1,6,3,3,0,2
"Argentina",476,4,6,7,3,4,1
"Croatia",476,4,4,3,4,-1,2
"Uruguay",477,1,6,4,3,1,2
"Russia",477,1,6,7,3,4,1
"Croatia",477,4,7,7,5,2,2
"Argentina",477,4,7,6,2,4,1
"Brazil",477,5,5,3,2,1,2
"Switzerland",477,5,5,5,2,3,1
"Sweden",478,6,4,3,2,1,1
"Germany",478,6,4,6,6,0,2
"France",479,3,7,5,1,4,1
"Denmark",479,3,7,6,3,3,2
"Spain",480,2,6,4,2,2,2
"Portugal",480,2,6,6,3,3,1
"Germany",480,6,5,3,2,1,1
"Mexico",480,6,4,3,2,1,2
"Uruguay",481,1,6,6,3,3,1
"Egypt",481,1,4,4,4,0,2
"Iran",481,2,9,4,0,4,1
"Spain",481,2,3,4,4,0,2
"Brazil",481,5,7,6,2,4,1
"Switzerland",481,5,7,4,1,3,2
"Sweden",481,6,5,4,1,3,1
"South Korea",481,6,5,3,2,1,2
"Panama",481,7,7,5,3,2,1
"England",481,7,4,3,2,1,2
"Argentina",482,4,5,6,4,2,1
"Croatia",482,4,4,4,3,1,2
"Brazil",483,5,9,9,4,5,1
"Serbia",483,5,3,7,6,1,2
"Belgium",483,7,6,8,3,5,1
"Panama",483,7,4,3,2,1,2
"Spain",484,2,7,4,1,3,1
"Portugal",484,2,4,3,1,2,2
"Russia",485,1,6,3,1,2,1
"Egypt",485,1,4,1,1,0,2
"Sweden",485,6,6,8,4,4,1
"Germany",485,6,6,4,4,0,2
"Japan",485,8,5,3,2,1,2
"Poland",485,8,5,3,1,2,1
"France",486,3,6,7,3,4,1
"Australia",486,3,4,3,3,0,2
"Belgium",486,7,6,6,2,4,1
"England",486,7,6,5,4,1,2
"Croatia",487,4,7,5,1,4,1
"Iceland",487,4,4,4,2,2,2
"Colombia",487,8,5,5,2,3,1
"Poland",487,8,5,4,3,1,2
"Nigeria",488,4,6,3,2,1,1
"Croatia",488,4,4,4,3,1,2
"Belgium",488,7,5,5,2,3,1
"Tunisia",488,7,4,3,3,0,2
"France",489,3,6,5,3,2,1
"Peru",489,3,6,2,2,0,2
"England",489,7,9,5,1,4,1
"Belgium",489,7,3,7,4,3,2
"Argentina",490,4,6,4,3,1,2
"Iceland",490,4,6,6,2,4,1
"Belgium",490,7,5,4,3,1,2
"England",490,7,5,4,2,2,1
"Poland",490,8,5,5,1,4,1
"Colombia",490,8,4,4,2,2,2
"Saudi Arabia",491,1,7,4,1,3,1
"Russia",491,1,4,4,3,1,2
"Peru",491,3,7,4,2,2,1
"France",491,3,4,4,3,1,2
"Argentina",491,4,9,5,1,4,1
"Iceland",491,4,3,6,3,3,2
"England",491,7,9,8,1,7,1
"Belgium",491,7,4,6,5,1,2
"Belgium",492,7,7,4,1,3,1
"England",492,7,4,7,3,4,2
"Uruguay",493,1,5,5,1,4,1
"Saudi Arabia",493,1,5,1,0,1,2
"Portugal",493,2,9,8,2,6,1
"Spain",493,2,4,5,4,1,2
"England",493,7,5,5,2,3,1
"Panama",493,7,5,4,3,1,2
"Sweden",494,6,6,7,6,1,2
"Germany",494,6,6,7,4,3,1
"Colombia",494,8,6,4,2,2,2
"Japan",494,8,6,5,2,3,1
"Portugal",495,2,7,8,1,7,1
"Spain",495,2,4,1,1,0,2
"Croatia",495,4,7,3,1,2,2
"Argentina",495,4,7,4,1,3,1
"Saudi Arabia",496,1,5,6,3,3,1
"Uruguay",496,1,4,6,3,3,2
"Uruguay",497,1,6,10,6,4,1
"Russia",497,1,4,3,2,1,2
"Iran",497,2,6,4,3,1,1
"Spain",497,2,4,6,6,0,2
"Switzerland",497,5,5,5,2,3,1
"Brazil",497,5,4,3,2,1,2
"Spain",498,2,6,6,3,3,1
"Portugal",498,2,6,3,3,0,2
"Germany",498,6,7,4,1,3,1
"Mexico",498,6,4,4,2,2,2
"Russia",499,1,7,3,0,3,1
"Uruguay",499,1,4,1,1,0,2
"Germany",499,6,6,3,2,1,1
"South Korea",499,6,4,6,3,3,2
"Spain",500,2,4,3,2,1,1
"Morocco",500,2,4,2,2,0,2
"Brazil",500,5,5,6,2,4,1
"Costa Rica",500,5,5,2,1,1,2
"Belgium",500,7,9,5,1,4,1
"England",500,7,3,4,3,1,2
"Colombia",500,8,5,2,1,1,1
"Japan",500,8,4,5,3,2,2
"Spain",501,2,5,2,1,1,2
"Iran",501,2,5,2,0,2,1
"Panama",501,7,6,2,1,1,1
"Belgium",501,7,4,6,3,3,2
"Uruguay",502,1,4,4,3,1,1
"Saudi Arabia",502,1,4,4,4,0,2
"Australia",502,3,6,3,4,-1,1
"Denmark",502,3,4,4,2,2,2
"Iceland",502,4,6,4,4,0,1
"Croatia",502,4,4,2,2,0,2
"Brazil",502,5,5,2,1,1,2
"Costa Rica",502,5,5,2,0,2,1
"Mexico",502,6,5,4,3,1,2
"South Korea",502,6,5,4,1,3,1
"Colombia",502,8,5,6,4,2,1
"Japan",502,8,4,3,3,0,2
"Denmark",503,3,5,2,1,1,1
"France",503,3,4,5,5,0,2
"Argentina",503,4,9,7,3,4,1
"Croatia",503,4,4,8,6,2,2
"Japan",504,8,9,6,0,6,1
"Colombia",504,8,3,1,2,-1,2
"Spain",505,2,6,4,1,3,1
"Morocco",505,2,6,2,4,-2,2
"Denmark",505,3,5,5,3,2,1
"Australia",505,3,4,7,7,0,2
"Iceland",505,4,6,4,4,0,1
"Nigeria",505,4,4,5,4,1,2
"Serbia",505,5,9,3,0,3,1
"Costa Rica",505,5,4,3,2,1,2
"England",505,7,6,3,5,-2,2
"Tunisia",505,7,6,4,3,1,1
"Portugal",506,2,7,7,3,4,1
"Iran",506,2,7,4,1,3,2
"Costa Rica",506,5,9,6,0,6,1
"Brazil",506,5,4,2,2,0,2
"France",507,3,6,7,4,3,1
"Denmark",507,3,4,7,6,1,2
"Argentina",507,4,9,10,2,8,1
"Croatia",507,4,4,2,3,-1,2
"Panama",507,7,5,3,2,1,1
"Belgium",507,7,4,4,2,2,2
"Japan",508,8,6,3,4,-1,1
"Colombia",508,8,4,4,2,2,2
"Spain",509,2,7,4,2,2,1
"Portugal",509,2,4,2,1,1,2
"South Korea",509,6,6,7,6,1,1
"Mexico",509,6,4,7,3,4,2
"Belgium",509,7,9,7,1,6,1
"England",509,7,3,4,4,0,2
"Uruguay",510,1,7,6,2,4,1
"Saudi Arabia",510,1,4,4,3,1,2
"Croatia",510,4,7,6,4,2,2
"Argentina",510,4,7,6,1,5,1
"Mexico",510,6,6,2,2,0,2
"Germany",510,6,6,5,2,3,1
"France",511,3,6,4,2,2,1
"Denmark",511,3,6,4,5,-1,2
"Argentina",511,4,7,6,1,5,1
"Nigeria",511,4,7,5,3,2,2
"England",511,7,5,5,2,3,1
"Panama",511,7,4,6,5,1,2
"Japan",511,8,9,5,1,4,1
"Colombia",511,8,3,9,6,3,2
"Spain",512,2,7,5,2,3,2
"Iran",512,2,7,6,1,5,1
"France",512,3,9,8,2,6,1
"Peru",512,3,4,5,3,2,2
"Tunisia",512,7,9,4,1,3,1
"England",512,7,4,4,3,1,2
"Brazil",513,5,9,9,3,6,1
"Switzerland",513,5,3,3,3,0,2
"South Korea",513,6,7,3,1,2,1
"Germany",513,6,4,4,1,3,2
"Saudi Arabia",514,1,6,4,5,-1,1
"Uruguay",514,1,4,8,5,3,2
"Portugal",514,2,6,6,5,1,1
"Spain",514,2,4,5,4,1,2
"Denmark",514,3,6,5,5,0,2
"Peru",514,3,6,6,4,2,1
"South Korea",514,6,7,5,1,4,1
"Germany",514,6,7,5,2,3,2
"France",516,3,6,7,2,5,1
"Australia",516,3,6,6,5,1,2
"Japan",516,8,5,4,2,2,1
"Poland",516,8,5,3,2,1,2
"Colombia",517,8,6,9,4,5,1
"Poland",517,8,6,4,5,-1,2
"Uruguay",518,1,7,5,2,3,2
"Russia",518,1,7,5,0,5,1
"Spain",518,2,7,5,3,2,1
"Iran",518,2,4,6,5,1,2
"Peru",518,3,9,6,2,4,1
"France",518,3,4,5,5,0,2
"Argentina",518,4,6,6,3,3,1
"Nigeria",518,4,6,3,3,0,2
"France",519,3,6,4,2,2,1
"Australia",519,3,4,4,4,0,2
"Croatia",519,4,6,8,3,5,1
"Argentina",519,4,6,5,5,0,2
"Germany",520,6,9,6,2,4,1
"Sweden",520,6,3,4,4,0,2
"Russia",521,1,6,6,3,3,1
"Saudi Arabia",521,1,4,4,4,0,2
"Brazil",521,5,6,5,2,3,1
"Switzerland",521,5,6,4,4,0,2
"Belgium",521,7,6,3,2,1,2
"England",521,7,6,3,1,2,1
"Iran",522,2,6,3,1,2,1
"Spain",522,2,4,2,2,0,2
"Argentina",522,4,7,5,2,3,1
"Nigeria",522,4,4,4,3,1,2
"Brazil",522,5,6,8,2,6,1
"Costa Rica",522,5,6,2,2,0,2
"Mexico",522,6,7,8,4,4,2
"Germany",522,6,7,10,3,7,1
"Colombia",522,8,6,3,3,0,1
"Poland",522,8,4,3,2,1,2
"Brazil",523,5,6,5,2,3,1
"Switzerland",523,5,6,3,4,-1,2
"Belgium",524,7,6,6,4,2,2
"England",524,7,6,6,3,3,1
"Uruguay",525,1,7,6,1,5,1
"Egypt",525,1,4,6,4,2,2
"France",525,3,6,5,1,4,1
"Australia",525,3,6,4,5,-1,2
"Croatia",525,4,5,3,1,2,2
"Argentina",525,4,5,3,0,3,1
"Belgium",525,7,9,7,2,5,1
"England",525,7,3,4,3,1,2
"Uruguay",526,1,5,5,2,3,1
"Russia",526,1,4,7,7,0,2
"Spain",526,2,6,8,2,6,1
"Iran",526,2,6,2,4,-2,2
"England",526,7,5,3,2,1,2
"Panama",526,7,5,7,3,4,1
"Russia",527,1,6,7,4,3,1
"Egypt",527,1,6,6,4,2,2
"France",527,3,9,8,2,6,1
"Peru",527,3,4,3,3,0,2
"Colombia",527,8,9,6,1,5,1
"Japan",527,8,2,1,2,-1,2
"Uruguay",528,1,9,9,2,7,1
"Egypt",528,1,4,5,6,-1,2
"Brazil",528,5,9,11,0,11,1
"Switzerland",528,5,4,1,3,-2,2
"Mexico",528,6,5,6,2,4,1
"South Korea",528,6,4,3,3,0,2
"Uruguay",529,1,9,7,2,5,1
"Russia",529,1,4,3,2,1,2
"France",529,3,7,4,0,4,1
"Denmark",529,3,4,1,1,0,2
"Belgium",529,7,6,5,2,3,2
"Panama",529,7,6,7,1,6,1
"Uruguay",530,1,5,3,2,1,2
"Russia",530,1,5,5,3,2,1
"France",530,3,9,9,1,8,1
"Denmark",530,3,3,4,4,0,2
"Japan",530,8,5,4,1,3,1
"Poland",530,8,5,5,3,2,2
"France",531,3,6,4,2,2,1
"Denmark",531,3,6,3,2,1,2
"England",531,7,6,7,2,5,1
"Panama",531,7,6,2,1,1,2
"Spain",532,2,5,2,1,1,1
"Iran",532,2,4,2,1,1,2
"Colombia",532,8,6,3,2,1,1
"Japan",532,8,4,3,2,1,2
"Argentina",533,4,6,10,3,7,1
"Iceland",533,4,6,5,5,0,2
"Colombia",533,8,7,5,2,3,1
"Poland",533,8,7,4,2,2,2
"France",534,3,7,7,0,7,1
"Peru",534,3,4,2,4,-2,2
"Colombia",534,8,7,6,2,4,1
"Japan",534,8,7,3,1,2,2
"Mexico",535,6,6,3,1,2,2
"Germany",535,6,6,5,2,3,1
"England",535,7,9,9,1,8,1
"Panama",535,7,4,2,2,0,2
"Portugal",536,2,7,8,3,5,1
"Iran",536,2,7,4,2,2,2
"Belgium",537,7,7,2,0,2,2
"England",537,7,7,3,0,3,1
"England",538,7,6,5,3,2,1
"Panama",538,7,4,3,2,1,2
"Colombia",538,8,5,4,3,1,1
"Poland",538,8,4,4,3,1,2
"Iran",539,2,6,3,2,1,1
"Spain",539,2,4,5,2,3,2
"Croatia",539,4,6,3,3,0,2
"Argentina",539,4,6,8,1,7,1
"Japan",539,8,5,3,1,2,1
"Poland",539,8,5,1,0,1,2
"Egypt",540,1,9,5,1,4,1
"Uruguay",540,1,3,4,4,0,2
"Brazil",540,5,5,5,3,2,1
"Switzerland",540,5,5,3,2,1,2
"England",540,7,9,6,1,5,1
"Belgium",540,7,4,5,4,1,2
"Spain",541,2,6,6,3,3,1
"Portugal",541,2,6,5,3,2,2
"Brazil",541,5,7,4,1,3,1
"Switzerland",541,5,7,4,2,2,2
"Brazil",542,5,5,3,1,2,1
"Switzerland",542,5,4,3,3,0,2
"South Korea",542,6,5,4,2,2,1
"Germany",542,6,5,4,3,1,2
"Uruguay",543,1,6,4,2,2,1
"Russia",543,1,4,7,3,4,2
"France",544,3,6,5,2,3,1
"Peru",544,3,6,3,2,1,2
"Argentina",544,4,9,7,2,5,1
"Iceland",544,4,3,7,5,2,2
"England",544,7,7,3,0,3,2
"Panama",544,7,7,7,3,4,1
"Croatia",545,4,9,6,1,5,1
"Iceland",545,4,3,3,4,-1,2
"Brazil",545,5,5,6,2,4,1
"Switzerland",545,5,4,3,3,0,2
"Uruguay",546,1,6,4,1,3,1
"Egypt",546,1,6,6,6,0,2
"Argentina",546,4,9,5,0,5,1
"Iceland",546,4,4,1,1,0,2
"England",546,7,6,5,2,3,1
"Belgium",546,7,4,4,4,0,2
"Peru",547,3,6,5,4,1,2
"Australia",547,3,6,6,4,2,1
"Belgium",547,7,6,6,5,1,1
"Tunisia",547,7,4,5,4,1,2
"Mexico",548,6,7,6,2,4,1
"Germany",548,6,7,5,3,2,2
"Spain",549,2,7,6,2,4,2
"Iran",549,2,7,6,1,5,1
"Brazil",549,5,5,2,0,2,1
"Serbia",549,5,4,5,4,1,2
"South Korea",549,6,5,2,1,1,2
"Germany",549,6,5,2,0,2,1
"Brazil",550,5,6,7,4,3,1
"Switzerland",550,5,4,3,3,0,2
"South Korea",550,6,7,4,1,3,1
"Germany",550,6,7,5,3,2,2
"Spain",551,2,7,3,0,3,1
"Portugal",551,2,4,3,1,2,2
"Nigeria",551,4,7,4,1,3,1
"Argentina",551,4,4,6,3,3,2
"Russia",552,1,7,6,2,4,1
"Egypt",552,1,4,4,3,1,2
"Portugal",553,2,6,8,4,4,1
"Iran",553,2,6,4,4,0,2
"France",554,3,9,13,2,11,1
"Peru",554,3,4,2,5,-3,2
"Belgium",555,7,7,8,3,5,2
"England",555,7,7,8,2,6,1
"Japan",555,8,6,4,5,-1,2
"Poland",555,8,6,6,5,1,1
"Spain",556,2,6,3,1,2,1
"Iran",556,2,4,4,4,0,2
"Poland",557,8,6,3,4,-1,1
"Colombia",557,8,4,4,2,2,2
"Saudi Arabia",558,1,6,2,2,0,2
"Egypt",558,1,6,4,2,2,1
"Croatia",558,4,7,6,4,2,2
"Argentina",558,4,7,7,3,4,1
"Senegal",558,8,6,2,1,1,1
"Poland",558,8,4,2,2,0,2
"Uruguay",559,1,9,4,0,4,1
"Egypt",559,1,4,2,1,1,2
"Argentina",559,4,6,7,5,2,1
"Croatia",559,4,4,6,4,2,2
"Poland",559,8,9,7,3,4,1
"Colombia",559,8,3,5,5,0,2
"Colombia",560,8,5,3,1,2,1
"Senegal",560,8,5,1,0,1,2
"Peru",561,3,6,3,1,2,1
"Denmark",561,3,4,3,3,0,2
"Argentina",561,4,9,8,0,8,1
"Croatia",561,4,4,7,7,0,2
"Costa Rica",561,5,5,4,2,2,1
"Brazil",561,5,4,4,2,2,2
"Germany",561,6,9,7,1,6,1
"South Korea",561,6,4,5,2,3,2
"Belgium",561,7,6,7,4,3,1
"Panama",561,7,6,4,4,0,2
"Colombia",561,8,9,6,0,6,1
"Senegal",561,8,2,4,5,-1,2
"France",562,3,5,3,2,1,2
"Peru",562,3,5,3,1,2,1
"Spain",563,2,6,3,3,0,1
"Iran",563,2,6,4,5,-1,2
"France",563,3,7,6,2,4,2
"Peru",563,3,7,6,1,5,1
"England",563,7,5,4,3,1,1
"Belgium",563,7,4,4,2,2,2
"Iran",564,2,6,9,4,5,1
"Portugal",564,2,4,5,5,0,2
"Argentina",564,4,6,3,2,1,1
"Iceland",564,4,4,2,2,0,2
"Mexico",564,6,5,3,2,1,1
"Sweden",564,6,4,3,2,1,2
"Nigeria",565,4,6,5,3,2,2
"Iceland",565,4,6,11,3,8,1
"Brazil",565,5,9,8,0,8,1
"Costa Rica",565,5,4,1,2,-1,2
"France",566,3,7,8,1,7,1
"Peru",566,3,7,5,0,5,2
"Brazil",566,5,7,5,2,3,2
"Costa Rica",566,5,7,6,2,4,1
"Switzerland",567,5,5,3,2,1,1
"Brazil",567,5,4,3,2,1,2
"Portugal",568,2,6,9,3,6,1
"Iran",568,2,6,6,5,1,2
"Spain",569,2,9,8,0,8,1
"Iran",569,2,2,0,1,-1,2
"Argentina",569,4,7,7,3,4,1
"Croatia",569,4,4,5,5,0,2
"Switzerland",569,5,6,6,5,1,1
"Brazil",569,5,4,6,4,2,2
"France",571,3,9,6,0,6,1
"Peru",571,3,3,2,2,0,2
"Belgium",571,7,7,7,5,2,1
"Panama",571,7,4,4,3,1,2
"France",572,3,5,4,2,2,1
"Australia",572,3,5,3,2,1,2
"Belgium",573,7,6,7,4,3,1
"Tunisia",573,7,4,1,2,-1,2
"Colombia",573,8,7,7,3,4,1
"Poland",573,8,7,3,1,2,2
"Belgium",574,7,7,4,2,2,1
"Panama",574,7,4,3,2,1,2
"South Korea",575,6,7,3,1,2,1
"Mexico",575,6,4,3,1,2,2
"Saudi Arabia",576,1,9,5,0,5,1
"Uruguay",576,1,3,5,4,1,2
"Belgium",576,7,6,6,4,2,2
"England",576,7,6,6,3,3,1
"Uruguay",577,1,9,7,3,4,1
"Russia",577,1,4,4,3,1,2
"Spain",577,2,9,9,4,5,1
"Morocco",577,2,3,7,7,0,2
"Argentina",577,4,4,5,3,2,1
"Nigeria",577,4,4,5,5,0,2
"Brazil",577,5,6,7,2,5,1
"Costa Rica",577,5,6,4,1,3,2
"Croatia",578,4,7,5,2,3,1
"Argentina",578,4,4,4,3,1,2
"Brazil",578,5,6,3,1,2,2
"Switzerland",578,5,6,7,2,5,1
"Mexico",578,6,6,4,1,3,1
"Germany",578,6,6,4,2,2,2
"England",578,7,7,5,2,3,1
"Belgium",578,7,4,4,3,1,2
"Spain",579,2,7,6,3,3,1
"Iran",579,2,7,3,1,2,2
"Croatia",579,4,5,7,3,4,1
"Nigeria",579,4,5,3,2,1,2
"Belgium",579,7,5,1,0,1,2
"Panama",579,7,5,5,3,2,1
"Senegal",579,8,6,4,5,-1,1
"Japan",579,8,4,2,2,0,2
"France",580,3,7,6,0,6,1
"Peru",580,3,7,3,1,2,2
"Japan",581,8,5,5,2,3,1
"Colombia",581,8,4,3,3,0,2
"Spain",582,2,6,3,1,2,1
"Portugal",582,2,6,2,1,1,2
"France",582,3,6,5,2,3,1
"Peru",582,3,4,3,2,1,2
"Belgium",582,7,5,3,2,1,2
"England",582,7,5,7,3,4,1
"Brazil",583,5,9,9,3,6,1
"Costa Rica",583,5,4,3,3,0,2
"France",584,3,5,3,2,1,1
"Australia",584,3,4,3,2,1,2
"Colombia",584,8,6,5,4,1,2
"Poland",584,8,6,7,4,3,1
"England",585,7,7,9,1,8,1
"Panama",585,7,4,6,5,1,2
"Brazil",586,5,6,6,3,3,1
"Switzerland",586,5,6,4,2,2,2
"Spain",587,2,6,5,4,1,2
"Portugal",587,2,6,4,2,2,1
"Germany",587,6,6,3,3,0,1
"South Korea",587,6,4,4,3,1,2
"Colombia",587,8,6,2,1,1,2
"Japan",587,8,6,3,1,2,1
"Russia",588,1,6,6,3,3,1
"Saudi Arabia",588,1,4,2,2,0,2
"Belgium",588,7,6,6,3,3,1
"England",588,7,6,3,2,1,2
"Senegal",588,8,6,4,1,3,1
"Colombia",588,8,4,4,2,2,2
"France",589,3,6,6,3,3,1
"Australia",589,3,6,6,5,1,2
"England",589,7,7,10,3,7,1
"Belgium",589,7,4,2,2,0,2
"Russia",590,1,7,6,3,3,1
"Saudi Arabia",590,1,4,5,4,1,2
"Spain",590,2,6,5,4,1,2
"Portugal",590,2,6,7,3,4,1
"Brazil",590,5,9,5,1,4,1
"Switzerland",590,5,3,4,4,0,2
"Uruguay",591,1,9,7,3,4,1
"Russia",591,1,4,6,4,2,2
"France",591,3,7,4,1,3,2
"Peru",591,3,7,8,0,8,1
"Russia",592,1,9,5,1,4,1
"Uruguay",592,1,4,7,4,3,2
"Iran",592,2,6,5,3,2,1
"Portugal",592,2,4,4,2,2,2
"Uruguay",593,1,6,5,2,3,1
"Russia",593,1,6,5,4,1,2
"France",593,3,5,5,4,1,1
"Peru",593,3,4,7,6,1,2
"Japan",594,8,6,2,2,0,1
"Colombia",594,8,4,4,3,1,2
"France",595,3,6,7,2,5,1
"Peru",595,3,6,4,2,2,2
"Colombia",595,8,7,4,1,3,1
"Senegal",595,8,4,5,4,1,2
"France",596,3,6,5,2,3,1
"Peru",596,3,4,4,2,2,2
"Brazil",596,5,6,3,1,2,2
"Serbia",596,5,6,4,1,3,1
"Iran",597,2,9,7,3,4,1
"Portugal",597,2,4,6,4,2,2
"Argentina",597,4,6,4,2,2,1
"Croatia",597,4,4,4,1,3,2
"Belgium",597,7,5,6,2,4,1
"England",597,7,5,3,2,1,2
"Japan",597,8,6,3,3,0,2
"Poland",597,8,6,4,2,2,1
"Portugal",598,2,6,5,5,0,2
"Iran",598,2,6,8,2,6,1
"France",598,3,7,5,1,4,1
"Denmark",598,3,4,5,4,1,2
"Brazil",598,5,6,6,1,5,1
"Serbia",598,5,6,3,4,-1,2
"Saudi Arabia",599,1,6,4,3,1,1
"Egypt",599,1,4,5,4,1,2
"Portugal",599,2,9,12,3,9,1
"Morocco",599,2,3,3,5,-2,2
"Brazil",599,5,5,5,2,3,1
"Serbia",599,5,5,3,2,1,2
"Uruguay",600,1,9,8,1,7,1
"Egypt",600,1,3,2,3,-1,2
"Spain",600,2,6,5,2,3,1
"Portugal",600,2,6,4,3,1,2
"Argentina",600,4,9,6,2,4,1
"Croatia",600,4,4,3,2,1,2
"Argentina",601,4,9,6,2,4,1
"Iceland",601,4,4,5,3,2,2
"France",602,3,6,5,1,4,1
"Australia",602,3,6,5,4,1,2
"South Korea",602,6,6,3,2,1,1
"Sweden",602,6,4,3,1,2,2
"Belgium",602,7,6,4,2,2,1
"England",602,7,6,2,1,1,2
"Croatia",603,4,6,3,5,-2,2
"Argentina",603,4,6,9,3,6,1
"Colombia",603,8,6,5,4,1,2
"Japan",603,8,6,6,1,5,1
"Spain",604,2,5,3,1,2,1
"Iran",604,2,5,2,1,1,2
"France",604,3,7,7,3,4,1
"Denmark",604,3,4,4,3,1,2
"Costa Rica",604,5,6,4,3,1,1
"Brazil",604,5,4,4,3,1,2
"Germany",604,6,6,4,4,0,1
"South Korea",604,6,4,4,3,1,2
"Saudi Arabia",606,1,6,7,6,1,1
"Uruguay",606,1,4,5,3,2,2
"Portugal",606,2,6,7,1,6,1
"Iran",606,2,6,4,3,1,2
"Germany",606,6,6,2,2,0,1
"Mexico",606,6,4,2,1,1,2
"Spain",607,2,5,6,2,4,1
"Morocco",607,2,5,3,2,1,2
"South Korea",607,6,5,3,1,2,1
"Mexico",607,6,4,8,6,2,2
"Belgium",607,7,7,4,1,3,1
"England",607,7,4,1,1,0,2
"Croatia",608,4,4,3,2,1,1
"Argentina",608,4,4,3,3,0,2
"Brazil",608,5,7,6,1,5,1
"Switzerland",608,5,7,6,3,3,2
"Senegal",608,8,6,3,3,0,1
"Japan",608,8,4,4,3,1,2
"Spain",609,2,7,5,1,4,1
"Portugal",609,2,7,3,1,2,2
"Croatia",609,4,7,5,2,3,1
"Argentina",609,4,7,4,2,2,2
"Brazil",610,5,6,5,2,3,1
"Costa Rica",610,5,6,3,1,2,2
"Mexico",610,6,6,4,4,0,2
"South Korea",610,6,6,4,3,1,1
"Uruguay",611,1,7,5,1,4,1
"Egypt",611,1,7,4,2,2,2
"Portugal",611,2,6,3,2,1,2
"Iran",611,2,6,4,2,2,1
"Peru",611,3,6,5,3,2,2
"Australia",611,3,6,6,3,3,1
"Brazil",611,5,6,8,5,3,2
"Costa Rica",611,5,6,8,2,6,1
"Spain",612,2,9,7,0,7,1
"Portugal",612,2,3,3,3,0,2
"France",612,3,7,5,1,4,1
"Australia",612,3,4,3,3,0,2
"Argentina",612,4,6,8,3,5,1
"Nigeria",612,4,4,5,4,1,2
"Costa Rica",613,5,9,5,1,4,1
"Brazil",613,5,3,7,4,3,2
"South Korea",613,6,5,4,3,1,2
"Germany",613,6,5,3,1,2,1
"Uruguay",614,1,7,3,0,3,1
"Saudi Arabia",614,1,4,5,4,1,2
"Argentina",614,4,7,8,3,5,1
"Croatia",614,4,4,5,4,1,2
"Belgium",614,7,7,6,2,4,1
"England",614,7,7,4,1,3,2
"Poland",614,8,5,3,2,1,1
"Colombia",614,8,4,3,2,1,2
"Belgium",615,7,7,6,3,3,2
"England",615,7,7,7,1,6,1
"Uruguay",616,1,9,4,0,4,1
"Saudi Arabia",616,1,4,2,2,0,2
"Germany",616,6,6,7,3,4,1
"Sweden",616,6,4,5,6,-1,2
"England",617,7,5,2,1,1,2
"Panama",617,7,5,4,0,4,1
"Colombia",617,8,6,7,4,3,1
"Poland",617,8,6,5,3,2,2
"Russia",618,1,6,4,3,1,1
"Uruguay",618,1,4,4,3,1,2
"France",618,3,7,2,0,2,2
"Peru",618,3,7,6,1,5,1
"Iceland",618,4,7,3,1,2,1
"Argentina",618,4,4,4,2,2,2
"Brazil",618,5,7,5,2,3,1
"Switzerland",618,5,4,5,4,1,2
"Mexico",618,6,5,4,2,2,1
"Germany",618,6,5,1,0,1,2
"Japan",618,8,6,3,3,0,2
"Poland",618,8,6,4,2,2,1
"Portugal",619,2,6,3,1,2,1
"Spain",619,2,4,4,3,1,2
"Denmark",619,3,5,3,1,2,1
"Peru",619,3,5,2,1,1,2
"Argentina",619,4,6,8,5,3,1
"Iceland",619,4,6,8,10,-2,2
"Germany",619,6,7,4,1,3,1
"South Korea",619,6,4,3,3,0,2
"Belgium",619,7,5,4,2,2,1
"England",619,7,4,7,3,4,2
"France",620,3,5,2,0,2,1
"Australia",620,3,5,3,2,1,2
"Russia",621,1,5,3,2,1,1
"Uruguay",621,1,4,3,3,0,2
"Iran",622,2,5,4,2,2,1
"Portugal",622,2,4,2,2,0,2
"Peru",622,3,9,5,0,5,1
"Australia",622,3,4,4,3,1,2
"Senegal",622,8,5,3,2,1,1
"Poland",622,8,4,5,5,0,2
"Spain",623,2,7,3,0,3,1
"Portugal",623,2,4,2,1,1,2
"Nigeria",623,4,6,6,4,2,1
"Iceland",623,4,6,2,2,0,2
"Switzerland",623,5,7,6,3,3,1
"Costa Rica",623,5,4,5,3,2,2
"Belgium",623,7,7,6,2,4,1
"England",623,7,7,5,2,3,2
"Croatia",624,4,7,4,2,2,1
"Nigeria",624,4,4,6,5,1,2
"South Korea",624,6,6,7,6,1,2
"Germany",624,6,6,9,5,4,1
"Spain",625,2,6,6,3,3,2
"Iran",625,2,6,7,3,4,1
"France",625,3,9,6,1,5,1
"Peru",625,3,4,3,3,0,2
"Colombia",625,8,5,2,1,1,2
"Japan",625,8,5,5,3,2,1
"Uruguay",626,1,6,6,2,4,1
"Russia",626,1,6,4,3,1,2
"Senegal",626,8,6,4,3,1,1
"Colombia",626,8,4,4,2,2,2
"Spain",628,2,6,7,2,5,1
"Portugal",628,2,6,6,4,2,2
"Brazil",628,5,5,3,1,2,1
"Serbia",628,5,5,3,2,1,2
"Belgium",628,7,7,6,1,5,1
"England",628,7,7,2,0,2,2
"Japan",628,8,6,5,5,0,1
"Colombia",628,8,4,4,3,1,2
"Argentina",629,4,6,2,1,1,2
"Iceland",629,4,6,6,2,4,1
"Colombia",629,8,5,4,2,2,1
"Japan",629,8,5,3,2,1,2
"Egypt",630,1,5,3,1,2,1
"Uruguay",630,1,4,3,2,1,2
"Sweden",630,6,6,4,2,2,1
"Germany",630,6,4,2,1,1,2
"Egypt",631,1,6,5,4,1,1
"Uruguay",631,1,4,3,2,1,2
"Spain",631,2,4,8,5,3,1
"Portugal",631,2,4,5,4,1,2
"Peru",631,3,6,4,2,2,1
"Denmark",631,3,4,6,5,1,2
"Germany",631,6,9,5,2,3,1
"South Korea",631,6,4,5,3,2,2
"England",631,7,9,10,1,9,1
"Belgium",631,7,3,6,4,2,2
"Russia",632,1,9,8,3,5,1
"Uruguay",632,1,3,5,5,0,2
"Portugal",632,2,6,8,4,4,1
"Morocco",632,2,6,4,3,1,2
"France",632,3,7,6,3,3,2
"Peru",632,3,7,8,4,4,1
"Belgium",632,7,7,3,1,2,1
"England",632,7,4,5,3,2,2
"Poland",632,8,9,4,0,4,1
"Colombia",632,8,3,4,4,0,2
"Peru",633,3,7,4,1,3,1
"France",633,3,4,3,2,1,2
"Poland",633,8,6,7,4,3,1
"Japan",633,8,4,4,4,0,2
"Spain",634,2,7,9,5,4,1
"Portugal",634,2,7,6,3,3,2
"Denmark",634,3,4,5,3,2,1
"Australia",634,3,4,5,4,1,2
"Colombia",634,8,6,3,2,1,1
"Japan",634,8,4,4,3,1,2
"Uruguay",635,1,9,6,1,5,1
"Egypt",635,1,2,3,4,-1,2
"Spain",635,2,7,5,3,2,2
"Portugal",635,2,7,6,3,3,1
"France",635,3,7,5,2,3,1
"Denmark",635,3,4,5,3,2,2
"South Korea",635,6,5,3,2,1,2
"Germany",635,6,5,3,1,2,1
"Belgium",635,7,5,4,3,1,2
"England",635,7,5,7,2,5,1
"Iran",636,2,7,5,1,4,1
"Portugal",636,2,4,2,2,0,2
"Peru",636,3,7,6,2,4,1
"France",636,3,4,3,2,1,2
"Russia",637,1,7,6,2,4,1
"Uruguay",637,1,4,3,3,0,2
"Colombia",637,8,7,7,2,5,1
"Poland",637,8,7,5,3,2,2
"Spain",638,2,7,6,2,4,2
"Iran",638,2,7,7,0,7,1
"Croatia",638,4,6,6,4,2,2
"Argentina",638,4,6,10,3,7,1
"Spain",639,2,6,6,1,5,1
"Iran",639,2,6,5,4,1,2
"Poland",639,8,5,3,1,2,1
"Colombia",639,8,4,4,4,0,2
"France",640,3,5,3,2,1,2
"Australia",640,3,5,5,1,4,1
"Argentina",640,4,7,4,0,4,1
"Iceland",640,4,7,4,2,2,2
"Spain",642,2,6,5,3,2,2
"Portugal",642,2,6,9,4,5,1
"Morocco",643,2,5,3,2,1,1
"Spain",643,2,4,4,3,1,2
"Peru",643,3,5,3,2,1,1
"France",643,3,4,5,2,3,2
"Mexico",643,6,6,3,1,2,1
"Germany",643,6,6,3,2,1,2
"Mexico",644,6,9,6,2,4,1
"Germany",644,6,4,6,5,1,2
"Colombia",644,8,6,4,2,2,1
"Poland",644,8,4,2,1,1,2
"Belgium",645,7,6,6,5,1,2
"England",645,7,6,6,3,3,1
"Senegal",645,8,6,6,5,1,1
"Poland",645,8,6,6,6,0,2
"Uruguay",646,1,9,7,1,6,1
"Russia",646,1,3,3,4,-1,2
"Colombia",646,8,7,5,2,3,2
"Poland",646,8,7,7,1,6,1
"Spain",647,2,4,4,4,0,2
"Portugal",647,2,4,3,2,1,1
"Croatia",647,4,7,6,1,5,1
"Argentina",647,4,7,5,1,4,2
"Croatia",648,4,6,4,1,3,1
"Argentina",648,4,6,3,1,2,2
"South Korea",648,6,6,2,2,0,2
"Germany",648,6,6,8,1,7,1
"Japan",648,8,4,3,3,0,2
"Senegal",648,8,4,3,2,1,1
"Uruguay",649,1,6,4,2,2,1
"Egypt",649,1,4,3,2,1,2
"Croatia",649,4,7,4,2,2,2
"Argentina",649,4,7,5,1,4,1
"Brazil",649,5,6,6,2,4,1
"Switzerland",649,5,6,2,3,-1,2
"Spain",650,2,5,6,2,4,1
"Iran",650,2,4,6,2,4,2
"Germany",650,6,5,5,3,2,1
"Mexico",650,6,4,5,5,0,2
"France",651,3,6,7,2,5,1
"Peru",651,3,6,6,6,0,2
"Argentina",651,4,5,6,5,1,1
"Croatia",651,4,4,6,4,2,2
"Germany",651,6,9,10,1,9,1
"Sweden",651,6,4,2,4,-2,2
"England",651,7,7,7,1,6,1
"Belgium",651,7,4,5,3,2,2
"Egypt",652,1,6,3,2,1,1
"Russia",652,1,4,3,2,1,2
"Spain",652,2,9,7,2,5,1
"Morocco",652,2,4,1,1,0,2
"Germany",652,6,5,3,2,1,1
"South Korea",652,6,4,4,3,1,2
"Poland",653,8,6,6,3,3,1
"Japan",653,8,4,6,4,2,2
"Uruguay",654,1,5,8,4,4,1
"Egypt",654,1,4,4,4,0,2
"France",655,3,6,6,3,3,1
"Denmark",655,3,6,2,4,-2,2
"Brazil",655,5,6,6,3,3,1
"Serbia",655,5,6,6,4,2,2
"Germany",655,6,7,5,2,3,1
"Mexico",655,6,4,4,2,2,2
"Germany",656,6,9,7,0,7,1
"Sweden",656,6,2,3,4,-1,2
"Russia",657,1,6,5,4,1,1
"Egypt",657,1,4,6,5,1,2
"France",657,3,6,6,3,3,2
"Australia",657,3,6,6,2,4,1
"Croatia",657,4,5,3,2,1,2
"Argentina",657,4,5,5,3,2,1
"Brazil",657,5,9,8,2,6,1
"Costa Rica",657,5,4,7,4,3,2
"Germany",657,6,9,7,2,5,1
"South Korea",657,6,4,2,2,0,2
"Uruguay",658,1,5,4,1,3,1
"Russia",658,1,5,3,1,2,2
"Spain",658,2,6,3,1,2,1
"Iran",658,2,4,4,2,2,2
"Iceland",658,4,6,7,5,2,1
"Argentina",658,4,4,4,2,2,2
"Brazil",658,5,9,8,0,8,1
"Costa Rica",658,5,4,4,5,-1,2
"Belgium",658,7,6,3,4,-1,2
"England",658,7,6,4,1,3,1
"Portugal",659,2,6,6,1,5,1
"Iran",659,2,4,4,5,-1,2
"France",659,3,6,5,2,3,1
"Australia",659,3,6,4,4,0,2
"Mexico",659,6,6,4,2,2,2
"Germany",659,6,6,5,2,3,1
"England",659,7,9,5,2,3,1
"Panama",659,7,4,4,3,1,2
"Mexico",660,6,7,5,1,4,1
"South Korea",660,6,4,1,1,0,2
"Brazil",661,5,7,5,2,3,2
"Costa Rica",661,5,7,5,1,4,1
"Belgium",661,7,9,8,3,5,1
"England",661,7,4,4,2,2,2
"Uruguay",662,1,6,8,5,3,1
"Saudi Arabia",662,1,6,8,6,2,2
"Germany",662,6,6,7,3,4,1
"Mexico",662,6,4,4,3,1,2
"Uruguay",663,1,6,5,2,3,1
"Egypt",663,1,4,2,1,1,2
"Denmark",663,3,6,3,2,1,1
"Peru",663,3,6,2,2,0,2
"Russia",664,1,6,8,3,5,1
"Egypt",664,1,6,4,4,0,2
"Australia",664,3,5,4,3,1,1
"France",664,3,4,5,3,2,2
"Brazil",664,5,7,4,2,2,2
"Switzerland",664,5,7,7,0,7,1
"Uruguay",665,1,6,5,3,2,1
"Russia",665,1,4,2,2,0,2
"Colombia",665,8,6,5,2,3,1
"Poland",665,8,6,4,3,1,2
"Belgium",666,7,6,4,1,3,1
"England",666,7,6,3,2,1,2
"Denmark",667,3,5,3,1,2,1
"Peru",667,3,5,4,3,1,2
"Costa Rica",667,5,5,3,2,1,1
"Brazil",667,5,4,4,3,1,2
"Colombia",667,8,5,6,2,4,1
"Japan",667,8,4,4,5,-1,2
"France",668,3,9,11,3,8,1
"Peru",668,3,3,7,6,1,2
"Argentina",668,4,6,6,2,4,1
"Iceland",668,4,6,5,5,0,2
"Uruguay",669,1,6,6,3,3,1
"Russia",669,1,6,3,2,1,2
"Germany",669,6,6,3,1,2,1
"South Korea",669,6,4,4,3,1,2
"Senegal",669,8,6,5,3,2,1
"Poland",669,8,6,6,5,1,2
"Argentina",670,4,6,6,2,4,1
"Croatia",670,4,4,3,2,1,2
"England",670,7,9,8,2,6,1
"Belgium",670,7,3,4,3,1,2
"Mexico",671,6,6,4,3,1,2
"Germany",671,6,6,6,4,2,1
"Uruguay",672,1,6,5,2,3,1
"Egypt",672,1,6,4,4,0,2
"Portugal",672,2,6,5,1,4,1
"Iran",672,2,6,3,1,2,2
"France",672,3,4,2,2,0,2
"Peru",672,3,4,3,2,1,1
"Croatia",672,4,6,4,4,0,2
"Argentina",672,4,6,5,2,3,1
"France",673,3,9,9,0,9,1
"Peru",673,3,2,2,3,-1,2
"Spain",674,2,7,8,2,6,1
"Portugal",674,2,4,2,3,-1,2
"Denmark",674,3,5,1,0,1,1
"Peru",674,3,4,4,3,1,2
"Brazil",674,5,9,7,1,6,1
"Costa Rica",674,5,4,5,4,1,2
"Spain",675,2,9,4,0,4,1
"Portugal",675,2,4,3,2,1,2
"England",675,7,6,5,5,0,1
"Belgium",675,7,4,6,5,1,2
"Argentina",676,4,9,6,2,4,1
"Nigeria",676,4,4,4,3,1,2
"Brazil",676,5,7,6,2,4,1
"Switzerland",676,5,7,4,2,2,2
"Denmark",677,3,6,2,1,1,2
"Australia",677,3,6,3,1,2,1
"Argentina",677,4,6,3,1,2,1
"Iceland",677,4,6,3,3,0,2
"Brazil",677,5,6,3,2,1,2
"Switzerland",677,5,6,6,2,4,1
"Colombia",678,8,6,4,1,3,2
"Poland",678,8,6,7,3,4,1
"Spain",679,2,5,2,0,2,2
"Iran",679,2,5,5,2,3,1
"Costa Rica",679,5,6,3,2,1,1
"Brazil",679,5,4,3,2,1,2
"Uruguay",680,1,5,5,3,2,1
"Egypt",680,1,5,4,3,1,2
"Nigeria",680,4,7,5,2,3,1
"Croatia",680,4,4,1,1,0,2
"Brazil",680,5,6,4,2,2,1
"Serbia",680,5,4,6,5,1,2
"Poland",680,8,5,3,2,1,1
"Colombia",680,8,4,3,2,1,2
"Uruguay",681,1,6,9,5,4,1
"Egypt",681,1,6,4,3,1,2
"Spain",681,2,7,4,2,2,2
"Portugal",681,2,7,5,1,4,1
"France",682,3,9,7,3,4,1
"Australia",682,3,3,6,5,1,2
"Germany",682,6,5,6,3,3,1
"Mexico",682,6,4,6,5,1,2
"Switzerland",683,5,9,9,1,8,1
"Costa Rica",683,5,4,2,2,0,2
"Egypt",684,1,6,3,2,1,1
"Uruguay",684,1,4,5,4,1,2
"Peru",685,3,7,4,1,3,1
"Australia",685,3,4,4,4,0,2
"Mexico",685,6,7,5,1,4,1
"Germany",685,6,4,4,4,0,2
"Colombia",685,8,6,8,3,5,1
"Poland",685,8,6,5,2,3,2
"Poland",686,8,9,5,1,4,1
"Japan",686,8,4,5,5,0,2
"Uruguay",687,1,6,4,3,1,1
"Egypt",687,1,4,4,3,1,2
"Argentina",687,4,5,7,2,5,1
"Nigeria",687,4,5,5,3,2,2
"Japan",687,8,7,2,0,2,2
"Poland",687,8,7,4,0,4,1
"France",689,3,6,3,3,0,2
"Denmark",689,3,6,4,2,2,1
"Portugal",690,2,6,7,7,0,2
"Iran",690,2,6,6,5,1,1
"Colombia",691,8,7,7,1,6,1
"Poland",691,8,4,1,1,0,2
"Argentina",692,4,9,8,1,7,1
"Croatia",692,4,4,5,5,0,2
"South Korea",692,6,7,7,5,2,2
"Germany",692,6,7,7,2,5,1
"Spain",693,2,6,3,2,1,2
"Portugal",693,2,6,5,2,3,1
"France",693,3,6,5,3,2,2
"Peru",693,3,6,8,4,4,1
"Argentina",693,4,6,5,2,3,1
"Nigeria",693,4,6,4,4,0,2
"Switzerland",693,5,6,7,2,5,1
"Costa Rica",693,5,6,4,5,-1,2
"Belgium",693,7,7,6,2,4,1
"England",693,7,4,3,2,1,2
"Colombia",693,8,7,6,2,4,1
"Poland",693,8,7,5,3,2,2
"Portugal",694,2,5,3,1,2,1
"Iran",694,2,4,2,1,1,2
"Uruguay",695,1,6,4,5,-1,1
"Russia",695,1,4,5,3,2,2
"Argentina",695,4,9,9,2,7,1
"Iceland",695,4,3,2,3,-1,2
"Panama",696,7,6,5,2,3,1
"Tunisia",696,7,4,3,3,0,2
"Uruguay",697,1,6,9,4,5,1
"Russia",697,1,6,5,4,1,2
"Russia",698,1,6,3,1,2,1
"Egypt",698,1,4,2,2,0,2
"Germany",698,6,5,6,4,2,1
"Sweden",698,6,4,4,3,1,2
"Belgium",698,7,6,5,3,2,1
"Panama",698,7,4,4,3,1,2
"Colombia",700,8,7,9,0,9,1
"Japan",700,8,7,4,0,4,2
"France",701,3,9,8,1,7,1
"Peru",701,3,4,3,3,0,2
"Brazil",701,5,6,5,2,3,1
"Switzerland",701,5,6,3,2,1,2
"France",702,3,5,4,1,3,1
"Denmark",702,3,5,2,1,1,2
"Argentina",702,4,9,13,1,12,1
"Croatia",702,4,4,4,4,0,2
"Germany",702,6,6,6,6,0,1
"Mexico",702,6,4,4,2,2,2
"Belgium",702,7,7,9,2,7,1
"England",702,7,7,5,2,3,2
"France",704,3,6,9,2,7,1
"Australia",704,3,6,4,5,-1,2
"South Korea",704,6,6,3,1,2,2
"Germany",704,6,6,7,2,5,1
"Peru",705,3,5,4,2,2,1
"Denmark",705,3,4,6,5,1,2
"Costa Rica",705,5,5,4,3,1,1
"Serbia",705,5,4,3,3,0,2
"South Korea",705,6,6,5,3,2,1
"Germany",705,6,4,4,2,2,2
"Belgium",705,7,9,11,5,6,1
"England",705,7,4,5,4,1,2
"Uruguay",706,1,6,7,4,3,2
"Russia",706,1,6,9,5,4,1
"France",706,3,9,5,1,4,1
"Peru",706,3,3,6,4,2,2
"Brazil",706,5,9,9,5,4,1
"Costa Rica",706,5,3,5,5,0,2
"Belgium",706,7,6,7,2,5,1
"England",706,7,4,4,4,0,2
"Uruguay",707,1,6,5,5,0,2
"Egypt",707,1,6,5,3,2,1
"Spain",707,2,7,5,2,3,2
"Portugal",707,2,7,4,0,4,1
"Uruguay",708,1,7,8,5,3,1
"Saudi Arabia",708,1,7,6,4,2,2
"Belgium",708,7,6,6,1,5,1
"Panama",708,7,4,4,4,0,2
"Russia",709,1,5,3,2,1,1
"Egypt",709,1,4,7,5,2,2
"France",709,3,6,4,1,3,1
"Denmark",709,3,6,2,2,0,2
"Brazil",709,5,7,2,0,2,2
"Switzerland",709,5,7,6,2,4,1
"Spain",710,2,6,5,1,4,1
"Portugal",710,2,6,4,4,0,2
"Brazil",710,5,5,4,2,2,2
"Switzerland",710,5,5,7,2,5,1
"England",710,7,6,5,3,2,1
"Tunisia",710,7,6,4,3,1,2
"Tunisia",711,7,5,4,3,1,2
"Panama",711,7,5,5,3,2,1
"Japan",711,8,6,4,5,-1,1
"Colombia",711,8,4,6,4,2,2
"Uruguay",712,1,7,5,1,4,1
"Egypt",712,1,7,4,2,2,2
"Spain",712,2,9,7,0,7,1
"Portugal",712,2,3,2,2,0,2
"France",712,3,7,4,2,2,1
"Australia",712,3,4,5,2,3,2
"Germany",712,6,9,4,1,3,1
"Sweden",712,6,3,7,4,3,2
"Portugal",713,2,5,5,3,2,1
"Morocco",713,2,4,3,3,0,2
"Uruguay",714,1,6,5,2,3,1
"Saudi Arabia",714,1,6,2,1,1,2
"France",714,3,9,7,1,6,1
"Denmark",714,3,3,2,3,-1,2
"Brazil",715,5,9,6,2,4,1
"Serbia",715,5,3,5,5,0,2
"Belgium",715,7,6,3,3,0,2
"England",715,7,6,6,2,4,1
"Argentina",716,4,9,9,1,8,1
"Croatia",716,4,2,3,4,-1,2
"Germany",717,6,6,6,4,2,1
"Sweden",717,6,4,5,4,1,2
"France",718,3,5,2,1,1,1
"Peru",718,3,4,2,2,0,2
"Colombia",718,8,9,7,1,6,1
"Senegal",718,8,4,5,3,2,2
"Brazil",719,5,6,5,4,1,2
"Switzerland",719,5,6,7,4,3,1
"Uruguay",720,1,6,6,4,2,1
"Russia",720,1,4,4,2,2,2
"France",720,3,6,8,4,4,1
"Peru",720,3,6,7,4,3,2
"Belgium",720,7,6,4,3,1,2
"England",720,7,6,7,2,5,1
"Switzerland",721,5,5,5,3,2,1
"Costa Rica",721,5,4,2,2,0,2
"Uruguay",722,1,6,5,3,2,1
"Russia",722,1,4,3,2,1,2
"France",723,3,6,5,4,1,1
"Peru",723,3,4,4,4,0,2
"Brazil",723,5,4,5,3,2,1
"Costa Rica",723,5,4,4,4,0,2
"France",724,3,5,4,2,2,2
"Peru",724,3,5,4,1,3,1
"Croatia",724,4,6,6,5,1,1
"Iceland",724,4,4,3,2,1,2
"Switzerland",725,5,6,4,2,2,1
"Serbia",725,5,4,6,4,2,2
"Colombia",725,8,7,10,4,6,1
"Poland",725,8,7,5,2,3,2
"Iran",726,2,6,5,3,2,1
"Spain",726,2,4,4,3,1,2
"Argentina",726,4,9,7,1,6,1
"Iceland",726,4,4,3,3,0,2
"Russia",727,1,6,4,2,2,1
"Saudi Arabia",727,1,6,3,2,1,2
"Peru",727,3,6,4,3,1,1
"Australia",727,3,4,6,4,2,2
"France",728,3,6,5,3,2,2
"Australia",728,3,6,7,4,3,1
"Brazil",728,5,6,5,2,3,1
"Switzerland",728,5,6,4,4,0,2
"Uruguay",729,1,6,6,4,2,1
"Russia",729,1,6,3,2,1,2
"South Korea",730,6,6,8,5,3,1
"Germany",730,6,6,6,5,1,2
"Spain",731,2,7,5,1,4,1
"Portugal",731,2,7,4,1,3,2
"Peru",731,3,9,4,0,4,1
"France",731,3,4,6,3,3,2
"Iceland",731,4,5,3,1,2,1
"Argentina",731,4,4,4,2,2,2
"Portugal",732,2,6,5,3,2,1
"Iran",732,2,6,2,1,1,2
"Argentina",732,4,6,9,4,5,1
"Croatia",732,4,4,3,4,-1,2
"Colombia",732,8,7,5,1,4,1
"Poland",732,8,4,3,2,1,2
"France",733,3,9,10,1,9,1
"Australia",733,3,4,2,2,0,2
"Switzerland",734,5,5,2,0,2,1
"Costa Rica",734,5,5,3,2,1,2
"Mexico",735,6,6,2,1,1,2
"Germany",735,6,6,8,3,5,1
"Peru",736,3,7,7,4,3,1
"France",736,3,4,4,3,1,2
"Brazil",736,5,6,4,4,0,2
"Switzerland",736,5,6,8,2,6,1
"Sweden",736,6,6,3,5,-2,2
"Mexico",736,6,6,7,4,3,1
"Argentina",737,4,5,4,1,3,1
"Nigeria",737,4,5,2,1,1,2
"Colombia",737,8,5,5,4,1,1
"Japan",737,8,4,2,1,1,2
"Uruguay",739,1,9,8,1,7,1
"Egypt",739,1,2,2,3,-1,2
"Croatia",739,4,7,3,1,2,2
"Argentina",739,4,7,10,0,10,1
"Germany",739,6,5,4,2,2,1
"South Korea",739,6,4,3,2,1,2
"Spain",740,2,6,5,3,2,1
"Morocco",740,2,6,4,3,1,2
"Croatia",740,4,5,6,2,4,1
"Argentina",740,4,5,4,2,2,2
"Serbia",741,5,6,4,3,1,2
"Costa Rica",741,5,6,4,2,2,1
"Sweden",741,6,6,6,2,4,1
"South Korea",741,6,4,2,2,0,2
"Belgium",741,7,7,4,2,2,1
"England",741,7,4,7,2,5,2
"Senegal",741,8,6,7,5,2,1
"Japan",741,8,4,5,4,1,2
"Argentina",742,4,6,7,4,3,1
"Nigeria",742,4,6,4,5,-1,2
"Costa Rica",742,5,7,5,1,4,1
"Serbia",742,5,4,2,1,1,2
"Portugal",743,2,5,5,3,2,1
"Iran",743,2,5,4,3,1,2
"Croatia",744,4,7,6,2,4,1
"Argentina",744,4,7,6,3,3,2
"Brazil",744,5,6,6,2,4,1
"Costa Rica",744,5,6,2,2,0,2
"England",744,7,7,8,5,3,2
"Panama",744,7,7,6,2,4,1
"Russia",745,1,7,6,3,3,1
"Egypt",745,1,4,2,2,0,2
"Brazil",745,5,7,6,2,4,1
"Costa Rica",745,5,7,9,6,3,2
"Nigeria",746,4,6,4,1,3,1
"Argentina",746,4,4,3,2,1,2
"Colombia",746,8,5,4,0,4,1
"Poland",746,8,5,4,2,2,2
"Brazil",747,5,6,4,2,2,2
"Switzerland",747,5,6,5,2,3,1
"Germany",747,6,7,4,1,3,1
"Mexico",747,6,4,2,1,1,2
"Colombia",747,8,9,8,2,6,1
"Senegal",747,8,4,2,2,0,2
"Japan",748,8,7,4,2,2,2
"Poland",748,8,7,7,1,6,1
"Spain",749,2,9,10,1,9,1
"Portugal",749,2,4,7,5,2,2
"Brazil",749,5,7,8,2,6,1
"Costa Rica",749,5,4,3,3,0,2
"Sweden",749,6,6,6,5,1,1
"Mexico",749,6,4,5,4,1,2
"Iran",750,2,4,3,3,0,2
"Morocco",750,2,4,6,5,1,1
"Croatia",750,4,7,8,1,7,1
"Iceland",750,4,4,3,3,0,2
"Sweden",750,6,5,6,3,3,1
"South Korea",750,6,4,5,4,1,2
"Belgium",750,7,6,8,7,1,2
"England",750,7,6,6,3,3,1
"Poland",750,8,6,4,5,-1,1
"Senegal",750,8,4,5,3,2,2
"Brazil",751,5,6,5,2,3,1
"Costa Rica",751,5,6,4,2,2,2
"Spain",753,2,9,4,0,4,1
"Portugal",753,2,4,3,2,1,2
"Colombia",754,8,6,4,4,0,2
"Japan",754,8,6,3,1,2,1
"France",755,3,5,4,1,3,1
"Peru",755,3,4,4,2,2,2
"Argentina",755,4,9,5,0,5,1
"Croatia",755,4,4,3,2,1,2
"Belgium",755,7,7,6,2,4,2
"Panama",755,7,7,9,3,6,1
"Colombia",755,8,7,7,2,5,1
"Poland",755,8,4,3,4,-1,2
"Spain",756,2,5,4,3,1,2
"Portugal",756,2,5,5,3,2,1
"South Korea",756,6,6,3,1,2,1
"Germany",756,6,6,2,2,0,2
"Colombia",756,8,6,4,4,0,1
"Poland",756,8,4,5,3,2,2
"France",757,3,7,7,0,7,1
"Australia",757,3,7,3,0,3,2
"Uruguay",758,1,5,7,4,3,1
"Egypt",758,1,4,6,5,1,2
"South Korea",758,6,5,6,5,1,1
"Mexico",758,6,4,4,3,1,2
"Peru",759,3,6,7,4,3,1
"Australia",759,3,6,3,2,1,2
"Uruguay",760,1,6,5,4,1,2
"Russia",760,1,6,8,3,5,1
"Croatia",760,4,6,2,1,1,1
"Argentina",760,4,4,5,2,3,2
"Brazil",760,5,9,5,0,5,1
"Switzerland",760,5,3,3,4,-1,2
"Belgium",760,7,7,6,2,4,1
"England",760,7,7,5,3,2,2
"Japan",760,8,7,8,4,4,1
"Poland",760,8,7,5,2,3,2
"Russia",761,1,7,3,1,2,1
"Uruguay",761,1,4,4,3,1,2
"Croatia",761,4,5,3,2,1,1
"Argentina",761,4,4,4,2,2,2
"South Korea",762,6,7,4,1,3,1
"Mexico",762,6,4,6,5,1,2
"Croatia",763,4,7,4,0,4,1
"Argentina",763,4,7,4,2,2,2
"Brazil",763,5,7,11,4,7,1
"Costa Rica",763,5,4,5,4,1,2
"England",763,7,9,6,1,5,1
"Belgium",763,7,4,4,2,2,2
"Uruguay",764,1,9,7,3,4,1
"Russia",764,1,4,6,4,2,2
"Peru",764,3,7,6,1,5,1
"Denmark",764,3,4,3,3,0,2
"Iceland",764,4,6,6,2,4,1
"Croatia",764,4,4,3,3,0,2
"Poland",764,8,9,6,1,5,1
"Colombia",764,8,3,3,2,1,2
"Denmark",765,3,4,3,3,0,2
"Australia",765,3,4,4,3,1,1
"Argentina",766,4,6,2,1,1,2
"Nigeria",766,4,6,5,3,2,1
"Colombia",766,8,6,5,3,2,1
"Japan",766,8,6,7,7,0,2
"Croatia",767,4,6,4,1,3,2
"Argentina",767,4,6,6,2,4,1
"Brazil",767,5,7,6,3,3,1
"Costa Rica",767,5,7,3,1,2,2
"Spain",768,2,6,5,2,3,1
"Portugal",768,2,6,3,1,2,2
"Croatia",770,4,7,2,0,2,1
"Nigeria",770,4,4,2,1,1,2
"Peru",771,3,7,8,1,7,1
"Australia",771,3,4,1,2,-1,2
"Belgium",771,7,7,9,2,7,1
"England",771,7,7,4,2,2,2
"Colombia",774,8,6,8,6,2,1
"Poland",774,8,6,5,5,0,2
"England",775,7,6,6,3,3,1
"Panama",775,7,4,4,3,1,2
"Brazil",776,5,9,6,1,5,1
"Switzerland",776,5,4,4,3,1,2
"England",776,7,6,7,1,6,1
"Belgium",776,7,4,4,3,1,2
"Denmark",777,3,5,2,1,1,1
"Peru",777,3,4,6,5,1,2
"Brazil",777,5,6,4,3,1,1
"Costa Rica",777,5,4,4,3,1,2
"Colombia",777,8,6,8,4,4,1
"Japan",777,8,4,5,3,2,2
"Portugal",778,2,6,4,2,2,1
"Morocco",778,2,4,4,4,0,2
"Brazil",778,5,6,7,3,4,1
"Costa Rica",778,5,6,6,5,1,2
"Portugal",779,2,6,3,3,0,2
"Iran",779,2,6,6,3,3,1
"Argentina",779,4,6,6,2,4,1
"Iceland",779,4,6,4,3,1,2
"France",781,3,5,4,2,2,1
"Peru",781,3,5,2,1,1,2
"Belgium",781,7,6,2,1,1,2
"Panama",781,7,6,4,2,2,1
"Uruguay",782,1,7,5,1,4,1
"Saudi Arabia",782,1,7,4,2,2,2
"Australia",782,3,7,3,1,2,1
"France",782,3,4,5,4,1,2
"Brazil",782,5,6,5,2,3,1
"Switzerland",782,5,4,5,3,2,2
"Sweden",782,6,5,4,3,1,1
"Mexico",782,6,4,4,2,2,2
"Spain",783,2,7,9,3,6,1
"Iran",783,2,4,4,4,0,2
"Australia",783,3,5,2,1,1,1
"France",783,3,4,2,2,0,2
"Egypt",784,1,6,5,4,1,1
"Uruguay",784,1,4,2,1,1,2
"Spain",784,2,7,9,6,3,1
"Iran",784,2,4,6,4,2,2
"Germany",784,6,7,6,2,4,1
"Mexico",784,6,4,4,2,2,2
"Spain",785,2,7,3,1,2,2
"Portugal",785,2,7,6,2,4,1
"France",785,3,7,4,1,3,1
"Denmark",785,3,4,4,3,1,2
"Spain",786,2,5,5,4,1,2
"Iran",786,2,5,4,2,2,1
"France",786,3,9,5,2,3,1
"Peru",786,3,3,5,4,1,2
"Belgium",786,7,5,2,0,2,1
"England",786,7,5,2,1,1,2
"Spain",789,2,6,5,1,4,1
"Iran",789,2,6,5,3,2,2
"Croatia",789,4,6,2,1,1,2
"Argentina",789,4,6,5,2,3,1
"Colombia",789,8,5,6,3,3,1
"Japan",789,8,5,3,2,1,2
"Argentina",790,4,7,5,1,4,1
"Nigeria",790,4,7,5,2,3,2
"Serbia",790,5,6,3,1,2,1
"Costa Rica",790,5,6,5,4,1,2
"Mexico",790,6,6,7,1,6,1
"Germany",790,6,4,2,2,0,2
"Belgium",790,7,9,8,3,5,1
"England",790,7,3,7,5,2,2
"Brazil",791,5,9,8,1,7,1
"Switzerland",791,5,4,3,3,0,2
"South Korea",791,6,6,5,4,1,2
"Germany",791,6,6,9,3,6,1
"Belgium",791,7,6,5,1,4,1
"England",791,7,6,7,6,1,2
"Croatia",792,4,7,4,2,2,2
"Argentina",792,4,7,5,1,4,1
"Switzerland",793,5,5,4,3,1,1
"Serbia",793,5,4,4,4,0,2
"South Korea",793,6,6,4,3,1,2
"Germany",793,6,6,5,2,3,1
"Colombia",793,8,7,5,1,4,1
"Poland",793,8,4,5,4,1,2
"Peru",794,3,5,5,3,2,1
"France",794,3,4,7,4,3,2
"Brazil",794,5,6,5,4,1,2
"Costa Rica",794,5,6,5,3,2,1
"England",794,7,6,7,2,5,1
"Belgium",794,7,4,3,3,0,2
"France",795,3,6,7,4,3,2
"Denmark",795,3,6,9,5,4,1
"Belgium",795,7,6,2,1,1,2
"England",795,7,6,6,3,3,1
"Japan",795,8,7,5,3,2,1
"Poland",795,8,4,5,4,1,2
"Morocco",796,2,7,6,2,4,1
"Spain",796,2,4,2,2,0,2
"England",796,7,7,12,3,9,1
"Panama",796,7,7,7,4,3,2
"Russia",797,1,5,1,0,1,1
"Uruguay",797,1,4,3,2,1,2
"France",797,3,5,6,4,2,1
"Peru",797,3,4,2,2,0,2
"England",797,7,9,6,1,5,1
"Panama",797,7,3,4,4,0,2
"Japan",797,8,6,6,6,0,1
"Colombia",797,8,4,5,4,1,2
"Spain",799,2,7,9,5,4,2
"Portugal",799,2,7,10,4,6,1
"South Korea",799,6,7,4,1,3,2
"Germany",799,6,7,7,3,4,1
"Japan",800,8,9,8,2,6,1
"Poland",800,8,2,6,7,-1,2
"England",801,7,7,3,0,3,1
"Belgium",801,7,4,3,3,0,2
"Brazil",802,5,6,7,3,4,1
"Switzerland",802,5,6,3,5,-2,2
"Costa Rica",803,5,6,5,4,1,1
"Serbia",803,5,4,3,3,0,2
"Argentina",804,4,6,8,3,5,1
"Croatia",804,4,4,5,4,1,2
"Portugal",805,2,7,4,2,2,1
"Spain",805,2,4,4,2,2,2
"Sweden",805,6,6,4,1,3,1
"Mexico",805,6,6,4,3,1,2
"Spain",806,2,5,7,3,4,1
"Portugal",806,2,5,5,2,3,2
"Denmark",806,3,7,5,3,2,2
"Peru",806,3,7,6,3,3,1
"Belgium",806,7,6,3,3,0,2
"England",806,7,6,4,1,3,1
"Croatia",807,4,6,2,3,-1,2
"Nigeria",807,4,6,4,2,2,1
"South Korea",807,6,6,3,3,0,1
"Germany",807,6,4,3,2,1,2
"Japan",807,8,5,2,1,1,1
"Colombia",807,8,4,5,4,1,2
"Uruguay",808,1,7,5,1,4,1
"Russia",808,1,4,4,2,2,2
"Brazil",808,5,6,6,2,4,1
"Costa Rica",808,5,6,4,3,1,2
"Croatia",809,4,6,3,5,-2,2
"Iceland",809,4,6,6,3,3,1
"Brazil",809,5,6,5,4,1,1
"Serbia",809,5,6,4,4,0,2
"Germany",809,6,9,6,1,5,1
"South Korea",809,6,3,3,3,0,2
"Belgium",809,7,6,5,6,-1,2
"England",809,7,6,3,2,1,1
"Japan",809,8,7,7,1,6,1
"Senegal",809,8,4,3,3,0,2
"Switzerland",811,5,6,6,3,3,2
"Costa Rica",811,5,6,6,2,4,1
"South Korea",811,6,7,7,2,5,1
"Germany",811,6,7,5,1,4,2
"Belgium",811,7,7,5,1,4,1
"England",811,7,7,5,2,3,2
"Japan",811,8,7,6,1,5,1
"Senegal",811,8,7,4,1,3,2
"France",812,3,6,4,1,3,1
"Australia",812,3,6,3,3,0,2
"Switzerland",812,5,6,4,3,1,1
"Costa Rica",812,5,6,3,4,-1,2
"Japan",812,8,7,4,1,3,1
"Senegal",812,8,4,2,2,0,2
"Denmark",813,3,6,5,4,1,1
"Australia",813,3,4,5,4,1,2
"Uruguay",814,1,6,4,2,2,1
"Russia",814,1,4,6,4,2,2
"England",814,7,6,6,4,2,1
"Belgium",814,7,4,4,2,2,2
"Poland",815,8,6,5,3,2,1
"Japan",815,8,4,2,2,0,2
"France",816,3,5,4,1,3,1
"Australia",816,3,4,2,1,1,2
"Mexico",816,6,6,5,2,3,1
"Germany",816,6,6,3,1,2,2
"Senegal",816,8,6,3,3,0,2
"Poland",816,8,6,5,3,2,1
"Argentina",817,4,7,8,0,8,1
"Croatia",817,4,4,1,3,-2,2
"South Korea",817,6,6,3,2,1,1
"Sweden",817,6,4,4,3,1,2
"England",817,7,9,8,3,5,1
"Panama",817,7,4,5,2,3,2
"Uruguay",818,1,9,7,2,5,1
"Saudi Arabia",818,1,4,1,1,0,2
"Spain",818,2,7,5,1,4,1
"Portugal",818,2,7,6,3,3,2
"Mexico",819,6,5,3,2,1,2
"Germany",819,6,5,6,3,3,1
"South Korea",820,6,6,4,3,1,1
"Sweden",820,6,4,3,1,2,2
"Senegal",820,8,6,4,3,1,1
"Japan",820,8,4,5,4,1,2
"Denmark",821,3,6,5,4,1,1
"Peru",821,3,4,5,3,2,2
"Sweden",821,6,5,3,2,1,1
"Germany",821,6,4,6,3,3,2
"Belgium",821,7,5,2,0,2,1
"Tunisia",821,7,5,3,2,1,2
"Uruguay",822,1,9,8,0,8,1
"Egypt",822,1,4,5,5,0,2
"Germany",822,6,7,7,1,6,1
"South Korea",822,6,4,4,3,1,2
"Colombia",822,8,6,7,3,4,1
"Japan",822,8,6,6,4,2,2
"Iran",825,2,6,4,1,3,1
"Portugal",825,2,4,3,3,0,2
"Brazil",825,5,5,8,3,5,1
"Costa Rica",825,5,5,5,2,3,2
"Belgium",825,7,6,6,2,4,1
"England",825,7,4,3,3,0,2
"Colombia",825,8,6,5,3,2,1
"Japan",825,8,6,4,3,1,2
"Uruguay",826,1,7,4,2,2,2
"Russia",826,1,7,4,1,3,1
"Russia",827,1,6,3,6,-3,1
"Uruguay",827,1,4,6,2,4,2
"France",827,3,7,6,2,4,1
"Peru",827,3,7,5,3,2,2
"Argentina",827,4,9,8,3,5,1
"Croatia",827,4,4,3,3,0,2
"Colombia",828,8,6,2,1,1,2
"Poland",828,8,6,6,1,5,1
"Belgium",829,7,6,3,2,1,2
"Tunisia",829,7,6,6,4,2,1
"Argentina",830,4,9,5,1,4,1
"Croatia",830,4,3,4,4,0,2
"Spain",831,2,5,4,2,2,1
"Iran",831,2,5,4,3,1,2
"Sweden",831,6,5,4,1,3,1
"Mexico",831,6,5,4,2,2,2
"Belgium",831,7,6,4,3,1,2
"Panama",831,7,6,7,5,2,1
"France",833,3,6,2,3,-1,1
"Peru",833,3,4,3,1,2,2
"Brazil",833,5,9,6,2,4,1
"Switzerland",833,5,3,6,6,0,2
"Germany",833,6,9,5,2,3,1
"Mexico",833,6,4,5,1,4,2
"Belgium",833,7,7,6,3,3,2
"England",833,7,7,5,1,4,1
"Senegal",833,8,6,4,4,0,2
"Poland",833,8,6,5,4,1,1
"Spain",834,2,6,6,3,3,1
"Portugal",834,2,6,3,2,1,2
"Croatia",834,4,6,3,3,0,1
"Argentina",834,4,4,4,3,1,2
"Brazil",834,5,6,3,1,2,1
"Costa Rica",834,5,6,5,4,1,2
"England",834,7,6,4,2,2,1
"Panama",834,7,4,6,5,1,2
"Senegal",834,8,9,4,0,4,1
"Poland",834,8,4,3,3,0,2
"Brazil",835,5,5,3,1,2,1
"Costa Rica",835,5,5,2,1,1,2
"Mexico",835,6,5,5,3,2,2
"Germany",835,6,5,6,3,3,1
"Poland",835,8,9,6,2,4,1
"Japan",835,8,3,3,2,1,2
"Uruguay",836,1,9,7,1,6,1
"Saudi Arabia",836,1,3,4,5,-1,2
"Mexico",836,6,6,3,1,2,2
"Germany",836,6,6,6,2,4,1
"England",836,7,6,4,1,3,1
"Panama",836,7,6,6,4,2,2
"Poland",836,8,9,6,2,4,1
"Senegal",836,8,3,2,2,0,2
"Brazil",837,5,7,5,2,3,1
"Costa Rica",837,5,4,3,2,1,2
"Mexico",837,6,6,5,3,2,1
"South Korea",837,6,4,3,2,1,2
"Spain",838,2,6,4,5,-1,2
"Iran",838,2,6,6,3,3,1
"Germany",838,6,9,6,1,5,1
"Mexico",838,6,3,5,4,1,2
"Belgium",838,7,6,9,4,5,1
"England",838,7,6,8,5,3,2
"Argentina",839,4,9,8,4,4,1
"Croatia",839,4,4,5,3,2,2
"Argentina",840,4,7,5,2,3,1
"Croatia",840,4,4,4,3,1,2
"Sweden",840,6,6,6,3,3,1
"South Korea",840,6,6,4,4,0,2
"Senegal",840,8,6,4,4,0,2
"Poland",840,8,6,5,4,1,1
"Belgium",841,7,7,5,2,3,1
"England",841,7,4,4,2,2,2
"Colombia",841,8,7,5,1,4,1
"Japan",841,8,7,4,2,2,2
"Uruguay",842,1,6,4,3,1,2
"Russia",842,1,6,3,1,2,1
"Japan",842,8,7,4,1,3,2
"Poland",842,8,7,8,1,7,1
"Brazil",843,5,7,3,1,2,2
"Switzerland",843,5,7,3,0,3,1
"Russia",844,1,6,8,5,3,1
"Egypt",844,1,6,3,3,0,2
"Brazil",844,5,6,4,3,1,1
"Costa Rica",844,5,4,2,2,0,2
"Uruguay",845,1,5,3,2,1,2
"Russia",845,1,5,4,2,2,1
"Germany",845,6,9,5,0,5,1
"Mexico",845,6,4,4,3,1,2
"Uruguay",846,1,9,3,0,3,1
"Saudi Arabia",846,1,4,2,1,1,2
"France",846,3,6,9,1,8,1
"Peru",846,3,4,3,3,0,2
"Brazil",846,5,9,5,1,4,1
"Costa Rica",846,5,3,4,4,0,2
"England",846,7,7,4,1,3,1
"Panama",846,7,4,5,4,1,2
"Colombia",846,8,5,2,0,2,1
"Poland",846,8,5,3,2,1,2
"Saudi Arabia",847,1,7,4,1,3,1
"Egypt",847,1,7,4,2,2,2
"Spain",847,2,5,3,2,1,1
"Portugal",847,2,4,3,2,1,2
"Argentina",847,4,5,4,3,1,2
"Iceland",847,4,5,6,4,2,1
"Colombia",847,8,6,4,2,2,2
"Japan",847,8,6,5,1,4,1
"Uruguay",848,1,6,8,7,1,2
"Saudi Arabia",848,1,6,10,5,5,1
"Denmark",848,3,6,6,4,2,1
"Peru",848,3,6,2,3,-1,2
"Croatia",849,4,6,6,2,4,1
"Argentina",849,4,6,4,3,1,2
"Croatia",850,4,6,4,2,2,1
"Argentina",850,4,6,3,2,1,2
"Brazil",850,5,6,5,1,4,1
"Costa Rica",850,5,4,5,3,2,2
"Japan",850,8,6,3,2,1,2
"Poland",850,8,6,6,2,4,1
"Russia",851,1,6,5,1,4,1
"Saudi Arabia",851,1,6,4,3,1,2
"Denmark",851,3,5,6,5,1,2
"Peru",851,3,5,5,3,2,1
"Brazil",851,5,7,5,1,4,1
"Serbia",851,5,4,3,2,1,2
"Belgium",851,7,7,5,2,3,1
"Tunisia",851,7,4,4,3,1,2
"Spain",852,2,6,4,2,2,2
"Portugal",852,2,6,7,3,4,1
"Japan",852,8,7,8,3,5,1
"Poland",852,8,7,6,3,3,2
"Argentina",854,4,7,7,3,4,1
"Iceland",854,4,7,7,4,3,2
"Brazil",854,5,6,5,3,2,1
"Serbia",854,5,4,1,1,0,2
"Japan",854,8,7,6,1,5,1
"Poland",854,8,4,3,4,-1,2
"Croatia",855,4,6,4,2,2,2
"Argentina",855,4,6,7,2,5,1
"Belgium",855,7,7,5,2,3,1
"Tunisia",855,7,4,4,3,1,2
"Colombia",855,8,6,6,1,5,1
"Japan",855,8,6,3,4,-1,2
"Portugal",856,2,6,5,2,3,2
"Iran",856,2,6,6,2,4,1
"Brazil",856,5,6,3,2,1,1
"Serbia",856,5,4,4,2,2,2
"Japan",856,8,6,4,3,1,2
"Poland",856,8,6,7,5,2,1
"France",857,3,6,4,4,0,2
"Peru",857,3,6,4,2,2,1
"Iceland",857,4,5,1,0,1,1
"Argentina",857,4,4,4,2,2,2
"Russia",858,1,6,4,2,2,1
"Uruguay",858,1,4,4,3,1,2
"Belgium",858,7,7,2,0,2,2
"England",858,7,7,6,2,4,1
"England",860,7,5,2,0,2,1
"Panama",860,7,5,3,2,1,2
"Uruguay",861,1,7,5,1,4,1
"Egypt",861,1,7,4,1,3,2
"France",861,3,7,5,1,4,1
"Australia",861,3,7,3,0,3,2
"England",861,7,6,12,4,8,1
"Panama",861,7,6,6,4,2,2
"Poland",862,8,5,3,2,1,1
"Japan",862,8,4,4,3,1,2
"Uruguay",863,1,6,6,3,3,1
"Russia",863,1,4,2,2,0,2
"France",863,3,9,6,1,5,1
"Peru",863,3,3,5,3,2,2
"Uruguay",864,1,5,5,3,2,1
"Saudi Arabia",864,1,5,5,4,1,2
"Argentina",864,4,6,3,3,0,2
"Iceland",864,4,6,2,1,1,1
"Croatia",865,4,9,8,0,8,1
"Nigeria",865,4,2,2,3,-1,2
"France",866,3,5,3,1,2,1
"Peru",866,3,4,6,4,2,2
"Uruguay",867,1,6,4,3,1,2
"Saudi Arabia",867,1,6,4,2,2,1
"Mexico",867,6,6,9,3,6,1
"Germany",867,6,6,5,4,1,2
"Colombia",868,8,6,6,2,4,1
"Japan",868,8,6,4,3,1,2
"Germany",869,6,7,4,0,4,1
"South Korea",869,6,4,3,3,0,2
"Belgium",869,7,6,10,2,8,1
"England",869,7,6,4,4,0,2
"Saudi Arabia",870,1,4,4,3,1,1
"Egypt",870,1,4,3,3,0,2
"Argentina",870,4,9,5,0,5,1
"Croatia",870,4,4,3,1,2,2
"Colombia",870,8,9,7,3,4,1
"Japan",870,8,4,5,4,1,2
"Australia",871,3,6,5,3,2,1
"Peru",871,3,4,7,5,2,2
"Argentina",872,4,6,3,1,2,1
"Iceland",872,4,4,2,2,0,2
"Brazil",872,5,7,3,0,3,1
"Serbia",872,5,4,4,2,2,2
"Belgium",873,7,6,8,1,7,1
"England",873,7,6,6,3,3,2
"Spain",876,2,7,3,0,3,2
"Portugal",876,2,7,7,1,6,1
"Brazil",876,5,5,2,1,1,1
"Costa Rica",876,5,4,4,4,0,2
"Argentina",877,4,7,4,0,4,1
"Iceland",877,4,7,4,2,2,2
"Poland",878,8,7,3,1,2,1
"Colombia",878,8,4,4,3,1,2
"France",879,3,9,8,2,6,1
"Denmark",879,3,4,4,3,1,2
"Colombia",879,8,6,7,2,5,1
"Japan",879,8,6,3,2,1,2
"Japan",880,8,6,5,6,-1,1
"Poland",880,8,4,6,5,1,2
"France",881,3,6,4,2,2,1
"Australia",881,3,6,2,2,0,2
"England",881,7,6,7,1,6,1
"Tunisia",881,7,4,2,2,0,2
"Colombia",881,8,7,7,3,4,1
"Japan",881,8,4,6,5,1,2
"Croatia",882,4,6,3,3,0,2
"Argentina",882,4,6,5,2,3,1
"Brazil",882,5,7,3,0,3,2
"Costa Rica",882,5,7,5,1,4,1
"Mexico",882,6,7,5,2,3,2
"Germany",882,6,7,7,2,5,1
"Colombia",882,8,6,3,2,1,2
"Poland",882,8,6,7,2,5,1
"Uruguay",883,1,5,5,3,2,1
"Egypt",883,1,5,2,1,1,2
"Spain",883,2,6,4,4,0,2
"Portugal",883,2,6,5,3,2,1
"Croatia",883,4,5,5,2,3,1
"Argentina",883,4,5,2,1,1,2
"Uruguay",884,1,6,4,2,2,1
"Egypt",884,1,4,4,3,1,2
"South Korea",884,6,6,5,3,2,1
"Germany",884,6,6,6,5,1,2
"England",884,7,6,5,3,2,1
"Panama",884,7,4,1,1,0,2
"Denmark",885,3,5,3,1,2,1
"France",885,3,4,4,3,1,2
"Mexico",885,6,5,6,2,4,1
"Germany",885,6,5,5,2,3,2
"Belgium",885,7,6,3,2,1,2
"England",885,7,6,5,2,3,1
"Spain",886,2,9,6,0,6,1
"Iran",886,2,4,3,3,0,2
"Peru",886,3,9,4,1,3,1
"France",886,3,3,9,7,2,2
"Belgium",886,7,5,3,2,1,1
"England",886,7,4,4,1,3,2
"Senegal",886,8,6,3,4,-1,1
"Poland",886,8,4,3,1,2,2
"Uruguay",887,1,5,3,2,1,1
"Russia",887,1,4,4,3,1,2
"Croatia",887,4,7,5,1,4,2
"Argentina",887,4,7,6,1,5,1
"Colombia",887,8,5,3,2,1,2
"Japan",887,8,5,4,2,2,1
"Portugal",888,2,5,1,0,1,1
"Iran",888,2,4,3,2,1,2
"Brazil",888,5,5,4,0,4,1
"Switzerland",888,5,5,3,2,1,2
"Belgium",888,7,6,4,3,1,2
"Panama",888,7,6,5,3,2,1
"Russia",890,1,6,7,6,1,1
"Saudi Arabia",890,1,6,3,3,0,2
"Peru",890,3,5,5,4,1,1
"France",890,3,4,4,3,1,2
"France",891,3,5,6,1,5,1
"Peru",891,3,5,2,1,1,2
"Costa Rica",891,5,7,2,0,2,1
"Switzerland",891,5,4,4,3,1,2
"Colombia",891,8,5,2,1,1,2
"Poland",891,8,5,6,2,4,1
"France",892,3,5,3,1,2,1
"Australia",892,3,4,4,3,1,2
"Croatia",892,4,6,4,1,3,1
"Argentina",892,4,6,3,2,1,2
"Mexico",893,6,6,9,4,5,1
"Germany",893,6,6,4,2,2,2
"Belgium",893,7,7,7,1,6,1
"Tunisia",893,7,4,1,1,0,2
"Colombia",893,8,9,7,1,6,1
"Japan",893,8,4,4,3,1,2
"Uruguay",894,1,7,3,1,2,2
"Russia",894,1,7,7,0,7,1
"Argentina",894,4,5,6,3,3,1
"Iceland",894,4,5,3,2,1,2
"Brazil",894,5,6,8,1,7,1
"Switzerland",894,5,4,2,2,0,2
"Mexico",894,6,6,5,1,4,1
"South Korea",894,6,6,3,3,0,2
"Colombia",894,8,5,4,3,1,1
"Poland",894,8,4,4,4,0,2
"Iran",895,2,9,5,1,4,1
"Spain",895,2,3,3,3,0,2
"France",895,3,9,9,1,8,1
"Denmark",895,3,4,3,3,0,2
"Argentina",895,4,6,6,4,2,2
"Iceland",895,4,6,6,2,4,1
"England",895,7,9,5,0,5,1
"Belgium",895,7,3,4,4,0,2
"France",896,3,7,4,1,3,1
"Peru",896,3,4,6,5,1,2
"Brazil",896,5,4,5,2,3,1
"Switzerland",896,5,4,2,1,1,2
"Russia",897,1,9,9,2,7,1
"Uruguay",897,1,4,6,4,2,2
"Spain",897,2,6,4,3,1,2
"Portugal",897,2,6,8,4,4,1
"South Korea",897,6,6,5,3,2,2
"Germany",897,6,6,10,4,6,1
"Portugal",898,2,6,4,2,2,2
"Iran",898,2,6,5,1,4,1
"Brazil",898,5,5,3,1,2,1
"Switzerland",898,5,4,4,4,0,2
"South Korea",898,6,7,4,1,3,1
"Germany",898,6,4,6,3,3,2
"Belgium",898,7,5,3,1,2,1
"England",898,7,4,3,2,1,2
"Brazil",899,5,7,7,3,4,1
"Switzerland",899,5,7,4,2,2,2
"Colombia",899,8,6,6,2,4,1
"Poland",899,8,6,4,4,0,2
"Colombia",900,8,6,4,6,-2,2
"Poland",900,8,6,4,3,1,1
"Uruguay",901,1,9,7,1,6,1
"Russia",901,1,3,4,5,-1,2
"France",902,3,7,3,0,3,1
"Peru",902,3,4,4,3,1,2
"Sweden",902,6,5,2,1,1,2
"Germany",902,6,5,4,1,3,1
"Colombia",902,8,9,5,0,5,1
"Senegal",902,8,4,2,1,1,2
"Argentina",903,4,6,6,5,1,2
"Nigeria",903,4,6,5,3,2,1
"Belgium",903,7,7,7,3,4,2
"England",903,7,7,7,2,5,1
"Colombia",903,8,6,2,1,1,2
"Poland",903,8,6,7,2,5,1
"Iran",904,2,9,6,2,4,1
"Portugal",904,2,4,2,2,0,2
"Croatia",904,4,7,7,4,3,1
"Argentina",904,4,7,4,2,2,2
"England",904,7,5,7,2,5,1
"Panama",904,7,4,4,2,2,2
"Uruguay",905,1,5,3,2,1,1
"Russia",905,1,4,4,3,1,2
"Germany",905,6,7,3,1,2,1
"Sweden",905,6,4,4,2,2,2
"Portugal",906,2,6,5,6,-1,1
"Spain",906,2,4,6,3,3,2
"Argentina",906,4,6,7,4,3,1
"Nigeria",906,4,6,4,5,-1,2
"Mexico",906,6,9,5,2,3,1
"South Korea",906,6,3,4,4,0,2
"Belgium",906,7,5,4,3,1,2
"England",906,7,5,8,2,6,1
"Colombia",906,8,9,10,0,10,1
"Japan",906,8,3,3,5,-2,2
"France",907,3,6,4,3,1,1
"Peru",907,3,4,3,2,1,2
"Colombia",907,8,6,4,3,1,1
"Poland",907,8,6,3,3,0,2
"Uruguay",908,1,6,4,1,3,1
"Russia",908,1,4,5,2,3,2
"Sweden",908,6,6,3,6,-3,2
"Germany",908,6,6,6,1,5,1
"France",909,3,6,4,1,3,1
"Denmark",909,3,6,2,1,1,2
"Denmark",910,3,6,4,4,0,1
"France",910,3,4,4,4,0,2
"Croatia",910,4,7,5,0,5,1
"Argentina",910,4,7,2,0,2,2
"Switzerland",910,5,9,8,1,7,1
"Brazil",910,5,4,1,1,0,2
"Uruguay",911,1,6,4,2,2,1
"Egypt",911,1,6,3,2,1,2
"South Korea",912,6,7,4,0,4,1
"Mexico",912,6,4,3,2,1,2
"Belgium",912,7,5,3,1,2,1
"England",912,7,5,1,0,1,2
"Colombia",912,8,6,5,1,4,1
"Poland",912,8,4,5,4,1,2
"Croatia",913,4,6,4,3,1,1
"Nigeria",913,4,4,3,2,1,2
"Brazil",913,5,9,5,2,3,1
"Switzerland",913,5,4,7,4,3,2
"Spain",914,2,6,4,2,2,1
"Portugal",914,2,6,2,3,-1,2
"Spain",915,2,7,7,2,5,1
"Iran",915,2,4,3,3,0,2
"Belgium",915,7,7,5,1,4,2
"England",915,7,7,8,0,8,1
"Colombia",915,8,6,5,3,2,1
"Poland",915,8,4,5,4,1,2
"France",916,3,9,5,0,5,1
"Denmark",916,3,3,5,2,3,2
"Mexico",916,6,6,3,4,-1,2
"South Korea",916,6,6,5,3,2,1
"Uruguay",917,1,6,6,2,4,1
"Egypt",917,1,6,2,1,1,2
"Panama",917,7,6,5,4,1,1
"England",917,7,4,3,2,1,2
"Spain",918,2,6,7,7,0,2
"Iran",918,2,6,3,2,1,1
"Spain",919,2,6,4,1,3,1
"Iran",919,2,6,4,2,2,2
"Colombia",919,8,5,5,4,1,1
"Senegal",919,8,4,4,3,1,2
"France",920,3,6,4,1,3,1
"Peru",920,3,4,3,3,0,2
"Brazil",920,5,6,4,1,3,1
"Costa Rica",920,5,4,1,1,0,2
"Colombia",920,8,6,4,2,2,1
"Japan",920,8,6,4,4,0,2
"Brazil",921,5,6,6,3,3,1
"Switzerland",921,5,6,3,4,-1,2
"Uruguay",922,1,7,4,1,3,2
"Egypt",922,1,7,10,2,8,1
"Croatia",922,4,6,8,5,3,1
"Argentina",922,4,6,5,4,1,2
"Egypt",923,1,6,5,3,2,1
"Saudi Arabia",923,1,4,4,3,1,2
"Denmark",923,3,6,6,2,4,1
"Australia",923,3,6,6,4,2,2
"Germany",923,6,6,7,5,2,1
"Mexico",923,6,4,4,3,1,2
"Japan",923,8,6,3,3,0,1
"Poland",923,8,4,7,3,4,2
"Spain",924,2,7,7,4,3,1
"Iran",924,2,4,6,3,3,2
"Brazil",924,5,7,4,1,3,2
"Costa Rica",924,5,7,6,0,6,1
"Peru",925,3,7,4,1,3,1
"France",925,3,4,3,2,1,2
"Portugal",926,2,6,5,4,1,1
"Spain",926,2,4,5,4,1,2
"Argentina",926,4,9,6,0,6,1
"Nigeria",926,4,4,3,1,2,2
"Portugal",927,2,7,9,6,3,1
"Spain",927,2,4,7,5,2,2
"Brazil",927,5,6,10,5,5,1
"Costa Rica",927,5,6,8,5,3,2
"Peru",928,3,9,8,3,5,1
"Australia",928,3,4,5,4,1,2
"South Korea",928,6,9,6,3,3,1
"Sweden",928,6,4,5,3,2,2
"Portugal",929,2,9,5,1,4,1
"Spain",929,2,4,3,2,1,2
"Germany",929,6,7,5,1,4,1
"Mexico",929,6,4,5,3,2,2
"Croatia",930,4,7,4,1,3,2
"Argentina",930,4,7,6,1,5,1
"Brazil",930,5,5,4,1,3,1
"Costa Rica",930,5,4,3,3,0,2
"South Korea",930,6,5,2,1,1,2
"Germany",930,6,5,5,3,2,1
"Saudi Arabia",931,1,9,6,2,4,1
"Russia",931,1,3,5,3,2,2
"Portugal",931,2,9,4,0,4,1
"Spain",931,2,4,2,2,0,2
"Germany",931,6,5,4,2,2,1
"South Korea",931,6,4,5,4,1,2
"Uruguay",932,1,7,7,3,4,1
"Russia",932,1,7,5,3,2,2
"Uruguay",933,1,5,3,2,1,1
"Russia",933,1,4,5,2,3,2
"Saudi Arabia",934,1,5,2,0,2,1
"Uruguay",934,1,4,5,4,1,2
"Argentina",934,4,6,7,2,5,1
"Nigeria",934,4,6,5,4,1,2
"Uruguay",935,1,7,4,0,4,1
"Russia",935,1,7,3,1,2,2
"Spain",935,2,6,2,1,1,2
"Portugal",935,2,6,6,1,5,1
"Portugal",936,2,6,4,3,1,2
"Iran",936,2,6,7,5,2,1
"Serbia",936,5,9,8,1,7,1
"Brazil",936,5,4,5,3,2,2
"Uruguay",938,1,6,4,4,0,2
"Saudi Arabia",938,1,6,4,2,2,1
"Sweden",939,6,6,3,3,0,1
"Mexico",939,6,4,4,3,1,2
"France",940,3,6,5,4,1,2
"Peru",940,3,6,5,3,2,1
"Croatia",940,4,6,6,3,3,1
"Nigeria",940,4,6,6,5,1,2
"Brazil",940,5,7,7,2,5,1
"Serbia",940,5,4,3,2,1,2
"France",941,3,9,8,3,5,1
"Australia",941,3,3,4,4,0,2
"Colombia",941,8,6,4,3,1,2
"Japan",941,8,6,6,4,2,1
"Spain",942,2,5,4,3,1,1
"Portugal",942,2,4,4,3,1,2
"Peru",942,3,5,6,3,3,1
"France",942,3,4,3,3,0,2
"Senegal",942,8,5,4,2,2,1
"Japan",942,8,4,3,2,1,2
"Costa Rica",943,5,7,3,0,3,1
"Serbia",943,5,4,5,3,2,2
"Uruguay",944,1,7,5,2,3,1
"Russia",944,1,4,5,4,1,2
"Croatia",944,4,9,8,0,8,1
"Argentina",944,4,4,3,2,1,2
"England",944,7,9,8,1,7,1
"Tunisia",944,7,3,5,5,0,2
"Japan",944,8,6,5,2,3,1
"Senegal",944,8,6,5,3,2,2
"Uruguay",945,1,6,6,3,3,1
"Russia",945,1,6,5,6,-1,2
"France",945,3,7,8,4,4,1
"Peru",945,3,7,8,5,3,2
"Brazil",945,5,6,3,2,1,1
"Costa Rica",945,5,4,4,3,1,2
"Belgium",945,7,7,9,2,7,1
"England",945,7,7,5,1,4,2
"Croatia",946,4,6,5,4,1,2
"Argentina",946,4,6,11,4,7,1
"Egypt",947,1,6,6,5,1,1
"Uruguay",947,1,4,3,1,2,2
"Spain",947,2,6,5,3,2,2
"Portugal",947,2,6,5,2,3,1
"Croatia",947,4,7,5,2,3,2
"Argentina",947,4,7,6,2,4,1
"Brazil",947,5,7,4,2,2,2
"Costa Rica",947,5,7,6,2,4,1
"Germany",947,6,5,4,3,1,1
"South Korea",947,6,4,5,5,0,2
"Japan",947,8,4,6,6,0,2
"Poland",947,8,4,4,3,1,1
"Brazil",948,5,6,7,6,1,1
"Costa Rica",948,5,4,7,5,2,2
"Uruguay",949,1,6,6,2,4,1
"Russia",949,1,6,7,4,3,2
"Australia",949,3,6,4,5,-1,1
"Denmark",949,3,4,3,1,2,2
"Germany",949,6,7,4,0,4,1
"South Korea",949,6,4,5,2,3,2
"Iran",950,2,7,4,1,3,1
"Spain",950,2,4,2,2,0,2
"Belgium",950,7,6,4,5,-1,2
"England",950,7,6,6,4,2,1
"South Korea",951,6,7,5,2,3,2
"Germany",951,6,7,7,2,5,1
"Morocco",952,2,6,6,3,3,1
"Spain",952,2,4,1,1,0,2
"Denmark",952,3,6,3,2,1,2
"Peru",952,3,6,4,2,2,1
"Brazil",952,5,6,7,2,5,1
"Switzerland",952,5,4,2,2,0,2
"Uruguay",953,1,6,5,3,2,1
"Russia",953,1,6,6,5,1,2
"France",953,3,5,5,2,3,1
"Denmark",953,3,5,3,1,2,2
"England",953,7,5,3,1,2,1
"Panama",953,7,5,1,0,1,2
"Senegal",953,8,6,5,3,2,1
"Poland",953,8,6,4,3,1,2
"Denmark",954,3,5,3,1,2,1
"France",954,3,4,3,2,1,2
"Mexico",954,6,6,3,2,1,1
"Germany",954,6,6,4,4,0,2
"England",954,7,9,10,1,9,1
"Belgium",954,7,2,1,2,-1,2
"South Korea",957,6,6,7,5,2,2
"Germany",957,6,6,6,3,3,1
"Colombia",957,8,7,9,3,6,1
"Japan",957,8,7,4,2,2,2
"Uruguay",958,1,6,3,1,2,1
"Egypt",958,1,4,3,3,0,2
"Uruguay",959,1,9,8,2,6,1
"Saudi Arabia",959,1,4,2,2,0,2
"Switzerland",959,5,7,6,4,2,1
"Brazil",959,5,4,5,3,2,2
"Colombia",959,8,6,5,3,2,1
"Poland",959,8,4,5,2,3,2
"Spain",960,2,6,6,5,1,2
"Portugal",960,2,6,7,4,3,1
"Brazil",960,5,5,3,2,1,1
"Costa Rica",960,5,4,2,2,0,2
"Mexico",960,6,7,4,1,3,2
"Germany",960,6,7,9,2,7,1
"Belgium",960,7,6,4,1,3,1
"England",960,7,6,3,2,1,2
"Uruguay",961,1,6,5,2,3,1
"Saudi Arabia",961,1,6,4,2,2,2
"Argentina",961,4,7,8,1,7,1
"Croatia",961,4,4,3,2,1,2
"Colombia",961,8,6,4,2,2,1
"Poland",961,8,4,2,2,0,2
"Uruguay",962,1,7,4,2,2,2
"Egypt",962,1,7,7,1,6,1
"Spain",962,2,7,8,3,5,1
"Iran",962,2,4,4,2,2,2
"France",962,3,6,4,5,-1,1
"Denmark",962,3,4,4,2,2,2
"Brazil",962,5,6,6,3,3,1
"Costa Rica",962,5,6,5,3,2,2
"Colombia",962,8,6,6,4,2,1
"Japan",962,8,4,5,5,0,2
"Portugal",964,2,5,3,2,1,1
"Iran",964,2,4,4,3,1,2
"Brazil",964,5,7,6,3,3,1
"Costa Rica",964,5,7,5,3,2,2
"Sweden",964,6,9,4,1,3,1
"Mexico",964,6,3,5,4,1,2
"Colombia",964,8,6,5,1,4,1
"Japan",964,8,6,5,3,2,2
"Portugal",965,2,9,6,1,5,1
"Spain",965,2,4,4,2,2,2
"Croatia",965,4,7,2,0,2,1
"Argentina",965,4,4,3,1,2,2
"Belgium",965,7,7,8,2,6,1
"England",965,7,7,6,2,4,2
"Uruguay",966,1,5,4,1,3,1
"Saudi Arabia",966,1,4,3,3,0,2
"Portugal",966,2,6,5,3,2,1
"Morocco",966,2,6,2,1,1,2
"Iceland",966,4,6,2,1,1,1
"Argentina",966,4,4,3,3,0,2
"Uruguay",967,1,7,9,2,7,1
"Egypt",967,1,4,5,4,1,2
"Peru",967,3,9,6,2,4,1
"Denmark",967,3,3,3,3,0,2
"Poland",967,8,9,4,0,4,1
"Senegal",967,8,4,3,2,1,2
"Uruguay",968,1,5,5,3,2,1
"Saudi Arabia",968,1,4,6,5,1,2
"Spain",968,2,4,4,4,0,2
"Iran",968,2,4,7,6,1,1
"Iceland",968,4,9,7,4,3,1
"Croatia",968,4,4,7,4,3,2
"Brazil",968,5,9,6,1,5,1
"Costa Rica",968,5,2,2,3,-1,2
"Uruguay",969,1,5,5,1,4,1
"Egypt",969,1,5,5,4,1,2
"Portugal",969,2,7,6,2,4,1
"Iran",969,2,4,2,2,0,2
"France",969,3,6,5,3,2,1
"Denmark",969,3,6,6,5,1,2
"Brazil",969,5,9,7,2,5,1
"Costa Rica",969,5,4,6,4,2,2
"Iran",970,2,6,6,3,3,1
"Spain",970,2,4,4,2,2,2
"Uruguay",971,1,4,1,2,-1,2
"Saudi Arabia",971,1,4,6,2,4,1
"France",971,3,6,7,1,6,1
"Peru",971,3,6,3,3,0,2
"Belgium",971,7,6,4,2,2,1
"England",971,7,6,4,3,1,2
"Poland",971,8,9,6,0,6,1
"Colombia",971,8,4,2,2,0,2
"Sweden",972,6,7,4,2,2,1
"Mexico",972,6,4,6,4,2,2
"Egypt",973,1,6,2,1,1,1
"Russia",973,1,4,5,4,1,2
"Spain",973,2,6,5,4,1,2
"Iran",973,2,6,7,4,3,1
"France",973,3,6,3,1,2,1
"Peru",973,3,6,3,2,1,2
"Egypt",974,1,5,5,4,1,1
"Saudi Arabia",974,1,4,5,4,1,2
"Iran",974,2,5,3,1,2,1
"Portugal",974,2,4,3,1,2,2
"Belgium",974,7,9,5,2,3,1
"Panama",974,7,4,2,1,1,2
"Spain",976,2,9,6,2,4,1
"Iran",976,2,3,4,4,0,2
"Mexico",976,6,6,3,2,1,2
"Germany",976,6,6,7,1,6,1
"France",977,3,9,9,1,8,1
"Peru",977,3,4,4,4,0,2
"Brazil",977,5,6,9,4,5,1
"Serbia",977,5,6,3,2,1,2
"Sweden",978,6,5,3,2,1,1
"Germany",978,6,4,5,2,3,2
"Switzerland",979,5,5,5,3,2,1
"Brazil",979,5,4,3,2,1,2
"Mexico",979,6,6,5,3,2,1
"South Korea",979,6,6,4,4,0,2
"Portugal",980,2,6,2,1,1,1
"Iran",980,2,4,3,2,1,2
"Spain",981,2,9,5,0,5,1
"Portugal",981,2,4,4,3,1,2
"Switzerland",981,5,5,2,1,1,1
"Costa Rica",981,5,4,4,2,2,2
"Uruguay",982,1,6,10,2,8,1
"Russia",982,1,6,4,4,0,2
"Spain",982,2,6,4,1,3,1
"Iran",982,2,6,4,2,2,2
"South Korea",982,6,5,3,1,2,2
"Germany",982,6,5,5,2,3,1
"Belgium",982,7,7,4,1,3,1
"England",982,7,7,4,2,2,2
"Croatia",983,4,6,9,4,5,1
"Argentina",983,4,6,7,5,2,2
"Mexico",983,6,6,6,3,3,1
"Germany",983,6,6,5,3,2,2
"Uruguay",984,1,4,4,3,1,1
"Egypt",984,1,4,2,2,0,2
"Costa Rica",984,5,5,5,4,1,1
"Switzerland",984,5,4,4,4,0,2
"Colombia",984,8,5,3,1,2,1
"Poland",984,8,5,2,1,1,2
"France",986,3,6,6,1,5,1
"Peru",986,3,4,3,3,0,2
"Croatia",986,4,5,7,1,6,1
"Iceland",986,4,4,3,4,-1,2
"Germany",986,6,7,6,2,4,1
"Mexico",986,6,4,5,3,2,2
"France",987,3,6,10,4,6,1
"Australia",987,3,4,5,4,1,2
"Serbia",987,5,6,3,2,1,2
"Costa Rica",987,5,6,5,2,3,1
"Russia",988,1,7,3,1,2,1
"Saudi Arabia",988,1,4,6,3,3,2
"South Korea",988,6,6,7,5,2,1
"Germany",988,6,6,3,3,0,2
"England",988,7,6,7,2,5,1
"Panama",988,7,4,2,2,0,2
"Colombia",988,8,7,6,1,5,1
"Japan",988,8,7,2,0,2,2
"Russia",989,1,5,4,2,2,1
"Uruguay",989,1,4,4,3,1,2
"Brazil",989,5,5,4,1,3,1
"Switzerland",989,5,5,3,2,1,2
"Germany",989,6,7,4,1,3,1
"Sweden",989,6,4,4,4,0,2
"England",989,7,6,7,3,4,1
"Belgium",989,7,4,5,5,0,2
"Saudi Arabia",990,1,6,5,3,2,1
"Russia",990,1,4,2,1,1,2
"Croatia",991,4,6,5,4,1,1
"Argentina",991,4,4,4,4,0,2
"Uruguay",992,1,7,6,0,6,1
"Egypt",992,1,4,2,2,0,2
"Brazil",992,5,6,6,4,2,1
"Switzerland",992,5,4,5,4,1,2
"Mexico",993,6,6,4,2,2,1
"Germany",993,6,4,3,2,1,2
"South Korea",994,6,6,5,2,3,1
"Germany",994,6,6,6,6,0,2
"Japan",994,8,5,5,3,2,1
"Senegal",994,8,5,2,1,1,2
"Colombia",995,8,9,5,1,4,1
"Japan",995,8,4,3,2,1,2
"France",996,3,7,6,1,5,1
"Peru",996,3,4,3,4,-1,2
"Brazil",996,5,7,8,2,6,1
"Serbia",996,5,4,4,4,0,2
"Russia",997,1,6,8,5,3,1
"Saudi Arabia",997,1,6,5,4,1,2
"Australia",997,3,6,7,4,3,1
"France",997,3,4,5,4,1,2
"Colombia",997,8,5,3,1,2,1
"Japan",997,8,5,4,3,1,2
"Egypt",998,1,5,1,0,1,1
"Uruguay",998,1,4,2,1,1,2
"Colombia",999,8,7,4,2,2,2
"Japan",999,8,7,4,1,3,1
"Iran",1000,2,9,6,1,5,1
"Spain",1000,2,4,3,3,0,2
"Denmark",1000,3,6,5,3,2,1
"Australia",1000,3,6,3,6,-3,2
"Mexico",1000,6,6,3,5,-2,1
"South Korea",1000,6,4,2,2,0,2
"South Korea",6,6,5,2,0,2,2
"Germany",6,6,5,3,1,2,1
"Spain",7,2,5,4,3,1,1
"Iran",7,2,5,3,2,1,2
"Spain",8,2,7,5,2,3,1
"Iran",8,2,7,4,1,3,2
"Croatia",8,4,7,4,1,3,2
"Argentina",8,4,7,5,2,3,1
"Brazil",9,5,7,5,1,4,1
"Switzerland",9,5,4,4,3,1,2
"Iran",11,2,4,6,5,1,1
"Morocco",11,2,4,4,4,0,2
"England",11,7,6,7,5,2,1
"Tunisia",11,7,4,4,4,0,2
"Spain",13,2,5,5,4,1,1
"Portugal",13,2,5,4,3,1,2
"Mexico",13,6,7,5,3,2,1
"Germany",13,6,4,5,5,0,2
"Colombia",13,8,6,2,1,1,1
"Poland",13,8,4,3,3,0,2
"Croatia",14,4,6,5,3,2,2
"Argentina",14,4,6,7,5,2,1
"Mexico",16,6,6,3,2,1,1
"South Korea",16,6,4,4,4,0,2
"Sweden",17,6,5,3,2,1,1
"Mexico",17,6,4,4,4,0,2
"Mexico",20,6,6,5,3,2,1
"South Korea",20,6,4,4,4,0,2
"Croatia",22,4,7,5,2,3,1
"Argentina",22,4,7,4,1,3,2
"Mexico",23,6,5,4,3,1,2
"South Korea",23,6,5,5,4,1,1
"England",24,7,7,2,0,2,2
"Panama",24,7,7,4,2,2,1
"Mexico",25,6,5,3,1,2,1
"Sweden",25,6,4,4,4,0,2
"France",26,3,7,4,1,3,2
"Peru",26,3,7,5,2,3,1
"France",27,3,6,3,1,2,2
"Peru",27,3,6,5,3,2,1
"Russia",28,1,6,5,4,1,2
"Egypt",28,1,6,6,5,1,1
"Switzerland",34,5,5,5,4,1,1
"Serbia",34,5,5,4,3,1,2
"Croatia",37,4,5,5,4,1,1
"Argentina",37,4,5,3,2,1,2
"Russia",38,1,5,3,2,1,1
"Egypt",38,1,5,2,1,1,2
"France",40,3,6,4,2,2,2
"Denmark",40,3,6,6,4,2,1
"Colombia",40,8,6,3,1,2,1
"Japan",40,8,6,3,2,1,2
"Brazil",43,5,7,7,4,3,1
"Costa Rica",43,5,4,3,3,0,2
"Saudi Arabia",46,1,6,3,2,1,1
"Russia",46,1,4,5,5,0,2
"France",48,3,9,7,2,5,1
"Peru",48,3,4,6,6,0,2
"Brazil",49,5,5,4,3,1,1
"Switzerland",49,5,5,3,2,1,2
"Mexico",54,6,5,4,3,1,1
"Germany",54,6,5,3,2,1,2
"Uruguay",55,1,5,4,3,1,2
"Russia",55,1,5,5,2,3,1
"France",60,3,4,3,3,0,2
"Australia",60,3,4,4,3,1,1
"Sweden",60,6,6,5,2,3,1
"Mexico",60,6,6,6,5,1,2
"Germany",62,6,9,9,0,9,1
"Sweden",62,6,4,3,3,0,2
"Spain",64,2,6,5,3,2,1
"Iran",64,2,4,5,5,0,2
"Poland",65,8,7,6,3,3,1
"Colombia",65,8,4,3,3,0,2
"Belgium",66,7,6,5,2,3,1
"England",66,7,6,4,1,3,2
"Saudi Arabia",67,1,6,3,2,1,1
"Uruguay",67,1,4,3,3,0,2
"Australia",70,3,5,3,2,1,1
"Peru",70,3,4,2,2,0,2
"Brazil",70,5,6,8,3,5,2
"Costa Rica",70,5,6,10,5,5,1
"Sweden",70,6,6,6,2,4,1
"Germany",70,6,6,4,3,1,2
"Japan",70,8,7,5,3,2,1
"Poland",70,8,4,3,3,0,2
"Croatia",72,4,9,9,2,7,1
"Nigeria",72,4,3,3,5,-2,2
"Brazil",75,5,5,2,1,1,2
"Serbia",75,5,5,5,4,1,1
"Mexico",76,6,6,5,3,2,2
"Germany",76,6,6,6,1,5,1
"Russia",79,1,9,5,2,3,1
"Saudi Arabia",79,1,4,3,3,0,2
"Croatia",79,4,9,7,2,5,1
"Argentina",79,4,4,5,4,1,2
"Belgium",79,7,7,4,1,3,1
"England",79,7,7,3,0,3,2
"Spain",81,2,5,5,4,1,2
"Iran",81,2,5,6,5,1,1
"Uruguay",86,1,5,3,2,1,1
"Russia",86,1,5,2,1,1,2
"Portugal",86,2,5,8,3,5,1
"Iran",86,2,3,2,2,0,2
"England",88,7,9,6,2,4,1
"Tunisia",88,7,4,2,2,0,2
"Saudi Arabia",90,1,5,3,2,1,1
"Russia",90,1,3,4,4,0,2
"France",91,3,7,7,3,4,1
"Denmark",91,3,7,6,2,4,2
"Argentina",91,4,9,9,2,7,1
"Croatia",91,4,3,4,6,-2,2
"Brazil",92,5,7,7,1,6,2
"Costa Rica",92,5,7,8,2,6,1
"Brazil",93,5,6,5,4,1,2
"Switzerland",93,5,6,5,3,2,1
"France",95,3,5,3,2,1,2
"Denmark",95,3,5,2,0,2,1
"Tunisia",97,7,7,5,3,2,1
"England",97,7,4,5,5,0,2
"Spain",99,2,7,5,1,4,2
"Iran",99,2,7,6,2,4,1
"Brazil",101,5,7,5,2,3,1
"Serbia",101,5,4,3,3,0,2
"Germany",101,6,6,5,3,2,1
"South Korea",101,6,4,4,4,0,2
"Spain",102,2,4,5,4,1,1
"Portugal",102,2,4,5,5,0,2
"Sweden",102,6,7,3,1,2,2
"Germany",102,6,7,5,3,2,1
"Sweden",105,6,6,4,3,1,2
"Mexico",105,6,6,5,4,1,1
"Senegal",106,8,9,4,1,3,1
"Colombia",106,8,4,2,2,0,2
"France",107,3,9,7,1,6,1
"Peru",107,3,2,3,5,-2,2
"Mexico",107,6,7,5,3,2,1
"Germany",107,6,7,4,2,2,2
"Portugal",112,2,9,7,3,4,1
"Iran",112,2,4,6,6,0,2
"Uruguay",113,1,6,3,1,2,2
"Egypt",113,1,6,4,2,2,1
"Belgium",114,7,4,2,1,1,1
"England",114,7,4,2,2,0,2
"England",115,7,7,3,1,2,1
"Panama",115,7,4,5,4,1,2
"Croatia",120,4,7,2,0,2,2
"Argentina",120,4,7,4,2,2,1
"Argentina",123,4,5,2,1,1,2
"Nigeria",123,4,5,4,3,1,1
"Spain",127,2,9,6,1,5,1
"Portugal",127,2,4,4,3,1,2
"Denmark",128,3,7,5,3,2,1
"France",128,3,4,4,4,0,2
"Colombia",129,8,7,5,2,3,2
"Poland",129,8,7,7,4,3,1
"Colombia",130,8,6,6,3,3,1
"Poland",130,8,4,3,2,1,2
"Uruguay",131,1,6,3,2,1,2
"Egypt",131,1,6,4,3,1,1
"France",131,3,7,7,5,2,1
"Australia",131,3,7,6,4,2,2
"Argentina",131,4,7,5,2,3,1
"Croatia",131,4,4,5,5,0,2
"Denmark",135,3,6,5,3,2,1
"Peru",135,3,6,3,1,2,2
"Uruguay",136,1,6,6,6,0,1
"Russia",136,1,6,4,4,0,2
"Sweden",137,6,6,5,2,3,1
"Germany",137,6,6,5,4,1,2
"Portugal",139,2,5,5,2,3,1
"Iran",139,2,3,3,3,0,2
"Denmark",140,3,6,5,4,1,1
"Peru",140,3,4,4,3,1,2
"France",141,3,9,8,3,5,1
"Australia",141,3,4,5,5,0,2
"Portugal",142,2,5,3,2,1,2
"Morocco",142,2,5,4,3,1,1
"Russia",144,1,6,3,2,1,1
"Uruguay",144,1,4,2,2,0,2
"France",145,3,5,5,4,1,1
"Peru",145,3,5,3,2,1,2
"Uruguay",147,1,5,4,2,2,2
"Russia",147,1,5,5,3,2,1
"Brazil",150,5,9,8,2,6,1
"Switzerland",150,5,2,2,3,-1,2
"Sweden",151,6,5,2,1,1,1
"South Korea",151,6,5,1,0,1,2
"Spain",155,2,7,4,2,2,1
"Iran",155,2,4,5,5,0,2
"Senegal",155,8,6,5,4,1,1
"Japan",155,8,4,4,4,0,2
"France",158,3,6,5,2,3,1
"Australia",158,3,4,4,4,0,2
"Germany",160,6,5,4,3,1,1
"Sweden",160,6,4,4,4,0,2
"Croatia",163,4,5,3,2,1,1
"Argentina",163,4,5,2,1,1,2
"Croatia",164,4,6,4,1,3,2
"Argentina",164,4,6,6,3,3,1
"Germany",164,6,9,7,0,7,1
"South Korea",164,6,3,2,3,-1,2
"Portugal",165,2,4,4,3,1,2
"Morocco",165,2,4,5,4,1,1
"Croatia",167,4,5,3,2,1,1
"Iceland",167,4,4,4,4,0,2
"Mexico",171,6,6,5,3,2,1
"Sweden",171,6,4,6,7,-1,2
"Belgium",172,7,5,3,2,1,2
"Tunisia",172,7,5,5,4,1,1
"Peru",173,3,5,4,3,1,1
"Australia",173,3,5,3,2,1,2
"Germany",174,6,6,6,5,1,1
"Mexico",174,6,4,4,4,0,2
"Poland",175,8,9,7,2,5,1
"Colombia",175,8,2,3,4,-1,2
"Colombia",177,8,5,4,3,1,1
"Poland",177,8,5,3,2,1,2
"Japan",178,8,9,3,0,3,1
"Colombia",178,8,4,2,2,0,2
"Russia",179,1,6,3,2,1,2
"Egypt",179,1,6,4,3,1,1
"Morocco",179,2,5,3,2,1,1
"Spain",179,2,4,4,4,0,2
"Panama",180,7,9,6,2,4,1
"Belgium",180,7,4,8,6,2,2
"Russia",181,1,5,2,0,2,2
"Egypt",181,1,5,3,1,2,1
"Brazil",181,5,5,5,4,1,1
"Serbia",181,5,4,4,4,0,2
"Spain",182,2,6,6,3,3,1
"Portugal",182,2,6,4,3,1,2
"France",183,3,6,5,2,3,1
"Denmark",183,3,4,4,4,0,2
"Uruguay",187,1,9,4,0,4,1
"Egypt",187,1,3,4,4,0,2
"Sweden",188,6,7,7,3,4,1
"Germany",188,6,7,6,2,4,2
"Saudi Arabia",189,1,9,5,1,4,1
"Uruguay",189,1,2,3,4,-1,2
"France",189,3,7,4,0,4,2
"Peru",189,3,7,5,1,4,1
"Argentina",189,4,5,5,4,1,1
"Iceland",189,4,4,3,3,0,2
"Brazil",189,5,6,3,1,2,2
"Switzerland",189,5,6,4,2,2,1
"South Korea",189,6,6,2,1,1,2
"Germany",189,6,6,4,3,1,1
"Saudi Arabia",190,1,6,3,3,0,1
"Egypt",190,1,6,2,2,0,2
"Belgium",191,7,7,5,2,3,2
"England",191,7,7,7,4,3,1
"Sweden",192,6,6,5,4,1,2
"South Korea",192,6,6,4,2,2,1
"Uruguay",195,1,5,4,3,1,1
"Russia",195,1,5,3,2,1,2
"Uruguay",196,1,6,2,2,0,1
"Egypt",196,1,4,3,3,0,2
"Belgium",196,7,5,2,1,1,2
"Tunisia",196,7,5,3,2,1,1
"Egypt",197,1,6,5,2,3,1
"Russia",197,1,4,4,4,0,2
"Mexico",201,6,9,7,4,3,1
"South Korea",201,6,3,4,5,-1,2
"Brazil",202,5,4,5,4,1,1
"Serbia",202,5,4,2,1,1,2
"Brazil",205,5,6,4,3,1,1
"Switzerland",205,5,6,3,2,1,2
"England",205,7,5,4,3,1,1
"Tunisia",205,7,5,2,1,1,2
"Mexico",207,6,9,5,0,5,1
"Sweden",207,6,4,3,3,0,2
"Japan",208,8,6,6,3,3,2
"Poland",208,8,6,7,4,3,1
"Russia",210,1,5,2,1,1,2
"Egypt",210,1,5,3,2,1,1
"Senegal",212,8,6,7,4,3,1
"Poland",212,8,6,4,1,3,2
"South Korea",214,6,6,5,1,4,1
"Germany",214,6,6,4,3,1,2
"Sweden",215,6,6,6,5,1,2
"Germany",215,6,6,5,2,3,1
"Sweden",221,6,6,3,2,1,2
"Mexico",221,6,6,5,4,1,1
"Russia",222,1,7,6,3,3,1
"Egypt",222,1,7,5,2,3,2
"Colombia",223,8,5,3,2,1,1
"Japan",223,8,3,3,3,0,2
"Croatia",224,4,5,1,0,1,2
"Iceland",224,4,5,2,1,1,1
"Brazil",228,5,9,9,0,9,1
"Serbia",228,5,4,3,5,-2,2
"Russia",229,1,5,2,1,1,1
"Saudi Arabia",229,1,4,5,5,0,2
"Spain",230,2,9,4,0,4,1
"Portugal",230,2,3,4,5,-1,2
"Colombia",230,8,5,6,5,1,1
"Japan",230,8,5,4,3,1,2
"Denmark",231,3,5,2,0,2,2
"Peru",231,3,5,3,1,2,1
"Brazil",231,5,5,5,3,2,1
"Switzerland",231,5,5,3,1,2,2
"Uruguay",232,1,5,7,6,1,1
"Saudi Arabia",232,1,5,5,4,1,2
"Colombia",233,8,6,2,1,1,2
"Poland",233,8,6,4,3,1,1
"Germany",237,6,9,12,1,11,1
"Mexico",237,6,4,3,5,-2,2
"Argentina",240,4,7,5,3,2,1
"Iceland",240,4,4,5,5,0,2
"Sweden",241,6,4,4,4,0,2
"Germany",241,6,4,5,3,2,1
"England",241,7,5,2,1,1,2
"Tunisia",241,7,5,3,2,1,1
"Belgium",243,7,9,5,2,3,1
"Panama",243,7,4,4,4,0,2
"Poland",244,8,5,3,2,1,1
"Japan",244,8,4,2,2,0,2
"England",247,7,9,6,1,5,1
"Belgium",247,7,3,3,4,-1,2
"Japan",247,8,6,2,1,1,1
"Poland",247,8,4,3,3,0,2
"Belgium",251,7,5,3,2,1,2
"England",251,7,5,6,5,1,1
"Colombia",252,8,6,4,2,2,2
"Poland",252,8,6,5,3,2,1
"Argentina",253,4,9,8,2,6,1
"Iceland",253,4,4,4,5,-1,2
"England",257,7,6,3,1,2,2
"Panama",257,7,6,4,2,2,1
"Brazil",258,5,9,5,1,4,1
"Serbia",258,5,2,3,4,-1,2
"England",260,7,9,7,1,6,1
"Belgium",260,7,3,4,5,-1,2
"Argentina",261,4,6,4,2,2,1
"Nigeria",261,4,4,3,3,0,2
"Mexico",263,6,5,5,4,1,1
"Germany",263,6,5,2,1,1,2
"Uruguay",265,1,5,4,3,1,1
"Russia",265,1,5,2,1,1,2
"South Korea",265,6,4,3,2,1,1
"Germany",265,6,4,4,4,0,2
"Portugal",266,2,7,4,1,3,2
"Iran",266,2,7,5,2,3,1
"Iran",267,2,5,4,3,1,2
"Morocco",267,2,5,6,5,1,1
"France",271,3,7,4,2,2,2
"Denmark",271,3,7,5,3,2,1
"Brazil",271,5,9,5,2,3,1
"Switzerland",271,5,3,4,4,0,2
"Egypt",272,1,9,5,2,3,1
"Saudi Arabia",272,1,3,5,6,-1,2
"Belgium",272,7,7,6,4,2,1
"England",272,7,7,5,3,2,2
"Saudi Arabia",273,1,5,3,2,1,1
"Egypt",273,1,4,4,4,0,2
"Uruguay",274,1,5,4,3,1,1
"Egypt",274,1,4,4,4,0,2
"France",274,3,7,4,2,2,1
"Peru",274,3,4,6,6,0,2
"Croatia",274,4,7,4,1,3,2
"Argentina",274,4,7,5,2,3,1
"Spain",275,2,5,5,2,3,1
"Portugal",275,2,4,4,3,1,2
"Australia",275,3,6,2,2,0,1
"France",275,3,4,5,4,1,2
"Belgium",277,7,5,4,1,3,2
"England",277,7,5,5,2,3,1
"Japan",277,8,6,3,2,1,1
"Colombia",277,8,4,4,4,0,2
"Russia",278,1,5,3,2,1,1
"Saudi Arabia",278,1,5,1,0,1,2
"Croatia",278,4,7,4,1,3,1
"Argentina",278,4,7,3,0,3,2
"Colombia",278,8,6,5,2,3,1
"Poland",278,8,4,6,5,1,2
"Portugal",279,2,6,5,2,3,2
"Iran",279,2,6,6,3,3,1
"Colombia",281,8,5,4,3,1,1
"Poland",281,8,5,2,1,1,2
"Portugal",283,2,6,5,4,1,1
"Iran",283,2,4,3,4,-1,2
"France",284,3,7,3,1,2,2
"Peru",284,3,7,4,2,2,1
"England",284,7,6,8,4,4,1
"Panama",284,7,4,4,5,-1,2
"Australia",287,3,5,4,3,1,1
"France",287,3,3,4,4,0,2
"Portugal",292,2,6,5,1,4,1
"Iran",292,2,6,4,3,1,2
"Brazil",292,5,5,5,3,2,1
"Costa Rica",292,5,5,4,2,2,2
"Belgium",292,7,6,5,3,2,1
"England",292,7,6,3,1,2,2
"Mexico",293,6,6,4,2,2,2
"Germany",293,6,6,5,3,2,1
"Colombia",295,8,5,5,1,4,1
"Poland",295,8,5,3,2,1,2
"Croatia",296,4,7,5,3,2,1
"Argentina",296,4,7,2,0,2,2
"Belgium",296,7,5,1,0,1,2
"England",296,7,5,3,2,1,1
"Mexico",301,6,5,6,4,2,1
"Germany",301,6,3,2,2,0,2
"South Korea",304,6,6,2,3,-1,1
"Germany",304,6,4,4,3,1,2
"Peru",306,3,7,7,2,5,1
"Australia",306,3,4,4,5,-1,2
"Poland",307,8,7,4,1,3,1
"Japan",307,8,4,2,2,0,2
"Costa Rica",309,5,5,6,4,2,1
"Serbia",309,5,3,3,3,0,2
"Denmark",310,3,7,6,3,3,1
"Peru",310,3,4,2,2,0,2
"Belgium",310,7,6,3,2,1,1
"England",310,7,4,3,3,0,2
"Colombia",310,8,6,5,3,2,1
"Japan",310,8,6,4,2,2,2
"Peru",313,3,5,4,1,3,1
"France",313,3,4,3,4,-1,2
"Croatia",316,4,5,6,5,1,2
"Argentina",316,4,5,7,6,1,1
"Costa Rica",316,5,5,4,3,1,1
"Switzerland",316,5,4,3,3,0,2
"Colombia",319,8,6,3,2,1,2
"Japan",319,8,6,4,3,1,1
"Spain",322,2,5,3,2,1,2
"Portugal",322,2,5,6,3,3,1
"Brazil",322,5,7,4,1,3,2
"Costa Rica",322,5,7,6,3,3,1
"Japan",322,8,5,2,1,1,2
"Senegal",322,8,5,4,3,1,1
"Colombia",323,8,6,3,2,1,2
"Poland",323,8,6,5,4,1,1
"Spain",324,2,6,4,2,2,1
"Iran",324,2,6,3,1,2,2
"Croatia",324,4,7,6,1,5,1
"Argentina",324,4,4,3,4,-1,2
"Colombia",324,8,9,6,3,3,1
"Poland",324,8,4,4,4,0,2
"Nigeria",325,4,5,2,0,2,2
"Iceland",325,4,5,3,1,2,1
"Belgium",326,7,5,5,3,2,1
"England",326,7,5,4,2,2,2
"Denmark",333,3,5,4,3,1,1
"Peru",333,3,5,3,2,1,2
"Brazil",333,5,6,2,1,1,2
"Serbia",333,5,6,4,3,1,1
"France",334,3,9,5,0,5,1
"Denmark",334,3,4,4,4,0,2
"Uruguay",335,1,7,4,2,2,1
"Russia",335,1,4,5,5,0,2
"Uruguay",336,1,5,1,0,1,2
"Russia",336,1,5,2,1,1,1
"Mexico",338,6,6,5,2,3,1
"South Korea",338,6,4,4,5,-1,2
"Croatia",342,4,6,5,4,1,1
"Nigeria",342,4,6,3,2,1,2
"Spain",344,2,5,6,2,4,1
"Iran",344,2,5,4,2,2,2
"Belgium",345,7,5,2,1,1,2
"Tunisia",345,7,5,3,2,1,1
"France",346,3,5,5,4,1,2
"Denmark",346,3,5,7,6,1,1
"Argentina",348,4,7,4,0,4,1
"Croatia",348,4,4,2,2,0,2
"Argentina",352,4,7,6,4,2,1
"Nigeria",352,4,4,3,3,0,2
"Croatia",354,4,5,3,2,1,1
"Nigeria",354,4,5,2,1,1,2
"France",358,3,6,4,1,3,2
"Peru",358,3,6,5,2,3,1
"Portugal",359,2,6,3,1,2,2
"Iran",359,2,6,4,2,2,1
"Costa Rica",362,5,6,6,5,1,1
"Switzerland",362,5,4,6,6,0,2
"England",362,7,7,2,0,2,1
"Tunisia",362,7,4,4,4,0,2
"Japan",363,8,4,2,1,1,2
"Senegal",363,8,4,3,2,1,1
"Peru",364,3,9,7,2,5,1
"Australia",364,3,3,6,7,-1,2
"Colombia",365,8,5,6,4,2,1
"Japan",365,8,4,5,5,0,2
"Spain",366,2,9,5,1,4,1
"Portugal",366,2,3,4,5,-1,2
"France",368,3,5,3,2,1,2
"Peru",368,3,5,4,3,1,1
"Croatia",368,4,5,4,3,1,1
"Iceland",368,4,5,3,2,1,2
"Uruguay",372,1,6,4,2,2,1
"Russia",372,1,6,3,1,2,2
"Portugal",372,2,5,2,1,1,1
"Spain",372,2,4,2,2,0,2
"Brazil",373,5,6,7,5,2,1
"Serbia",373,5,6,5,3,2,2
"Denmark",375,3,5,3,2,1,2
"Australia",375,3,5,4,3,1,1
"Switzerland",375,5,5,1,0,1,2
"Costa Rica",375,5,5,3,2,1,1
"Colombia",375,8,6,4,2,2,2
"Japan",375,8,6,5,3,2,1
"Australia",376,3,6,3,1,2,1
"France",376,3,4,5,5,0,2
"Germany",376,6,6,5,2,3,1
"Mexico",376,6,4,5,5,0,2
"Spain",380,2,6,5,3,2,1
"Portugal",380,2,6,4,2,2,2
"Serbia",380,5,5,3,2,1,1
"Brazil",380,5,4,3,3,0,2
"South Korea",383,6,5,3,2,1,1
"Germany",383,6,4,3,3,0,2
"Portugal",384,2,6,4,3,1,2
"Iran",384,2,6,5,2,3,1
"Germany",385,6,9,5,1,4,1
"Sweden",385,6,3,3,4,-1,2
"Mexico",386,6,6,3,2,1,1
"Germany",386,6,4,7,7,0,2
"Argentina",387,4,9,4,1,3,1
"Iceland",387,4,2,3,4,-1,2
"France",390,3,7,6,1,5,2
"Peru",390,3,7,8,3,5,1
"Sweden",390,6,6,5,1,4,2
"Germany",390,6,6,7,3,4,1
"Brazil",393,5,7,6,4,2,1
"Switzerland",393,5,4,6,6,0,2
"Brazil",395,5,9,9,2,7,1
"Switzerland",395,5,2,4,5,-1,2
"South Korea",395,6,5,4,3,1,1
"Germany",395,6,5,3,2,1,2
"Poland",395,8,7,3,0,3,1
"Colombia",395,8,4,3,3,0,2
"Germany",396,6,5,2,1,1,1
"Sweden",396,6,4,5,5,0,2
"England",396,7,7,4,2,2,1
"Tunisia",396,7,4,3,3,0,2
"Spain",398,2,5,4,3,1,1
"Portugal",398,2,3,3,3,0,2
"Portugal",401,2,5,3,2,1,2
"Iran",401,2,5,4,3,1,1
"Germany",402,6,6,5,2,3,1
"South Korea",402,6,4,3,3,0,2
"Poland",404,8,9,7,3,4,1
"Colombia",404,8,4,3,3,0,2
"France",406,3,4,3,3,0,2
"Peru",406,3,4,3,2,1,1
"Portugal",408,2,6,2,1,1,2
"Iran",408,2,6,3,2,1,1
"France",408,3,6,3,2,1,2
"Peru",408,3,6,4,3,1,1
"Saudi Arabia",410,1,5,3,1,2,1
"Uruguay",410,1,4,6,6,0,2
"Belgium",410,7,5,2,1,1,2
"Panama",410,7,5,4,3,1,1
"Brazil",411,5,6,4,2,2,2
"Switzerland",411,5,6,6,4,2,1
"Colombia",411,8,5,2,1,1,1
"Japan",411,8,3,3,3,0,2
"South Korea",412,6,6,4,2,2,2
"Germany",412,6,6,5,3,2,1
"Belgium",415,7,6,4,3,1,2
"Panama",415,7,6,5,2,3,1
"Mexico",418,6,5,4,2,2,1
"South Korea",418,6,4,6,7,-1,2
"Portugal",421,2,6,4,1,3,1
"Iran",421,2,4,3,3,0,2
"France",421,3,6,3,2,1,2
"Australia",421,3,6,5,4,1,1
"Mexico",423,6,4,5,5,0,2
"Germany",423,6,4,7,5,2,1
"Mexico",424,6,6,5,4,1,1
"Germany",424,6,6,4,3,1,2
"Mexico",427,6,5,3,1,2,2
"South Korea",427,6,5,5,3,2,1
"England",427,7,7,5,1,4,1
"Belgium",427,7,4,5,5,0,2
"Poland",428,8,5,3,2,1,1
"Japan",428,8,4,6,5,1,2
"France",429,3,6,8,3,5,1
"Australia",429,3,4,3,4,-1,2
"Uruguay",436,1,6,5,4,1,1
"Egypt",436,1,4,5,5,0,2
"France",439,3,6,4,1,3,1
"Australia",439,3,4,2,2,0,2
"Sweden",440,6,6,6,3,3,1
"Germany",440,6,6,6,4,2,2
"Mexico",441,6,7,6,2,4,1
"Germany",441,6,7,5,1,4,2
"Argentina",444,4,6,4,1,3,1
"Croatia",444,4,4,4,4,0,2
"England",444,7,7,3,1,2,1
"Panama",444,7,4,3,3,0,2
"Russia",446,1,5,2,1,1,2
"Saudi Arabia",446,1,5,3,2,1,1
"France",446,3,6,4,2,2,1
"Denmark",446,3,4,5,6,-1,2
"Brazil",447,5,9,5,1,4,1
"Serbia",447,5,2,3,4,-1,2
"Mexico",448,6,5,5,3,2,2
"Germany",448,6,5,7,5,2,1
"Switzerland",450,5,7,4,2,2,1
"Serbia",450,5,7,3,1,2,2
"Germany",461,6,6,5,1,4,1
"Sweden",461,6,4,3,4,-1,2
"Peru",462,3,5,2,1,1,1
"Australia",462,3,4,2,2,0,2
"France",463,3,5,5,2,3,1
"Denmark",463,3,3,5,5,0,2
"France",466,3,9,6,1,5,1
"Peru",466,3,3,3,4,-1,2
"Argentina",468,4,9,4,0,4,1
"Croatia",468,4,3,3,4,-1,2
"Belgium",469,7,5,5,2,3,2
"England",469,7,5,6,3,3,1
"Uruguay",472,1,5,6,4,2,1
"Russia",472,1,5,5,3,2,2
"Brazil",472,5,7,2,0,2,2
"Switzerland",472,5,7,4,2,2,1
"Colombia",472,8,7,7,2,5,1
"Poland",472,8,4,3,3,0,2
"Senegal",475,8,5,4,3,1,2
"Poland",475,8,5,6,4,2,1
"Spain",478,2,6,6,5,1,2
"Portugal",478,2,6,6,4,2,1
"Spain",482,2,7,6,4,2,1
"Portugal",482,2,7,5,3,2,2
"Colombia",484,8,9,9,3,6,1
"Senegal",484,8,2,4,6,-2,2
"Egypt",490,1,6,4,3,1,1
"Russia",490,1,4,3,3,0,2
"Iran",492,2,7,7,5,2,1
"Spain",492,2,4,6,5,1,2
"France",492,3,6,6,5,1,1
"Australia",492,3,6,4,3,1,2
"England",494,7,7,4,1,3,1
"Belgium",494,7,4,4,4,0,2
"South Korea",496,6,5,4,3,1,1
"Germany",496,6,5,3,2,1,2
"Sweden",500,6,5,3,1,2,2
"Germany",500,6,5,4,2,2,1
"England",502,7,9,8,2,6,1
"Panama",502,7,4,5,5,0,2
"South Korea",503,6,5,4,3,1,2
"Germany",503,6,5,5,4,1,1
"Uruguay",506,1,9,6,1,5,1
"Egypt",506,1,4,5,5,0,2
"Costa Rica",507,5,5,3,2,1,1
"Brazil",507,5,4,2,2,0,2
"Colombia",507,8,6,5,2,3,1
"Poland",507,8,4,5,5,0,2
"Croatia",508,4,5,3,2,1,2
"Argentina",508,4,5,4,2,2,1
"Argentina",509,4,6,3,2,1,2
"Nigeria",509,4,6,4,3,1,1
"Sweden",511,6,5,1,0,1,1
"Germany",511,6,4,2,2,0,2
"France",513,3,7,3,1,2,2
"Australia",513,3,7,6,4,2,1
"Colombia",514,8,5,3,2,1,2
"Poland",514,8,5,4,3,1,1
"England",515,7,9,5,1,4,1
"Tunisia",515,7,2,2,3,-1,2
"Uruguay",516,1,5,4,2,2,1
"Egypt",516,1,5,3,1,2,2
"Belgium",517,7,6,7,4,3,1
"England",517,7,6,6,3,3,2
"Saudi Arabia",519,1,5,5,4,1,2
"Egypt",519,1,5,7,6,1,1
"England",520,7,9,7,0,7,1
"Belgium",520,7,4,4,5,-1,2
"Peru",522,3,5,3,1,2,1
"Australia",522,3,5,3,2,1,2
"Uruguay",523,1,5,2,0,2,2
"Russia",523,1,5,3,1,2,1
"Belgium",523,7,5,3,2,1,1
"England",523,7,5,2,1,1,2
"Brazil",525,5,6,5,4,1,1
"Switzerland",525,5,6,3,2,1,2
"Mexico",527,6,7,6,2,4,1
"South Korea",527,6,4,5,5,0,2
"Mexico",529,6,6,3,1,2,1
"Germany",529,6,6,4,3,1,2
"Poland",529,8,9,5,1,4,1
"Japan",529,8,3,3,4,-1,2
"Sweden",530,6,4,5,5,0,2
"South Korea",530,6,4,3,2,1,1
"Germany",531,6,6,6,4,2,1
"Mexico",531,6,4,4,4,0,2
"Uruguay",532,1,6,5,3,2,2
"Russia",532,1,6,8,6,2,1
"Sweden",532,6,7,4,2,2,1
"Mexico",532,6,7,3,1,2,2
"England",532,7,9,8,2,6,1
"Belgium",532,7,3,4,5,-1,2
"Uruguay",533,1,4,5,5,0,1
"Egypt",533,1,4,4,4,0,2
"Portugal",535,2,9,5,1,4,1
"Spain",535,2,3,5,5,0,2
"Argentina",536,4,7,7,4,3,1
"Iceland",536,4,7,5,2,3,2
"Brazil",536,5,5,4,0,4,1
"Switzerland",536,5,3,4,4,0,2
"Portugal",537,2,5,3,1,2,2
"Iran",537,2,5,5,3,2,1
"Nigeria",537,4,5,3,2,1,2
"Iceland",537,4,5,4,3,1,1
"Uruguay",538,1,6,3,2,1,1
"Saudi Arabia",538,1,6,2,1,1,2
"Peru",540,3,5,5,4,1,1
"Australia",540,3,5,2,1,1,2
"Spain",542,2,6,4,2,2,1
"Iran",542,2,4,4,4,0,2
"Mexico",543,6,5,3,2,1,1
"Sweden",543,6,4,3,3,0,2
"Senegal",545,8,5,2,1,1,2
"Poland",545,8,5,4,3,1,1
"Spain",546,2,9,6,0,6,1
"Portugal",546,2,4,2,3,-1,2
"France",548,3,9,7,1,6,1
"Australia",548,3,3,5,6,-1,2
"Australia",553,3,6,3,2,1,1
"Peru",553,3,4,3,3,0,2
"Colombia",553,8,7,8,2,6,1
"Poland",553,8,7,6,0,6,2
"South Korea",555,6,5,4,2,2,2
"Germany",555,6,5,5,3,2,1
"France",556,3,7,5,2,3,1
"Denmark",556,3,4,6,5,1,2
"Argentina",556,4,5,2,1,1,1
"Nigeria",556,4,5,1,0,1,2
"Sweden",556,6,6,5,3,2,1
"Mexico",556,6,6,4,2,2,2
"Costa Rica",557,5,6,5,4,1,1
"Brazil",557,5,4,7,7,0,2
"Sweden",559,6,6,4,4,0,1
"Germany",559,6,4,4,4,0,2
"Uruguay",560,1,9,6,2,4,1
"Russia",560,1,2,3,4,-1,2
"Uruguay",564,1,6,6,5,1,1
"Russia",564,1,6,3,2,1,2
"Brazil",564,5,9,5,1,4,1
"Serbia",564,5,3,3,4,-1,2
"Colombia",564,8,6,4,2,2,1
"Japan",564,8,6,5,4,1,2
"Uruguay",566,1,9,4,1,3,1
"Saudi Arabia",566,1,4,2,2,0,2
"South Korea",567,6,7,6,3,3,1
"Germany",567,6,7,5,2,3,2
"Australia",576,3,6,4,5,-1,1
"Denmark",576,3,4,5,3,2,2
"Croatia",576,4,6,7,4,3,1
"Nigeria",576,4,6,4,1,3,2
"Spain",580,2,5,3,2,1,1
"Portugal",580,2,5,2,1,1,2
"Argentina",580,4,5,3,1,2,1
"Iceland",580,4,4,4,4,0,2
"Portugal",581,2,6,5,4,1,2
"Morocco",581,2,6,6,4,2,1
"France",581,3,6,3,2,1,2
"Peru",581,3,6,3,1,2,1
"France",585,3,5,1,0,1,2
"Australia",585,3,5,4,3,1,1
"Brazil",585,5,5,2,0,2,2
"Serbia",585,5,5,5,3,2,1
"England",587,7,9,7,1,6,1
"Panama",587,7,4,5,5,0,2
"South Korea",591,6,5,6,4,2,1
"Germany",591,6,5,3,1,2,2
"Argentina",592,4,6,6,3,3,2
"Iceland",592,4,6,7,4,3,1
"Senegal",598,8,5,4,3,1,1
"Poland",598,8,5,3,2,1,2
"France",599,3,5,2,1,1,2
"Peru",599,3,5,3,2,1,1
"Japan",599,8,7,4,2,2,1
"Colombia",599,8,4,4,4,0,2
"Peru",600,3,6,6,4,2,2
"Australia",600,3,6,7,5,2,1
"Japan",600,8,9,5,2,3,1
"Colombia",600,8,4,4,3,1,2
"Nigeria",606,4,6,4,3,1,1
"Iceland",606,4,4,4,4,0,2
"Brazil",607,5,9,5,1,4,1
"Serbia",607,5,4,5,4,1,2
"South Korea",608,6,6,5,5,0,2
"Germany",608,6,6,7,7,0,1
"Belgium",610,7,6,3,2,1,2
"England",610,7,6,4,3,1,1
"Colombia",613,8,6,7,4,3,1
"Japan",613,8,6,5,2,3,2
"Spain",615,2,6,5,3,2,2
"Portugal",615,2,6,6,4,2,1
"Brazil",615,5,6,5,4,1,2
"Costa Rica",615,5,6,4,2,2,1
"Uruguay",617,1,7,5,1,4,2
"Russia",617,1,7,6,2,4,1
"Iran",618,2,5,2,1,1,1
"Spain",618,2,4,4,4,0,2
"Japan",621,8,6,4,1,3,2
"Poland",621,8,6,6,3,3,1
"Colombia",623,8,6,4,2,2,2
"Poland",623,8,6,5,3,2,1
"Brazil",624,5,5,3,2,1,2
"Serbia",624,5,5,6,5,1,1
"Germany",625,6,9,6,1,5,1
"Sweden",625,6,3,6,7,-1,2
"England",629,7,5,2,1,1,1
"Tunisia",629,7,4,3,4,-1,2
"Denmark",630,3,5,4,3,1,1
"Peru",630,3,4,4,4,0,2
"England",630,7,5,2,1,1,2
"Panama",630,7,5,3,2,1,1
"Iceland",632,4,5,3,2,1,1
"Croatia",632,4,3,4,4,0,2
"Uruguay",638,1,4,8,5,3,1
"Russia",638,1,4,6,6,0,2
"Portugal",640,2,7,6,3,3,1
"Iran",640,2,7,4,1,3,2
"Uruguay",641,1,7,5,1,4,2
"Egypt",641,1,7,7,3,4,1
"Spain",641,2,7,5,2,3,1
"Portugal",641,2,7,4,1,3,2
"Germany",642,6,5,4,2,2,1
"Mexico",642,6,3,4,4,0,2
"France",644,3,5,5,4,1,2
"Australia",644,3,5,7,6,1,1
"Egypt",645,1,6,2,1,1,1
"Russia",645,1,4,3,3,0,2
"Mexico",645,6,5,3,1,2,1
"South Korea",645,6,5,2,0,2,2
"Iran",648,2,9,7,0,7,1
"Spain",648,2,4,4,4,0,2
"France",648,3,5,3,2,1,2
"Australia",648,3,5,5,4,1,1
"Croatia",650,4,6,3,2,1,2
"Argentina",650,4,6,7,6,1,1
"France",652,3,9,5,2,3,1
"Denmark",652,3,4,3,3,0,2
"Uruguay",656,1,5,3,2,1,1
"Russia",656,1,5,2,1,1,2
"Colombia",656,8,7,4,2,2,2
"Poland",656,8,7,5,3,2,1
"Sweden",658,6,5,4,3,1,1
"Germany",658,6,5,1,0,1,2
"France",661,3,5,2,1,1,2
"Denmark",661,3,5,4,3,1,1
"Croatia",662,4,7,5,2,3,2
"Argentina",662,4,7,6,3,3,1
"South Korea",666,6,5,2,1,1,2
"Germany",666,6,5,4,3,1,1
"Argentina",667,4,9,9,2,7,1
"Iceland",667,4,2,3,5,-2,2
"Spain",670,2,7,6,2,4,2
"Portugal",670,2,7,7,3,4,1
"Brazil",675,5,6,4,2,2,1
"Costa Rica",675,5,6,4,3,1,2
"Senegal",679,8,5,5,4,1,1
"Poland",679,8,5,4,3,1,2
"Germany",680,6,9,6,1,5,1
"Mexico",680,6,4,4,4,0,2
"Sweden",683,6,7,6,2,4,1
"Mexico",683,6,4,4,4,0,2
"England",684,7,9,7,1,6,1
"Panama",684,7,4,5,5,0,2
"Morocco",685,2,6,6,4,2,1
"Spain",685,2,4,5,5,0,2
"Russia",686,1,5,6,3,3,1
"Saudi Arabia",686,1,4,5,6,-1,2
"Russia",690,1,6,5,2,3,1
"Saudi Arabia",690,1,4,3,5,-2,2
"France",695,3,5,4,3,1,1
"Peru",695,3,3,4,4,0,2
"Brazil",695,5,5,5,3,2,1
"Serbia",695,5,3,3,3,0,2
"Brazil",698,5,6,4,3,1,2
"Switzerland",698,5,6,3,1,2,1
"Switzerland",702,5,4,5,5,0,2
"Serbia",702,5,4,2,1,1,1
"Portugal",703,2,5,3,1,2,1
"Iran",703,2,5,2,0,2,2
"Mexico",703,6,6,3,2,1,1
"Germany",703,6,4,4,4,0,2
"Japan",703,8,4,4,4,0,2
"Poland",703,8,4,2,1,1,1
"Poland",707,8,6,3,1,2,1
"Colombia",707,8,4,4,4,0,2
"South Korea",709,6,5,3,1,2,1
"Mexico",709,6,4,6,6,0,2
"Spain",711,2,4,4,2,2,1
"Morocco",711,2,4,5,5,0,2
"France",713,3,6,6,4,2,1
"Peru",713,3,6,4,2,2,2
"Mexico",714,6,7,6,2,4,2
"Germany",714,6,7,7,3,4,1
"Sweden",716,6,6,4,5,-1,1
"Mexico",716,6,4,5,4,1,2
"Uruguay",718,1,6,8,6,2,2
"Egypt",718,1,6,5,2,3,1
"Portugal",718,2,5,3,2,1,2
"Iran",718,2,5,4,3,1,1
"South Korea",718,6,5,3,2,1,1
"Germany",718,6,5,2,1,1,2
"Uruguay",719,1,6,7,5,2,1
"Saudi Arabia",719,1,6,5,3,2,2
"France",719,3,9,3,0,3,1
"Denmark",719,3,2,4,5,-1,2
"Argentina",722,4,6,4,2,2,1
"Iceland",722,4,6,4,3,1,2
"Russia",724,1,5,5,3,2,1
"Saudi Arabia",724,1,5,5,4,1,2
"Japan",724,8,6,3,1,2,2
"Poland",724,8,6,4,2,2,1
"Uruguay",725,1,5,3,2,1,1
"Saudi Arabia",725,1,4,5,5,0,2
"Poland",728,8,9,7,2,5,1
"Colombia",728,8,4,4,4,0,2
"England",730,7,6,5,2,3,1
"Tunisia",730,7,6,5,3,2,2
"Sweden",731,6,5,4,2,2,1
"South Korea",731,6,5,2,1,1,2
"Uruguay",732,1,7,3,0,3,2
"Russia",732,1,7,6,3,3,1
"Portugal",733,2,5,5,2,3,2
"Iran",733,2,5,6,3,3,1
"Croatia",734,4,6,6,4,2,2
"Argentina",734,4,6,6,3,3,1
"Uruguay",735,1,6,6,3,3,2
"Russia",735,1,6,7,4,3,1
"Croatia",736,4,5,4,2,2,1
"Argentina",736,4,5,3,2,1,2
"Uruguay",738,1,6,6,2,4,1
"Russia",738,1,6,4,3,1,2
"South Korea",744,6,7,6,3,3,1
"Mexico",744,6,4,5,4,1,2
"Brazil",748,5,7,5,3,2,1
"Serbia",748,5,4,4,4,0,2
"France",749,3,4,6,4,2,1
"Denmark",749,3,4,3,3,0,2
"Argentina",753,4,6,4,2,2,1
"Iceland",753,4,6,3,1,2,2
"Germany",755,6,6,5,3,2,1
"South Korea",755,6,4,5,5,0,2
"Iran",757,2,6,6,3,3,1
"Morocco",757,2,4,3,5,-2,2
"Colombia",757,8,5,5,3,2,1
"Japan",757,8,5,4,2,2,2
"France",760,3,7,7,4,3,1
"Peru",760,3,7,6,3,3,2
"Spain",762,2,7,8,3,5,1
"Portugal",762,2,7,6,1,5,2
"Belgium",762,7,9,5,1,4,1
"Panama",762,7,3,4,5,-1,2
"Egypt",763,1,9,7,3,4,1
"Uruguay",763,1,2,3,4,-1,2
"Brazil",764,5,5,2,1,1,2
"Switzerland",764,5,5,5,4,1,1
"Croatia",765,4,7,2,0,2,1
"Argentina",765,4,4,2,2,0,2
"Spain",766,2,9,6,3,3,1
"Portugal",766,2,3,5,5,0,2
"France",766,3,6,6,4,2,1
"Australia",766,3,6,5,4,1,2
"Spain",767,2,9,5,0,5,1
"Iran",767,2,4,2,2,0,2
"Spain",769,2,7,6,3,3,1
"Portugal",769,2,7,4,1,3,2
"Peru",769,3,7,6,4,2,1
"Australia",769,3,7,4,2,2,2
"Spain",770,2,5,4,3,1,2
"Morocco",770,2,5,6,5,1,1
"France",770,3,5,7,2,5,1
"Denmark",770,3,4,4,6,-2,2
"Germany",770,6,5,3,1,2,1
"South Korea",770,6,3,2,2,0,2
"Portugal",773,2,9,7,0,7,1
"Spain",773,2,4,4,5,-1,2
"Brazil",773,5,5,2,1,1,2
"Serbia",773,5,5,3,2,1,1
"Belgium",773,7,5,5,4,1,1
"Panama",773,7,5,4,3,1,2
"Uruguay",774,1,9,6,1,5,1
"Russia",774,1,2,4,5,-1,2
"Uruguay",775,1,5,2,1,1,2
"Egypt",775,1,5,3,2,1,1
"France",775,3,5,7,1,6,1
"Australia",775,3,4,4,4,0,2
"Mexico",777,6,9,6,0,6,1
"South Korea",777,6,4,4,3,1,2
"Saudi Arabia",779,1,6,6,4,2,1
"Russia",779,1,4,6,6,0,2
"Colombia",779,8,5,3,2,1,1
"Poland",779,8,4,3,3,0,2
"Germany",785,6,6,3,2,1,1
"South Korea",785,6,4,3,3,0,2
"Spain",787,2,7,6,1,5,1
"Iran",787,2,7,5,0,5,2
"France",787,3,9,5,1,4,1
"Peru",787,3,4,4,4,0,2
"Belgium",787,7,9,5,2,3,1
"England",787,7,3,5,6,-1,2
"Uruguay",788,1,5,3,2,1,1
"Saudi Arabia",788,1,3,1,1,0,2
"Poland",792,8,6,2,2,0,1
"Colombia",792,8,4,3,2,1,2
"Colombia",796,8,7,6,3,3,1
"Senegal",796,8,4,4,4,0,2
"France",798,3,7,6,1,5,1
"Peru",798,3,4,3,3,0,2
"Mexico",798,6,6,5,3,2,1
"Germany",798,6,6,4,2,2,2
"Argentina",799,4,9,6,2,4,1
"Croatia",799,4,2,3,4,-1,2
"Brazil",799,5,9,7,2,5,1
"Switzerland",799,5,4,5,4,1,2
"France",800,3,9,8,3,5,1
"Denmark",800,3,4,3,4,-1,2
"Japan",802,8,6,6,2,4,1
"Poland",802,8,6,5,4,1,2
"Poland",803,8,7,4,2,2,1
"Senegal",803,8,4,4,4,0,2
"Germany",804,6,7,4,1,3,1
"South Korea",804,6,4,4,4,0,2
"Argentina",810,4,9,7,1,6,1
"Iceland",810,4,3,6,7,-1,2
"Belgium",810,7,6,9,3,6,1
"Panama",810,7,6,8,6,2,2
"France",811,3,7,4,1,3,2
"Australia",811,3,7,5,2,3,1
"Russia",813,1,5,2,1,1,1
"Egypt",813,1,5,1,0,1,2
"Belgium",813,7,5,2,1,1,2
"Tunisia",813,7,5,3,2,1,1
"Spain",814,2,7,6,4,2,1
"Portugal",814,2,4,6,5,1,2
"Russia",815,1,7,4,1,3,1
"Uruguay",815,1,4,6,6,0,2
"Japan",818,8,6,3,1,2,2
"Senegal",818,8,6,4,2,2,1
"Brazil",820,5,6,6,4,2,1
"Serbia",820,5,4,4,5,-1,2
"Peru",823,3,6,7,3,4,1
"Denmark",823,3,4,5,6,-1,2
"Mexico",823,6,6,3,1,2,1
"South Korea",823,6,6,4,3,1,2
"France",826,3,9,8,0,8,1
"Denmark",826,3,2,3,5,-2,2
"Croatia",826,4,6,5,3,2,1
"Argentina",826,4,6,4,2,2,2
"Switzerland",826,5,6,4,4,0,2
"Serbia",826,5,6,6,3,3,1
"Mexico",826,6,5,4,3,1,1
"Germany",826,6,5,3,2,1,2
"Uruguay",829,1,6,6,5,1,2
"Egypt",829,1,6,4,1,3,1
"Germany",829,6,5,2,1,1,1
"Sweden",829,6,4,4,4,0,2
"France",830,3,7,5,2,3,1
"Peru",830,3,7,4,1,3,2
"Uruguay",832,1,5,5,1,4,1
"Saudi Arabia",832,1,3,3,3,0,2
"Russia",835,1,5,2,1,1,2
"Saudi Arabia",835,1,5,3,2,1,1
"France",835,3,9,6,3,3,1
"Australia",835,3,4,5,5,0,2
"Portugal",836,2,9,7,2,5,1
"Spain",836,2,4,4,4,0,2
"Spain",837,2,5,3,2,1,1
"Portugal",837,2,5,2,1,1,2
"France",839,3,9,8,4,4,1
"Australia",839,3,2,3,4,-1,2
"England",839,7,5,4,2,2,1
"Panama",839,7,5,3,2,1,2
"Portugal",842,2,6,5,3,2,1
"Iran",842,2,6,3,1,2,2
"Croatia",842,4,6,6,2,4,1
"Iceland",842,4,4,4,4,0,2
"Colombia",843,8,7,6,2,4,1
"Japan",843,8,7,5,1,4,2
"Argentina",851,4,5,4,3,1,1
"Iceland",851,4,5,3,2,1,2
"Uruguay",852,1,6,4,2,2,2
"Russia",852,1,6,5,3,2,1
"France",852,3,5,3,1,2,2
"Denmark",852,3,5,4,2,2,1
"Iceland",853,4,6,2,1,1,1
"Nigeria",853,4,4,2,2,0,2
"Egypt",855,1,7,4,1,3,1
"Saudi Arabia",855,1,4,5,5,0,2
"Portugal",859,2,6,6,2,4,2
"Iran",859,2,6,7,3,4,1
"Germany",860,6,7,5,1,4,1
"Mexico",860,6,4,7,7,0,2
"Iran",861,2,5,4,3,1,1
"Portugal",861,2,4,5,5,0,2
"Germany",865,6,5,6,2,4,1
"Sweden",865,6,4,3,3,0,2
"Portugal",866,2,5,3,1,2,1
"Iran",866,2,5,2,0,2,2
"Japan",866,8,5,2,1,1,2
"Senegal",866,8,5,3,2,1,1
"Portugal",868,2,5,4,1,3,2
"Iran",868,2,5,6,3,3,1
"Mexico",870,6,7,5,2,3,1
"South Korea",870,6,4,5,5,0,2
"Saudi Arabia",872,1,6,2,2,0,1
"Uruguay",872,1,4,3,2,1,2
"Peru",873,3,5,6,2,4,1
"Australia",873,3,5,4,2,2,2
"Croatia",874,4,5,3,2,1,2
"Iceland",874,4,5,4,3,1,1
"South Korea",874,6,6,5,2,3,1
"Germany",874,6,4,3,3,0,2
"Colombia",874,8,6,4,3,1,1
"Poland",874,8,6,3,2,1,2
"Russia",876,1,6,6,5,1,1
"Egypt",876,1,6,3,2,1,2
"Senegal",877,8,6,4,1,3,2
"Poland",877,8,6,5,2,3,1
"France",878,3,6,5,2,3,1
"Australia",878,3,4,2,2,0,2
"Germany",881,6,6,10,1,9,1
"Sweden",881,6,4,4,7,-3,2
"France",882,3,5,4,3,1,1
"Denmark",882,3,5,3,2,1,2
"Mexico",887,6,6,6,5,1,1
"Germany",887,6,4,3,3,0,2
"Colombia",888,8,6,3,3,0,1
"Poland",888,8,4,4,3,1,2
"Argentina",889,4,7,7,2,5,1
"Nigeria",889,4,4,4,5,-1,2
"Senegal",890,8,6,5,3,2,1
"Colombia",890,8,4,4,4,0,2
"Spain",894,2,5,2,1,1,2
"Portugal",894,2,5,4,3,1,1
"Japan",895,8,7,4,1,3,1
"Poland",895,8,4,5,5,0,2
"Argentina",896,4,9,6,2,4,1
"Croatia",896,4,3,4,5,-1,2
"Portugal",901,2,6,5,3,2,1
"Iran",901,2,6,4,2,2,2
"Colombia",901,8,4,3,2,1,2
"Senegal",901,8,4,5,4,1,1
"Mexico",903,6,7,4,1,3,1
"Sweden",903,6,4,3,3,0,2
"Poland",905,8,5,2,1,1,1
"Colombia",905,8,4,5,5,0,2
"Russia",906,1,6,5,5,0,1
"Egypt",906,1,4,6,6,0,2
"Brazil",906,5,9,13,0,13,1
"Switzerland",906,5,4,3,5,-2,2
"Brazil",907,5,7,3,1,2,2
"Serbia",907,5,7,5,3,2,1
"Belgium",907,7,5,4,3,1,1
"England",907,7,5,2,1,1,2
"Iran",909,2,7,3,1,2,1
"Spain",909,2,4,3,3,0,2
"Mexico",910,6,5,3,2,1,1
"South Korea",910,6,3,2,2,0,2
"France",912,3,7,5,3,2,2
"Australia",912,3,7,8,6,2,1
"Brazil",912,5,6,4,2,2,1
"Costa Rica",912,5,4,4,4,0,2
"Colombia",914,8,7,3,0,3,2
"Poland",914,8,7,4,1,3,1
"Brazil",915,5,6,5,2,3,1
"Costa Rica",915,5,4,2,3,-1,2
"Mexico",915,6,6,3,2,1,2
"South Korea",915,6,6,8,7,1,1
"Japan",918,8,4,6,4,2,1
"Poland",918,8,4,4,4,0,2
"Russia",921,1,5,3,1,2,1
"Uruguay",921,1,3,2,2,0,2
"Argentina",929,4,9,8,2,6,1
"Iceland",929,4,3,6,8,-2,2
"Brazil",929,5,6,5,2,3,1
"Costa Rica",929,5,4,3,4,-1,2
"Colombia",931,8,9,8,1,7,1
"Japan",931,8,3,4,6,-2,2
"Uruguay",936,1,5,5,4,1,1
"Russia",936,1,3,3,3,0,2
"France",936,3,6,5,3,2,1
"Denmark",936,3,6,4,2,2,2
"Sweden",936,6,6,5,3,2,2
"Germany",936,6,6,6,3,3,1
"Belgium",936,7,4,2,1,1,1
"England",936,7,4,2,2,0,2
"Colombia",936,8,5,2,1,1,2
"Poland",936,8,5,3,1,2,1
"France",939,3,5,7,3,4,1
"Peru",939,3,5,6,2,4,2
"Brazil",939,5,4,3,3,0,2
"Costa Rica",939,5,4,2,1,1,1
"France",943,3,9,8,1,7,1
"Peru",943,3,3,2,4,-2,2
"Mexico",943,6,7,5,1,4,2
"South Korea",943,6,7,6,2,4,1
"Brazil",944,5,5,5,1,4,1
"Serbia",944,5,3,2,2,0,2
"Mexico",944,6,5,3,2,1,1
"Germany",944,6,4,4,4,0,2
"Spain",945,2,6,4,2,2,1
"Portugal",945,2,6,3,1,2,2
"Belgium",946,7,6,6,4,2,1
"England",946,7,6,4,2,2,2
"France",947,3,6,4,4,0,2
"Denmark",947,3,6,5,5,0,1
"France",948,3,9,6,2,4,1
"Australia",948,3,2,5,6,-1,2
"Uruguay",950,1,5,5,2,3,1
"Saudi Arabia",950,1,3,2,2,0,2
"France",951,3,6,6,4,2,1
"Australia",951,3,6,5,3,2,2
"Croatia",952,4,7,7,1,6,2
"Argentina",952,4,7,8,2,6,1
"Germany",952,6,6,5,4,1,1
"Mexico",952,6,4,4,4,0,2
"Brazil",953,5,9,6,2,4,1
"Switzerland",953,5,4,3,3,0,2
"Colombia",954,8,7,7,3,4,1
"Poland",954,8,4,5,5,0,2
"South Korea",955,6,6,4,3,1,2
"Germany",955,6,6,6,5,1,1
"France",957,3,9,7,2,5,1
"Peru",957,3,3,4,5,-1,2
"Argentina",957,4,5,4,1,3,1
"Iceland",957,4,5,4,2,2,2
"Croatia",958,4,7,5,1,4,2
"Argentina",958,4,7,6,2,4,1
"Brazil",958,5,6,4,1,3,1
"Costa Rica",958,5,6,4,3,1,2
"Croatia",959,4,7,7,4,3,1
"Argentina",959,4,7,4,1,3,2
"Belgium",962,7,5,6,3,3,2
"England",962,7,5,9,3,6,1
"Russia",965,1,5,3,2,1,1
"Uruguay",965,1,4,4,4,0,2
"Colombia",968,8,9,5,0,5,1
"Poland",968,8,3,4,5,-1,2
"Russia",970,1,5,2,1,1,1
"Egypt",970,1,5,1,0,1,2
"Senegal",970,8,4,4,2,2,1
"Poland",970,8,4,3,4,-1,2
"Argentina",972,4,6,2,1,1,1
"Nigeria",972,4,4,3,3,0,2
"South Korea",973,6,5,2,1,1,2
"Germany",973,6,5,4,3,1,1
"France",974,3,7,6,3,3,1
"Peru",974,3,7,5,2,3,2
"Croatia",975,4,5,5,4,1,1
"Iceland",975,4,4,4,4,0,2
"Belgium",975,7,9,4,0,4,1
"Panama",975,7,3,4,5,-1,2
"France",984,3,7,5,2,3,1
"Denmark",984,3,7,4,1,3,2
"France",985,3,6,4,3,1,1
"Peru",985,3,4,6,6,0,2
"Japan",987,8,6,6,4,2,1
"Senegal",987,8,4,6,6,0,2
"France",988,3,6,5,4,1,1
"Peru",988,3,6,4,3,1,2
"Croatia",988,4,6,4,3,1,2
"Iceland",988,4,6,6,5,1,1
"Spain",989,2,5,3,2,1,1
"Iran",989,2,5,2,1,1,2
"Australia",989,3,5,1,0,1,1
"Peru",989,3,3,2,2,0,2
"Japan",989,8,9,7,3,4,1
"Colombia",989,8,2,5,6,-1,2
"Mexico",991,6,6,6,4,2,1
"Germany",991,6,6,5,3,2,2
"Uruguay",993,1,5,4,2,2,1
"Russia",993,1,4,6,6,0,2
"England",995,7,6,3,1,2,1
"Panama",995,7,4,3,3,0,2
"Uruguay",996,1,5,6,5,1,2
"Saudi Arabia",996,1,5,8,7,1,1
"South Korea",996,6,6,8,5,3,1
"Mexico",996,6,4,6,6,0,2
"Argentina",997,4,4,2,2,0,2
"Nigeria",997,4,4,3,1,2,1
"Croatia",1000,4,9,6,0,6,1
"Argentina",1000,4,3,4,5,-1,2
"Iran",1,2,4,5,3,2,2
"Spain",1,2,7,6,2,4,1
"Belgium",5,7,4,3,3,0,1
"England",5,7,4,2,2,0,2
"Brazil",11,5,4,1,2,-1,2
"Serbia",11,5,9,5,0,5,1
"Portugal",14,2,5,4,3,1,1
"Spain",14,2,5,4,3,1,2
"Egypt",20,1,3,3,4,-1,2
"Uruguay",20,1,9,5,1,4,1
"Colombia",24,8,5,2,1,1,1
"Japan",24,8,5,2,1,1,2
"Argentina",27,4,6,4,2,2,1
"Iceland",27,4,6,4,2,2,2
"Russia",39,1,7,5,1,4,1
"Uruguay",39,1,7,5,1,4,2
"Costa Rica",39,5,5,4,1,3,1
"Serbia",39,5,5,4,1,3,2
"Russia",42,1,6,5,4,1,1
"Saudi Arabia",42,1,4,4,4,0,2
"Germany",42,6,5,2,1,1,1
"Sweden",42,6,5,2,1,1,2
"Japan",43,8,5,3,2,1,1
"Senegal",43,8,5,3,2,1,2
"Iran",48,2,4,3,2,1,2
"Spain",48,2,7,4,1,3,1
"Iran",53,2,6,5,4,1,1
"Portugal",53,2,4,2,2,0,2
"Colombia",56,8,5,2,1,1,1
"Senegal",56,8,5,2,1,1,2
"Egypt",64,1,5,2,1,1,1
"Uruguay",64,1,5,2,1,1,2
"England",65,7,6,4,2,2,1
"Panama",65,7,6,4,2,2,2
"Egypt",69,1,7,2,0,2,1
"Russia",69,1,7,2,0,2,2
"Germany",72,6,5,4,1,3,1
"Sweden",72,6,5,4,1,3,2
"Australia",77,3,4,3,3,0,2
"France",77,3,6,4,3,1,1
"Argentina",82,4,7,5,1,4,1
"Croatia",82,4,7,5,1,4,2
"Belgium",82,7,7,5,0,5,1
"England",82,7,7,5,0,5,2
"Australia",92,3,3,2,2,0,2
"France",92,3,5,3,2,1,1
"Australia",94,3,4,4,4,0,2
"France",94,3,6,5,2,3,1
"Denmark",98,3,3,3,3,0,2
"France",98,3,9,5,0,5,1
"Argentina",99,4,7,4,0,4,1
"Croatia",99,4,7,4,0,4,2
"Belgium",103,7,7,6,2,4,1
"England",103,7,7,6,2,4,2
"Denmark",106,3,5,3,2,1,1
"France",106,3,5,3,2,1,2
"Brazil",107,5,9,7,2,5,1
"Costa Rica",107,5,4,5,5,0,2
"Russia",117,1,5,3,2,1,1
"Uruguay",117,1,5,3,2,1,2
"Argentina",118,4,6,5,3,2,1
"Nigeria",118,4,6,5,3,2,2
"Australia",121,3,3,4,4,0,2
"Denmark",121,3,5,3,2,1,1
"Colombia",121,8,6,4,1,3,1
"Senegal",121,8,6,4,1,3,2
"Colombia",124,8,4,3,3,0,2
"Japan",124,8,5,4,2,2,1
"Russia",125,1,6,3,2,1,1
"Saudi Arabia",125,1,4,4,4,0,2
"Australia",125,3,7,3,0,3,1
"France",125,3,7,3,0,3,2
"England",125,7,5,2,1,1,1
"Tunisia",125,7,5,2,1,1,2
"Iran",129,2,5,7,4,3,1
"Portugal",129,2,5,7,4,3,2
"Germany",134,6,5,2,1,1,1
"Sweden",134,6,5,2,1,1,2
"Russia",140,1,7,4,1,3,1
"Uruguay",140,1,7,4,1,3,2
"Germany",140,6,6,4,3,1,1
"Mexico",140,6,6,4,3,1,2
"Germany",146,6,4,1,1,0,2
"Mexico",146,6,5,2,1,1,1
"Australia",150,3,4,3,2,1,2
"Peru",150,3,9,5,1,4,1
"Australia",154,3,9,4,0,4,1
"France",154,3,4,2,2,0,2
"Argentina",160,4,4,4,4,0,2
"Nigeria",160,4,6,6,4,2,1
"Belgium",168,7,6,8,6,2,1
"Panama",168,7,6,8,6,2,2
"Argentina",173,4,3,2,2,0,2
"Croatia",173,4,3,4,4,0,1
"Germany",181,6,7,2,0,2,1
"Mexico",181,6,4,2,2,0,2
"Colombia",182,8,9,6,3,3,1
"Japan",182,8,4,4,4,0,2
"Australia",191,3,4,3,3,0,2
"Peru",191,3,7,5,3,2,1
"Brazil",192,5,4,3,3,0,2
"Costa Rica",192,5,4,3,2,1,1
"Argentina",194,4,4,3,3,0,2
"Nigeria",194,4,5,4,2,2,1
"Japan",196,8,4,3,2,1,1
"Poland",196,8,4,3,2,1,2
"Iran",198,2,5,4,2,2,1
"Portugal",198,2,4,5,5,0,2
"Argentina",205,4,9,6,0,6,1
"Croatia",205,4,4,2,3,-1,2
"Iran",208,2,4,4,4,0,2
"Spain",208,2,7,3,1,2,1
"Belgium",210,7,5,3,2,1,1
"England",210,7,5,3,2,1,2
"Egypt",211,1,3,2,2,0,2
"Uruguay",211,1,5,4,2,2,1
"Germany",213,6,5,5,2,3,1
"Mexico",213,6,5,5,2,3,2
"Portugal",214,2,7,6,3,3,1
"Spain",214,2,7,6,3,3,2
"Egypt",217,1,4,1,1,0,2
"Uruguay",217,1,6,3,2,1,1
"Brazil",225,5,5,2,1,1,1
"Costa Rica",225,5,5,2,1,1,2
"Russia",227,1,6,4,2,2,1
"Uruguay",227,1,6,4,2,2,2
"Russia",246,1,4,2,2,0,2
"Saudi Arabia",246,1,7,4,1,3,1
"Egypt",247,1,4,3,2,1,2
"Russia",247,1,6,5,3,2,1
"Colombia",249,8,4,4,3,1,2
"Poland",249,8,9,5,2,3,1
"Germany",256,6,6,5,3,2,1
"Sweden",256,6,6,5,3,2,2
"Australia",260,3,2,1,2,-1,2
"France",260,3,9,7,3,4,1
"England",271,7,4,2,2,0,2
"Panama",271,7,5,2,1,1,1
"Morocco",277,2,4,4,4,0,2
"Spain",277,2,6,4,2,2,1
"Costa Rica",282,5,6,6,3,3,1
"Serbia",282,5,6,6,3,3,2
"Germany",290,6,7,6,3,3,1
"Mexico",290,6,4,5,5,0,2
"Australia",301,3,6,4,3,1,2
"Peru",301,3,6,5,2,3,1
"Australia",311,3,6,4,3,1,1
"Denmark",311,3,4,3,2,1,2
"Colombia",311,8,4,3,3,0,2
"Poland",311,8,5,2,1,1,1
"Germany",315,6,4,2,1,1,2
"South Korea",315,6,7,2,0,2,1
"Colombia",315,8,9,6,2,4,1
"Japan",315,8,3,2,3,-1,2
"Belgium",317,7,4,3,1,2,1
"England",317,7,4,3,3,0,2
"Colombia",318,8,5,2,1,1,1
"Japan",318,8,4,2,2,0,2
"Colombia",327,8,5,4,2,2,1
"Japan",327,8,4,4,4,0,2
"Australia",330,3,4,4,3,1,2
"Peru",330,3,9,7,2,5,1
"Costa Rica",347,5,6,5,3,2,1
"Switzerland",347,5,6,5,3,2,2
"Argentina",349,4,5,2,1,1,1
"Nigeria",349,4,5,2,1,1,2
"Egypt",353,1,4,4,4,0,1
"Saudi Arabia",353,1,4,4,4,0,2
"Russia",354,1,6,4,1,3,1
"Saudi Arabia",354,1,4,3,3,0,2
"Egypt",356,1,3,2,3,-1,2
"Russia",356,1,9,4,1,3,1
"Belgium",365,7,7,4,1,3,1
"England",365,7,4,5,5,0,2
"Egypt",367,1,3,4,5,-1,2
"Uruguay",367,1,9,8,1,7,1
"Brazil",367,5,6,6,5,1,2
"Switzerland",367,5,6,5,3,2,1
"Japan",369,8,7,8,1,7,1
"Poland",369,8,7,8,1,7,2
"Egypt",370,1,4,3,3,0,2
"Uruguay",370,1,5,3,2,1,1
"Colombia",371,8,3,3,3,0,2
"Japan",371,8,5,4,2,2,1
"Saudi Arabia",385,1,4,3,2,1,1
"Uruguay",385,1,4,3,2,1,2
"Russia",390,1,6,5,3,2,1
"Saudi Arabia",390,1,4,4,4,0,2
"Egypt",396,1,4,2,2,0,2
"Uruguay",396,1,6,6,4,2,1
"Colombia",399,8,5,3,2,1,2
"Japan",399,8,5,5,2,3,1
"England",404,7,6,4,2,2,1
"Panama",404,7,4,2,2,0,2
"Australia",409,3,9,5,2,3,1
"France",409,3,4,3,3,0,2
"France",413,3,6,3,2,1,1
"Peru",413,3,6,3,2,1,2
"Germany",419,6,6,3,1,2,1
"Mexico",419,6,6,2,1,1,2
"Colombia",426,8,4,3,3,0,2
"Japan",426,8,6,3,1,2,1
"Belgium",428,7,9,10,1,9,1
"Panama",428,7,4,4,5,-1,2
"Germany",436,6,9,6,1,5,1
"Mexico",436,6,3,2,3,-1,2
"Colombia",440,8,6,3,2,1,1
"Japan",440,8,6,3,2,1,2
"Japan",444,8,5,3,2,1,1
"Senegal",444,8,5,3,2,1,2
"Germany",445,6,6,4,2,2,2
"South Korea",445,6,6,4,1,3,1
"Croatia",448,4,5,2,1,1,1
"Iceland",448,4,5,2,1,1,2
"Colombia",448,8,9,8,4,4,1
"Poland",448,8,4,3,3,0,2
"Belgium",454,7,5,3,1,2,1
"England",454,7,5,3,1,2,2
"Australia",458,3,6,5,3,2,1
"Denmark",458,3,4,3,3,0,2
"Egypt",459,1,5,5,2,3,1
"Saudi Arabia",459,1,5,4,3,1,2
"Colombia",478,8,2,2,3,-1,2
"Japan",478,8,9,7,2,5,1
"Colombia",479,8,5,4,3,1,1
"Japan",479,8,5,4,3,1,2
"Belgium",480,7,3,2,3,-1,2
"Panama",480,7,9,6,2,4,1
"Australia",481,3,5,3,2,1,1
"Denmark",481,3,4,2,2,0,2
"Denmark",485,3,4,4,4,0,2
"Peru",485,3,7,5,3,2,1
"Portugal",488,2,5,3,2,1,1
"Spain",488,2,5,3,2,1,2
"Germany",491,6,6,6,2,4,1
"Mexico",491,6,6,4,3,1,2
"Denmark",495,3,7,5,0,5,1
"France",495,3,7,5,0,5,2
"Belgium",498,7,7,4,1,3,1
"England",498,7,7,4,1,3,2
"Iran",503,2,5,3,1,2,1
"Morocco",503,2,4,4,4,0,2
"Colombia",503,8,9,7,3,4,1
"Japan",503,8,4,5,5,0,2
"Belgium",504,7,6,4,2,2,1
"Panama",504,7,6,4,2,2,2
"Colombia",505,8,5,2,1,1,1
"Poland",505,8,5,2,1,1,2
"Iran",511,2,5,2,0,2,2
"Portugal",511,2,5,4,1,3,1
"England",514,7,5,2,1,1,1
"Tunisia",514,7,5,2,1,1,2
"Brazil",517,5,9,4,0,4,1
"Costa Rica",517,5,4,3,3,0,2
"Colombia",519,8,6,7,3,4,1
"Japan",519,8,6,7,3,4,2
"Australia",526,3,4,3,4,-1,2
"Peru",526,3,5,3,2,1,1
"Iran",531,2,4,2,1,1,2
"Portugal",531,2,6,2,2,0,1
"Argentina",540,4,6,2,1,1,1
"Iceland",540,4,6,2,1,1,2
"Colombia",543,8,7,7,3,4,1
"Poland",543,8,7,7,3,4,2
"Argentina",547,4,4,3,3,0,2
"Iceland",547,4,9,5,1,4,1
"Croatia",550,4,5,5,3,2,1
"Iceland",550,4,5,5,3,2,2
"Australia",552,3,6,3,1,2,1
"Denmark",552,3,4,2,2,0,2
"Argentina",553,4,9,6,2,4,1
"Croatia",553,4,4,6,4,2,2
"England",558,7,5,3,2,1,1
"Panama",558,7,5,3,2,1,2
"Brazil",562,5,3,3,3,0,2
"Serbia",562,5,5,3,2,1,1
"Colombia",565,8,4,3,3,0,2
"Japan",565,8,9,6,3,3,1
"Argentina",566,4,4,2,2,0,2
"Iceland",566,4,4,3,2,1,1
"Belgium",570,7,6,2,1,1,1
"Tunisia",570,7,6,2,1,1,2
"Russia",571,1,6,7,3,4,1
"Uruguay",571,1,6,7,3,4,2
"Germany",574,6,6,7,3,4,1
"Mexico",574,6,4,3,3,0,2
"Colombia",582,8,5,3,2,1,2
"Japan",582,8,5,9,5,4,1
"Mexico",583,6,4,5,4,1,1
"South Korea",583,6,4,5,4,1,2
"Croatia",585,4,7,3,0,3,1
"Iceland",585,4,7,3,0,3,2
"Australia",586,3,3,3,5,-2,2
"France",586,3,9,8,1,7,1
"Brazil",592,5,6,6,4,2,1
"Switzerland",592,5,6,6,4,2,2
"Belgium",592,7,7,2,0,2,1
"England",592,7,7,2,0,2,2
"Germany",601,6,5,5,3,2,1
"South Korea",601,6,5,5,3,2,2
"Belgium",604,7,9,4,0,4,1
"England",604,7,4,2,2,0,2
"Belgium",605,7,7,4,1,3,1
"Panama",605,7,7,4,1,3,2
"Denmark",606,3,6,3,2,1,1
"France",606,3,6,3,2,1,2
"Argentina",607,4,6,5,2,3,1
"Croatia",607,4,6,5,2,3,2
"Iran",608,2,5,1,0,1,2
"Spain",608,2,5,2,0,2,1
"Japan",611,8,6,2,1,1,1
"Poland",611,8,4,2,2,0,2
"Australia",616,3,4,3,4,-1,2
"Denmark",616,3,6,6,4,2,1
"Argentina",617,4,6,3,1,2,1
"Croatia",617,4,4,3,3,0,2
"Morocco",620,2,7,2,0,2,1
"Portugal",620,2,7,2,0,2,2
"Argentina",626,4,5,3,2,1,1
"Croatia",626,4,5,3,2,1,2
"Germany",626,6,7,4,0,4,1
"Mexico",626,6,7,4,0,4,2
"Croatia",639,4,7,3,0,3,1
"Iceland",639,4,7,3,0,3,2
"Argentina",643,4,6,3,2,1,1
"Croatia",643,4,6,3,2,1,2
"Argentina",645,4,4,4,4,0,2
"Nigeria",645,4,7,5,3,2,1
"Germany",646,6,4,5,3,2,2
"South Korea",646,6,6,5,5,0,1
"Colombia",649,8,4,3,4,-1,2
"Poland",649,8,7,6,1,5,1
"Egypt",650,1,5,5,3,2,1
"Russia",650,1,5,5,3,2,2
"Denmark",653,3,4,3,3,0,2
"France",653,3,9,7,1,6,1
"Argentina",653,4,7,2,0,2,1
"Croatia",653,4,4,2,2,0,2
"Russia",655,1,7,6,2,4,1
"Uruguay",655,1,7,6,2,4,2
"Costa Rica",659,5,4,3,3,0,1
"Switzerland",659,5,4,3,3,0,2
"Denmark",660,3,7,4,1,3,1
"France",660,3,7,4,1,3,2
"Belgium",660,7,6,5,4,1,2
"England",660,7,6,6,2,4,1
"Colombia",662,8,4,3,3,0,2
"Japan",662,8,6,4,1,3,1
"Denmark",665,3,6,4,2,2,1
"France",665,3,6,4,2,2,2
"Russia",667,1,4,6,5,1,1
"Saudi Arabia",667,1,4,3,3,0,2
"Iran",667,2,4,6,4,2,2
"Spain",667,2,6,4,4,0,1
"Germany",667,6,3,3,3,0,2
"South Korea",667,6,5,5,4,1,1
"Belgium",667,7,6,2,1,1,2
"England",667,7,6,3,1,2,1
"Morocco",669,2,3,1,1,0,2
"Portugal",669,2,5,2,1,1,1
"Brazil",672,5,6,8,2,6,1
"Costa Rica",672,5,6,2,1,1,2
"Belgium",673,7,4,2,2,0,2
"Panama",673,7,5,3,1,2,1
"Germany",674,6,7,4,1,3,1
"South Korea",674,6,7,4,1,3,2
"Denmark",681,3,4,2,1,1,2
"Peru",681,3,9,3,0,3,1
"Japan",681,8,6,4,2,2,1
"Poland",681,8,6,4,2,2,2
"Argentina",682,4,5,3,2,1,1
"Nigeria",682,4,5,3,2,1,2
"Argentina",683,4,5,5,2,3,1
"Croatia",683,4,5,5,2,3,2
"Argentina",684,4,7,5,2,3,1
"Croatia",684,4,4,3,3,0,2
"Brazil",684,5,4,4,3,1,2
"Costa Rica",684,5,7,4,2,2,1
"England",685,7,4,2,2,0,2
"Tunisia",685,7,5,2,1,1,1
"Denmark",687,3,6,4,3,1,1
"France",687,3,6,4,3,1,2
"Iran",688,2,6,5,3,2,1
"Portugal",688,2,6,5,3,2,2
"Colombia",692,8,6,5,4,1,2
"Poland",692,8,6,7,3,4,1
"Colombia",696,8,4,2,2,0,2
"Japan",696,8,7,5,3,2,1
"Argentina",698,4,7,5,2,3,1
"Iceland",698,4,7,5,2,3,2
"Iran",700,2,4,2,2,0,2
"Spain",700,2,7,2,0,2,1
"Brazil",703,5,7,4,1,3,1
"Costa Rica",703,5,4,2,2,0,2
"Costa Rica",711,5,6,4,3,1,1
"Switzerland",711,5,6,4,3,1,2
"Colombia",719,8,6,6,2,4,1
"Japan",719,8,6,4,2,2,2
"Germany",722,6,4,2,1,1,2
"South Korea",722,6,6,3,2,1,1
"Belgium",722,7,6,5,1,4,1
"England",722,7,6,5,1,4,2
"Croatia",725,4,5,5,3,2,1
"Nigeria",725,4,5,5,3,2,2
"Colombia",726,8,9,5,2,3,1
"Japan",726,8,4,3,3,0,2
"Iran",727,2,7,4,1,3,1
"Portugal",727,2,7,4,1,3,2
"Russia",728,1,6,5,2,3,1
"Uruguay",728,1,6,5,2,3,2
"Egypt",730,1,4,4,5,-1,2
"Uruguay",730,1,7,7,2,5,1
"England",732,7,4,4,3,1,1
"Panama",732,7,4,3,2,1,2
"Colombia",734,8,6,5,3,2,1
"Japan",734,8,6,4,2,2,2
"France",737,3,6,5,3,2,1
"Peru",737,3,6,5,3,2,2
"Mexico",737,6,4,4,4,0,2
"Sweden",737,6,6,4,3,1,1
"Denmark",739,3,5,3,2,1,1
"Peru",739,3,5,3,2,1,2
"England",739,7,5,2,1,1,1
"Panama",739,7,3,2,2,0,2
"Denmark",742,3,4,5,2,3,2
"France",742,3,9,7,2,5,1
"Germany",742,6,5,4,3,1,1
"South Korea",742,6,3,2,2,0,2
"France",746,3,7,3,1,2,1
"Peru",746,3,7,3,1,2,2
"Belgium",747,7,6,6,3,3,1
"Panama",747,7,6,6,3,3,2
"Egypt",753,1,5,1,0,1,1
"Russia",753,1,3,0,0,0,2
"Argentina",754,4,6,6,6,0,1
"Iceland",754,4,4,3,3,0,2
"Argentina",758,4,5,3,2,1,1
"Iceland",758,4,5,3,2,1,2
"Portugal",761,2,6,4,2,2,1
"Spain",761,2,6,4,2,2,2
"Iran",771,2,4,4,3,1,2
"Portugal",771,2,5,3,2,1,1
"France",774,3,6,4,3,1,1
"Peru",774,3,6,4,3,1,2
"Iran",777,2,4,2,2,0,2
"Spain",777,2,9,6,1,5,1
"Mexico",781,6,5,3,2,1,1
"South Korea",781,6,5,3,2,1,2
"Argentina",788,4,5,4,3,1,1
"Croatia",788,4,3,3,3,0,2
"Belgium",788,7,6,4,1,3,1
"England",788,7,4,2,2,0,2
"Egypt",800,1,4,2,2,0,2
"Uruguay",800,1,7,5,3,2,1
"Egypt",804,1,4,2,2,0,2
"Uruguay",804,1,6,6,4,2,1
"Iran",812,2,4,1,1,0,2
"Spain",812,2,5,2,1,1,1
"England",822,7,6,7,4,3,1
"Panama",822,7,6,7,4,3,2
"Brazil",824,5,5,4,3,1,1
"Switzerland",824,5,5,4,3,1,2
"Iran",826,2,4,1,1,0,2
"Portugal",826,2,6,3,1,2,1
"Germany",828,6,5,4,2,2,1
"South Korea",828,6,5,4,2,2,2
"Germany",839,6,4,2,2,0,2
"South Korea",839,6,7,4,1,3,1
"Morocco",841,2,3,2,2,0,2
"Spain",841,2,5,3,2,1,1
"Brazil",841,5,6,3,1,2,1
"Costa Rica",841,5,4,2,2,0,2
"Argentina",843,4,9,6,1,5,1
"Croatia",843,4,4,2,2,0,2
"Australia",847,3,6,5,3,2,1
"France",847,3,4,5,4,1,2
"Brazil",848,5,4,4,4,0,2
"Switzerland",848,5,7,4,1,3,1
"Denmark",855,3,4,3,5,-2,2
"France",855,3,9,7,0,7,1
"Colombia",858,8,6,3,1,2,1
"Japan",858,8,6,4,3,1,2
"Colombia",863,8,4,5,5,0,2
"Japan",863,8,9,8,2,6,1
"Belgium",867,7,5,5,3,2,2
"England",867,7,5,7,4,3,1
"Australia",869,3,5,4,2,2,1
"France",869,3,5,4,2,2,2
"Colombia",871,8,6,6,4,2,1
"Poland",871,8,6,6,4,2,2
"Iran",872,2,6,3,1,2,1
"Portugal",872,2,6,3,1,2,2
"Brazil",873,5,5,3,2,1,1
"Costa Rica",873,5,4,2,2,0,2
"Belgium",877,7,7,4,2,2,1
"England",877,7,7,4,2,2,2
"Brazil",881,5,5,5,2,3,1
"Costa Rica",881,5,5,5,2,3,2
"Germany",883,6,5,3,2,1,1
"Sweden",883,6,5,3,2,1,2
"Egypt",885,1,4,1,1,0,2
"Saudi Arabia",885,1,6,4,2,2,1
"Argentina",886,4,6,3,1,2,1
"Croatia",886,4,6,3,1,2,2
"Germany",886,6,9,9,1,8,1
"Mexico",886,6,4,3,3,0,2
"Iran",896,2,4,5,7,-2,2
"Spain",896,2,9,9,1,8,1
"Argentina",912,4,4,5,3,2,1
"Croatia",912,4,4,8,6,2,2
"Russia",914,1,4,6,6,0,2
"Saudi Arabia",914,1,5,8,4,4,1
"Colombia",926,8,5,2,1,1,1
"Japan",926,8,5,2,1,1,2
"Colombia",928,8,5,3,2,1,1
"Japan",928,8,5,3,2,1,2
"Australia",929,3,3,1,1,0,2
"Peru",929,3,3,2,2,0,1
"Japan",929,8,4,4,4,0,2
"Senegal",929,8,4,5,5,0,1
"Russia",930,1,4,4,4,0,1
"Saudi Arabia",930,1,4,3,3,0,2
"England",930,7,6,3,2,1,1
"Panama",930,7,6,3,2,1,2
"Argentina",931,4,6,4,1,3,1
"Croatia",931,4,6,4,1,3,2
"Colombia",934,8,6,5,4,1,1
"Japan",934,8,4,6,5,1,2
"Germany",940,6,6,3,3,0,1
"South Korea",940,6,4,4,4,0,2
"Germany",942,6,6,4,3,1,1
"Sweden",942,6,6,4,3,1,2
"Germany",946,6,4,3,3,0,2
"Sweden",946,6,6,4,2,2,1
"Germany",950,6,6,5,3,2,1
"Mexico",950,6,6,3,2,1,2
"Croatia",951,4,6,5,4,1,1
"Iceland",951,4,6,5,4,1,2
"Russia",956,1,6,3,3,0,1
"Uruguay",956,1,6,3,3,0,2
"Australia",956,3,4,4,6,-2,2
"France",956,3,6,7,4,3,1
"Belgium",964,7,7,3,1,2,1
"Panama",964,7,4,3,3,0,2
"Argentina",971,4,5,5,3,2,1
"Croatia",971,4,3,2,2,0,2
"Colombia",975,8,4,2,2,0,2
"Japan",975,8,7,5,3,2,1
"Australia",978,3,6,3,2,1,1
"Denmark",978,3,4,2,2,0,2
"Egypt",983,1,4,4,4,0,1
"Russia",983,1,4,4,4,0,2
"Portugal",985,2,6,3,2,1,1
"Spain",985,2,6,3,2,1,2
"Colombia",985,8,5,3,1,2,1
"Japan",985,8,5,3,1,2,2
"Morocco",991,2,6,4,3,1,1
"Portugal",991,2,6,4,3,1,2
"Australia",991,3,4,1,1,0,2
"France",991,3,6,3,1,2,1
"Denmark",993,3,3,2,3,-1,2
"France",993,3,9,3,0,3,1
"Brazil",994,5,9,7,3,4,1
"Costa Rica",994,5,3,3,4,-1,2
"Morocco",998,2,4,3,4,-1,2
"Portugal",998,2,7,4,0,4,1
